A	'ə	ə
abadessa	ə β ə ð 'ɛ s ə	ə β ə ð 'e s ə
abandonis	ə β ə n d 'ɔ n i s	ə β ə n d 'o n i s
abdomen	ə b d 'o m ə n	ə b d 'ɔ m ə n
abell	ə β 'ɛ ʎ	ə β 'e ʎ
abella	ə β 'ɛ ʎ ə	ə β 'e ʎ ə
Abella	ə β 'ɛ ʎ ə	ə β 'e ʎ ə
abelles	ə β 'ɛ ʎ ə s	ə β 'e ʎ ə s
ablació	ə β l ə s i 'o	ə b b l ə s i 'o
absolt	ə p s 'ɔ l t	ə p s 'o l t
absurd	ə p s 'u r t	ə p s 'u r
acer	ə s 'e r	ə s 'e
acord	ə k 'ɔ r t	ə k 'o r t
Açores	ə s 'ɔ ɾ ə s	ə s 'o ɾ ə s
adscripció	ə t s k ɾ i p s i 'o	ə ts k ɾ i p s i 'o
adscrit	ə t s k ɾ 'i t	ə ts k ɾ 'i t
adscrita	ə t s k ɾ 'i t ə	ə ts k ɾ 'i t ə
adscrites	ə t s k ɾ 'i t ə s	ə ts k ɾ 'i t ə s
adscrits	ə t s k ɾ 'i t s	ə ts k ɾ 'i t s
adscriure	ə t s k ɾ 'i w ɾ ə	ə ts k ɾ 'i w ɾ ə
adúlter	ə ð 'u l t ə r	ə ð 'u l t ə
advers	ə d b 'ɛ r s	ə d b 'e s
afecta	ə f 'e k t ə	ə f 'ɛ k t ə
afecte	ə f 'e k t ə	ə f 'ɛ k t ə
afectes	ə f 'e k t ə s	ə f 'ɛ k t ə s
afer	ə f 'e r	ə f 'e
aflora	ə f l 'ɔ ɾ ə	ə f l 'o ɾ ə
aflores	ə f l 'ɔ ɾ ə s	ə f l 'o ɾ ə s
afores	ə f 'ɔ ɾ ə s	ə f 'o ɾ ə s
afronta	ə f ɾ 'o n t ə	ə f ɾ 'ɔ n t ə
agenda	ə ʒ 'e n d ə	ə ʒ 'ɛ n d ə
aiguabarreig	ə j ɣ w ə β ə r 'ɛ t ʃ	ə j ɣ w ə β ə r 'ɛ tʃ
aiguafort	ə j ɣ w ə f 'ɔ r t	ə j ɣ w ə f 'o r t
aiguaneu	ə j ɣ w ə n 'e w	ə j ɣ w ə n 'ɛ w
al	'ə l	ə l
alcaldessa	ə l k ə l d 'ɛ s ə	ə l k ə l d 'e s ə
alçament	ə l s ə m 'e n	a l s ə m 'e n
Alcàsser	ə l k 'a s ə r	ə l k 'a s ə
alcàsser	ə l k 'a s ə r	ə l k 'a s ə
alegre	ə l 'e ɣ ɾ ə	ə l 'ɛ ɣ ɾ ə
aleshores	ə l ə z 'ɔ ɾ ə s	ə l ə z i 'o ɾ ə s
aleteig	ə l ə t 'ɛ t ʃ	ə l ə t 'ɛ tʃ
àlgid	'a l ʒ i t	'a l ʒ i ð
alhora	ə l 'ɔ ɾ ə	ə l i 'o ɾ ə
aliment	ə l i m 'e n	a l i m 'e n
alimenti	ə l i m 'e n t i	ə l i m 'ɛ n t i
alineament	ə l i n e ə m 'e n	ə l i n ə ə m 'e n
almirallessa	ə l m i ɾ ə ʎ 'ɛ s ə	ə l m i ɾ ə ʎ 'e s ə
alosa	ə l 'ɔ z ə	ə l 'o z ə
altrament	ə l t ɾ ə m 'e n	a l t ɾ ə m 'e n
amarg	ə m 'a r k	ə m 'a r
ambdós	ə m d 'o s	ə m b d 'o s
ambdues	ə m d 'u ə s	ə m b d 'u ə s
ambigu	ə m b 'i ɣ u	ə m b 'i ɣ
amens	ə m 'ɛ n s	ə m 'e n s
amor	ə m 'o r	ə m 'o
ampolla	ə m p 'o ʎ ə	ə m p 'ɔ ʎ ə
Andreu	ə n d ɾ 'e w	ə n d ɾ 'ɛ w
aniquilar	ə n i k i l 'a	ə n i k i ʎ 'a
anterior	ə n t ə ɾ i 'o r	ə n t ə ɾ i 'o
antimoni	ə n t i m 'ɔ n i	ə n t i m 'o n i
Antoni	ə n t 'ɔ n i	ə n t 'o n i
Anvers	ə m b 'ɛ r s	ə m b 'e s
anvers	ə m b 'ɛ r s	ə m b 'e s
aparell	ə p ə ɾ 'ɛ ʎ	ə p ə ɾ 'e ʎ
aparentment	ə p ə ɾ ə m m 'e n	ə p ə ɾ ə n m 'e n
apèndix	ə p 'ɛ n d i k s	ə p 'ɛ n d ʃ
aquell	ə k 'ɛ ʎ	ə k 'e ʎ
aquest	ə k 'ɛ t	ə k 'ɛ s t
aqüífer	ə k w 'i f ə r	ə k w 'i f ə
arbre	'a β ɾ ə	'a ɾ β ɾ ə
arbres	'a β ɾ ə s	'a ɾ β ɾ ə s
armament	ə r m ə m 'e n	a r m ə m 'e n
arqueig	ə r k 'ɛ t ʃ	ə r k 'ɛ tʃ
Artur	ə r t 'u r	ə r t 'u
arxiduquessa	ə r ʃ i ð u k 'ɛ s ə	ə r ʃ i ð u k 'e s ə
asimètric	ə s i m 'ɛ t ɾ i k	ə z i m 'ɛ t ɾ i k
assaig	ə s 'a t ʃ	ə s 'a tʃ
asseure's	ə s 'ɛ w ɾ ə s	ə s ə w ɾ 'ɛ s
atendre	ə t 'e n d ɾ ə	ə t 'ɛ n d ɾ ə
ateu	ə t 'e w	ə t 'ɛ w
atlàntic	ə l l 'a n t i k	ə ʎ 'a n t i k
atles	'a l l ə s	'a t l ə s
Atles	'a l l ə s	'a t l ə s
atleta	ə l l 'ɛ t ə	ə ʎ 'ɛ t ə
atlètic	ə l l 'ɛ t i k	ə t l 'ɛ t i k
atot	ə t 'o t	ə t 'ɔ t
atret	ə t ɾ 'e t	ə t ɾ 'ɛ t
atrets	ə t ɾ 'e t s	ə t ɾ 'ɛ t s
atroç	ə t ɾ 'ɔ s	ə t ɾ 'o s
atur	ə t 'u r	ə t 'u
atzar	ə d z 'a r	ə d z 'a
auster	ə w s t 'e r	ə w s t 'e
autocar	ə w t u k 'a r	ə w t u k 'a
autoretrat	ə w t u r ə t ɾ 'a t	ə w t u ɾ ə t ɾ 'a t
autoretrats	ə w t u r ə t ɾ 'a t s	ə w t u ɾ ə t ɾ 'a t s
avantbraç	ə β ə m b ɾ 'a s	ə β ə n b ɾ 'a s
avantpassat	ə β ə m p ə s 'a t	ə β ə n p ə s 'a t
avantpassats	ə β ə m p ə s 'a t s	ə β ə n p ə s 'a t s
avar	ə β 'a r	ə β 'a
babiloni	b ə β i l 'ɔ n i	b ə β i l 'o n i
balbuceig	b ə l β u s 'ɛ t ʃ	b ə l β u s 'ɛ tʃ
balear	b ə l e 'a r	b ə l e 'a
balears	b ə l e 'a r s	b ə l e 'a s
Balears	b ə l e 'a r s	b ə l e 'a s
baluard	b ə l u 'a r t	b ə l u 'a r
banc	b 'a ŋ	b 'a ŋ k
bancs	b 'a ŋ s	b 'a ŋ k s
bar	b 'a r	b 'a
baronessa	b ə ɾ u n 'ɛ s ə	b ə ɾ u n 'e s ə
barreig	b ə r 'ɛ t ʃ	b ə r 'ɛ tʃ
bastard	b ə s t 'a r t	b ə s t 'a r
bateig	b ə t 'ɛ t ʃ	b ə t 'ɛ tʃ
be	b 'e	b 'ɛ
beix	b 'e ʃ	b 'ɛ ʃ
Belgrad	b ə l ɣ ɾ 'a t	b ə l ɣ ɾ 'a ð
bellugueig	b ə ʎ u ɣ 'ɛ t ʃ	b ə ʎ u ɣ 'ɛ tʃ
bemoll	b ə m 'ɔ ʎ	b ə m 'o ʎ
ben	b 'e n	b 'ɛ n
bes	b 'e s	b 'ɛ s
besnebot	b ə z n ə β 'o t	b ə z n ə β 'ɔ t
beso	b 'e z u	b 'ɛ z u
Bigorra	b i ɣ 'ɔ r ə	b i ɣ 'o r ə
billar	b i ʎ 'a r	b i ʎ 'a
bioma	b i 'ɔ m ə	b i 'o m ə
bipolar	b i p u l 'a r	b i p u l 'a
blanqueig	b l ə ŋ k 'ɛ t ʃ	b l ə ŋ k 'ɛ tʃ
blens	b l 'ɛ n s	b l 'e n s
bloqueig	b l u k 'ɛ t ʃ	b l u k 'ɛ tʃ
bo	b 'ɔ	b 'o
boa	b 'ɔ ə	b 'o ə
boc	b 'o k	b 'ɔ k
boca	b 'o k ə	b 'ɔ k ə
bocs	b 'o k s	b 'ɔ k s
boda	b 'o ð ə	b 'ɔ ð ə
bodes	b 'o ð ə s	b 'ɔ ð ə s
boes	b 'ɔ ə s	b 'o ə s
boga	b 'o ɣ ə	b 'ɔ ɣ ə
boig	b 'ɔ t ʃ	b 'ɔ tʃ
boirina	b u j ɾ 'i n ə	b u i ɾ 'i n ə
bolca	b 'o l k ə	b 'ɔ l k ə
bolquen	b 'o l k ə n	b 'ɔ l k ə n
bomba	b 'o m b ə	b 'ɔ m b ə
bombes	b 'o m b ə s	b 'ɔ m b ə s
bombo	b 'o m b u	b 'ɔ m b u
bombolla	b u m b 'o ʎ ə	b u m b 'ɔ ʎ ə
bon	b 'ɔ n	b 'o n
bona	b 'ɔ n ə	b 'o n ə
bones	b 'ɔ n ə s	b 'o n ə s
bons	b 'ɔ n s	b 'o n s
bonze	b 'ɔ n z ə	b 'o n z ə
bonzessa	b u n z 'ɛ s ə	b u n z 'e s ə
boques	b 'o k ə s	b 'ɔ k ə s
bord	b 'o r t	b 'o ɾ ð
borsa	b 'o r s ə	b 'ɔ r s ə
borses	b 'o r s ə s	b 'ɔ r s ə s
bosc	b 'ɔ s k	b 'o s k
bossa	b 'o s ə	b 'ɔ s ə
bosses	b 'o s ə s	b 'ɔ s ə s
bot	b 'o t	b 'ɔ t
bota	b 'o t ə	b 'ɔ t ə
botes	b 'o t ə s	b 'ɔ t ə s
boti	b 'o t i	b 'ɔ t i
bou	b 'ɔ w	b 'o w
bous	b 'ɔ w s	b 'o w s
Brasília	b ɾ ə z 'i l i ə	b ɾ ə s 'i l i ə
bressa	b ɾ 'ɛ s ə	b ɾ 'e s ə
bretxa	b ɾ 'e t ʃ ə	b ɾ 'ɛ t ʃ ə
breu	b ɾ 'e w	b ɾ 'ɛ w
breus	b ɾ 'e w s	b ɾ 'ɛ w s
broda	b ɾ 'o ð ə	b ɾ 'ɔ ð ə
brolla	b ɾ 'o ʎ ə	b ɾ 'ɔ ʎ ə
brollen	b ɾ 'o ʎ ə n	b ɾ 'ɔ ʎ ə n
brot	b ɾ 'o t	b ɾ 'ɔ t
brota	b ɾ 'o t ə	b ɾ 'ɔ t ə
brou	b ɾ 'ɔ w	b ɾ 'o w
búlgar	b 'u l ɣ ə r	b 'u l ɣ ə
bullabessa	b u ʎ ə β 'ɛ s ə	b u ʎ ə β 'e s ə
busseig	b u s 'ɛ t ʃ	b u s 'ɛ tʃ
cabeça	k ə β 'ɛ s ə	k ə β 'e s ə
cabell	k ə β 'ɛ ʎ	k ə β 'e ʎ
caber	k ə β 'ɛ	k ə β 'e
Calabuig	k ə l ə β 'u t ʃ	k ə l ə β 'u tʃ
calb	k 'a l p	k 'a l
caler	k ə l 'ɛ	k ə l 'e
calfred	k ə l f ɾ 'ɛ t	k ə l f ɾ 'e t
camps	k 'a m s	k 'a m p s
càncer	k 'a n s ə r	k 'a n s ə
cantimplora	k ə n t i m p l 'ɔ ɾ ə	k ə n t i m p l 'o ɾ ə
caos	k 'a o s	k 'a u s
capritx	k ə p ɾ 'i t ʃ	k ə p ɾ 'i tʃ
capvespre	k ə b b 'e s p ɾ ə	k ə b b 'ɛ s p ɾ ə
car	k 'a r	k 'a
caràcter	k ə ɾ 'a k t ə r	k ə ɾ 'a k t ə
card	k 'a r t	k 'a r
cars	k 'a r s	k 'a s
cartutx	k ə r t 'u t ʃ	k ə r t 'u t
casts	k 'a s t s	k 'a s s
càtar	k 'a t ə r	k 'a t ə
catorze	k ə t 'o r z ə	k ə t 'ɔ r z ə
caviar	k ə β i 'a r	k ə β i 'a
ce	s 'e	s 'ɛ
cec	s 'e k	s 'ɛ k
cecs	s 'e k s	s 'ɛ k s
cega	s 'e ɣ ə	s 'ɛ ɣ ə
cegues	s 'e ɣ ə s	s 'ɛ ɣ ə s
cella	s 'ɛ ʎ ə	s 'e ʎ ə
celles	s 'ɛ ʎ ə s	s 'e ʎ ə s
cens	s 'ɛ n s	s 'e n s
centre	s 'e n t ɾ ə	s 'ɛ n t ɾ ə
centren	s 'e n t ɾ ə n	s 'ɛ n t ɾ ə n
centres	s 'e n t ɾ ə s	s 'ɛ n t ɾ ə s
centri	s 'e n t ɾ i	s 'ɛ n t ɾ i
centrin	s 'e n t ɾ i n	s 'ɛ n t ɾ i n
centro	s 'e n t ɾ u	s 'ɛ n t ɾ u
ceptre	s 'e p t ɾ ə	s 'ɛ p t ɾ ə
cera	s 'ɛ ɾ ə	s 'e ɾ ə
cercle	s 'e r k l ə	s 'ɛ r k l ə
cercles	s 'e r k l ə s	s 'ɛ r k l ə s
Cèsar	s 'ɛ z ə r	s 'ɛ z ə
cessen	s 'e s ə n	s 'ɛ s ə n
cessi	s 'e s i	s 'ɛ s i
cessin	s 'e s i n	s 'ɛ s i n
cianur	s i ə n 'u r	s i ə n 'u
ciclomotor	s i k l u m u t 'o r	s i k l u m u t 'o
cigar	s i ɣ 'a r	s i ɣ 'a
Cir	s 'i r	s 'i
clixé	k l i ʃ 'e	k l i k s 'e
clon	k l 'ɔ n	k l 'o n
clona	k l 'ɔ n ə	k l 'o n ə
clones	k l 'ɔ n ə s	k l 'o n ə s
cloni	k l 'ɔ n i	k l 'o n i
clonin	k l 'ɔ n i n	k l 'o n i n
clonis	k l 'ɔ n i s	k l 'o n i s
clono	k l 'ɔ n u	k l 'o n u
clor	k l 'ɔ r	k l 'o
clora	k l 'ɔ ɾ ə	k l 'o ɾ ə
clores	k l 'ɔ ɾ ə s	k l 'o ɾ ə s
clos	k l 'ɔ s	k l 'o s
closa	k l 'ɔ z ə	k l 'o z ə
closes	k l 'ɔ z ə s	k l 'o z ə s
closos	k l 'ɔ z u s	k l 'o z u s
clou	k l 'ɔ w	k l 'o w
ço	s 'ɔ	s 'o
coa	k 'ɔ ə	k 'o ə
cobla	k 'o b b l ə	k 'ɔ b b l ə
cobles	k 'o b b l ə s	k 'ɔ b b l ə s
coca	k 'o k ə	k 'ɔ k ə
coclear	k u k l e 'a r	k u k l e 'a
coco	k 'o k u	k 'ɔ k u
cofoi	k u f 'ɔ j	k u f 'o i
cogoma	k u ɣ 'ɔ m ə	k u ɣ 'o m ə
cogombre	k u ɣ 'o m b ɾ ə	k u ɣ 'ɔ m b ɾ ə
coherentment	k u ə ɾ ə m m 'e n	k u ə ɾ ə n m 'e n
coit	k 'ɔ j t	k 'o i t
colesteatoma	k u l ə s t e ə t 'ɔ m ə	k u l ə s t e ə t 'o m ə
colesteatomes	k u l ə s t e ə t 'ɔ m ə s	k u l ə s t e ə t 'o m ə s
colitx	k u l 'i t ʃ	k u l 'i tʃ
coll	k 'ɔ ʎ	k 'o ʎ
colossos	k u l 'o s u s	k u l 'ɔ s u s
colze	k 'o l z ə	k 'ɔ l z ə
colzes	k 'o l z ə s	k 'ɔ l z ə s
comboi	k u m b 'ɔ j	k u m b 'o i
Comores	k u m 'ɔ ɾ ə s	k u m 'o ɾ ə s
compon	k u m p 'ɔ n	k u m p 'o n
compost	k u m p 'ɔ s t	k u m p 'o s t
compra	k 'o m p ɾ ə	k 'ɔ m p ɾ ə
compren	k 'o m p ɾ ə n	k 'ɔ m p ɾ ə n
compres	k 'o m p ɾ ə s	k 'ɔ m p ɾ ə s
compro	k 'o m p ɾ u	k 'ɔ m p ɾ u
compta	k 'o m t ə	k 'ɔ m t ə
compte	k 'o m t ə	k 'ɔ m p t ə
compten	k 'o m t ə n	k 'ɔ m p t ə n
comptes	k 'o m t ə s	k 'ɔ m p t ə s
compti	k 'o m t i	k 'ɔ m t i
comptin	k 'o m t i n	k 'ɔ m p t i n
compto	k 'o m t u	k 'ɔ m t u
comte	k 'o m t ə	k 'ɔ m t ə
comtes	k 'o m t ə s	k 'ɔ m t ə s
comtessa	k u m t 'ɛ s ə	k u m t 'e s ə
conca	k 'o ŋ k ə	k 'ɔ ŋ k ə
concepte	k u n s 'e p t ə	k u n s 'ɛ p t ə
concloses	k u ŋ k l 'ɔ z ə s	k u ŋ k l 'o z ə s
conclosos	k u ŋ k l 'ɔ z u s	k u ŋ k l 'o z u s
concret	k u ŋ k ɾ 'e t	k u ŋ k ɾ 'ɛ t
còndor	k 'ɔ n d u r	k 'ɔ n d u
conques	k 'o ŋ k ə s	k 'ɔ ŋ k ə s
conquesta	k u ŋ k 'e s t ə	k u ŋ k 'ɛ s t ə
conscientment	k u n s i ə m m 'e n	k u n s i ə n m 'e n
consell	k u n s 'ɛ ʎ	k u n s 'e ʎ
consens	k u n s 'ɛ n s	k u n s 'e n s
consta	k 'o n s t ə	k 'ɔ n s t ə
consten	k 'o n s t ə n	k 'ɔ n s t ə n
consular	k u n s u l 'a r	k u n s u l 'a
conta	k 'o n t ə	k 'ɔ n t ə
conte	k 'o n t ə	k 'ɔ n t ə
conten	k 'o n t ə n	k 'ɔ n t ə n
contes	k 'o n t ə s	k 'ɔ n t ə s
context	k u n t 'e k s t	k u n t 'ɛ k s t
contigu	k u n t 'i ɣ u	k u n t 'i ɣ
contrasts	k u n t ɾ 'a s t s	k u n t ɾ 'a s s
contret	k u n t ɾ 'e t	k u n t ɾ 'ɛ t
contreta	k u n t ɾ 'e t ə	k u n t ɾ 'ɛ t ə
contrets	k u n t ɾ 'e t s	k u n t ɾ 'ɛ t s
convenientment	k u m b ə n i ə m m 'e n	k u m b ə n i ə n m 'e n
copa	k 'o p ə	k 'ɔ p ə
copes	k 'o p ə s	k 'ɔ p ə s
copsa	k 'o p s ə	k 'ɔ p s ə
coquessa	k u k 'ɛ s ə	k u k 'e s ə
cor	k 'ɔ r	k 'o
cora	k 'ɔ ɾ ə	k 'o ɾ ə
corre	k 'o r ə	k 'ɔ r ə
corren	k 'o r ə n	k 'ɔ r ə n
corri	k 'o r i	k 'ɔ r i
corrin	k 'o r i n	k 'ɔ r i n
corro	k 'o r u	k 'ɔ r u
corrompre	k u r 'o m p ɾ ə	k u r 'ɔ m p ɾ ə
cors	k 'ɔ r s	k 'o s
corsa	k 'o r s ə	k 'ɔ r s ə
corses	k 'o r s ə s	k 'ɔ r s ə s
corsos	k 'o r s u s	k 'ɔ r s u s
Corts	k 'o r s	k 'o r t s
cos	k 'ɔ s	k 'o s
cosa	k 'ɔ z ə	k 'o z ə
coses	k 'ɔ z ə s	k 'o z ə s
cosinus	k u s 'i n u s	k u z 'i n u s
cost	k 'ɔ s t	k 'o s t
cotxe	k 'o t ʃ ə	k 'ɔ t ʃ ə
cotxes	k 'o t ʃ ə s	k 'ɔ t ʃ ə s
cou	k 'ɔ w	k 'o w
covard	k u β 'a r t	k u β 'a r
cranc	k ɾ 'a ŋ	k ɾ 'a n s
cràter	k ɾ 'a t ə r	k ɾ 'a t ə
creen	k ɾ 'e ə n	k ɾ 'ɛ ə n
creï	k ɾ 'e i	k ɾ 'ɛ i
creïn	k ɾ 'e i n	k ɾ ə 'i n
creixen	k ɾ 'e ʃ ə n	k ɾ 'ɛ ʃ ə n
crema	k ɾ 'e m ə	k ɾ 'ɛ m ə
cremen	k ɾ 'e m ə n	k ɾ 'ɛ m ə n
cremes	k ɾ 'e m ə s	k ɾ 'ɛ m ə s
cremi	k ɾ 'e m i	k ɾ 'ɛ m i
cremin	k ɾ 'e m i n	k ɾ 'ɛ m i n
crepuscular	k ɾ ə p u s k u l 'a r	k ɾ ə p u s k u l 'a
cuinar	k u j n 'a	k u i n 'a
cuir	k 'u j r	k 'u j
curricular	k u r i k u l 'a r	k u r i k u l 'a
curts	k 'u r s	k 'u r t s
d'acord	d ə k 'ɔ r t	d ə k 'o r t
d'hora	d 'ɔ ɾ ə	d i 'o ɾ ə
dard	d 'a r t	d 'a r
darrere	d ə r 'e ɾ ə	d ə r 'ɛ ɾ ə
de	d 'ə	d ə
decor	d ə k 'o r	d ə k 'o
decret	d ə k ɾ 'e t	d ə k ɾ 'ɛ t
Deessa	d ə 'ɛ s ə	d ə 'e s ə
deessa	d ə 'ɛ s ə	d ə 'e s ə
defora	d ə f 'ɔ ɾ ə	d ə f 'o ɾ ə
degoteig	d ə ɣ u t 'ɛ t ʃ	d ə ɣ u t 'ɛ tʃ
deix	d 'e ʃ	d 'ɛ ʃ
deixeble	d ə ʃ 'e b b l ə	d ə ʃ 'ɛ b b l ə
deixis	d 'e ʃ i s	d 'ɛ ʃ i s
deler	d ə l 'ɛ	d ə l 'e
demagog	d ə m ə ɣ 'ɔ k	d ə m ə ɣ 'o k
dens	d 'ɛ n s	d 'e n s
desa	d 'e z ə	d 'ɛ z ə
desamor	d ə z ə m 'o r	d ə z ə m 'o
desatendre	d ə z ə t 'e n d ɾ ə	d ə z ə t 'ɛ n d ɾ ə
descompte	d ə s k 'o m t ə	d ə s k 'ɔ m p t ə
desembre	d ə z 'e m b ɾ ə	d ə z 'ɛ m b ɾ ə
desfet	d ə s f 'e t	d ə s f 'ɛ t
desfeta	d ə s f 'e t ə	d ə s f 'ɛ t ə
deshonest	d ə z u n 'e s t	d ə z u n 'ɛ s t
desi	d 'e z i	d 'ɛ z i
desig	d ə z 'i t ʃ	d ə z 'i ɣ
desigs	d ə z 'i t ʃ s	d ə z 'i k s
deso	d 'e z u	d 'ɛ z u
Despuig	d ə s p 'u t ʃ	d ə s p 'u tʃ
dessota	d ə s 'o t ə	d ə s 'ɔ t ə
destorb	d ə s t 'o r p	d ə s t 'o ɾ
destra	d 'e s t ɾ ə	d 'ɛ s t ɾ ə
destres	d 'e s t ɾ ə s	d 'ɛ s t ɾ ə s
detona	d ə t 'ɔ n ə	d ə t 'o n ə
detones	d ə t 'ɔ n ə s	d ə t 'o n ə s
detono	d ə t 'ɔ n u	d ə t 'o n u
devers	d ə β 'ɛ r s	d ə β 'e s
diatomea	d i ə t u m 'ɛ ə	d i ə t u m 'e ə
difondre	d i f 'o n d ɾ ə	d i f 'ɔ n d ɾ ə
dijous	d i ʒ 'ɔ w s	d i ʒ 'o w s
diligentment	d i l i ʒ ə m m 'e n	d i l i ʒ ə n m 'e n
dimecres	d i m 'e k ɾ ə s	d i m 'ɛ k ɾ ə s
dimoni	d i m 'ɔ n i	d i m 'o n i
dimonis	d i m 'ɔ n i s	d i m 'o n i s
dinou	d i n 'ɔ w	d i n 'o w
discret	d i s k ɾ 'e t	d i s k ɾ 'ɛ t
discreta	d i s k ɾ 'e t ə	d i s k ɾ 'ɛ t ə
discretes	d i s k ɾ 'e t ə s	d i s k ɾ 'ɛ t ə s
discrets	d i s k ɾ 'e t s	d i s k ɾ 'ɛ t s
dispers	d i s p 'ɛ r s	d i s p 'e s
dissabte	d i s 'a p t ə	d i s 'a b b t ə
dissolt	d i s 'ɔ l t	d i s 'o l t
dissort	d i s 'ɔ r t	d i s 'o r t
distendre	d i s t 'e n d ɾ ə	d i s t 'ɛ n d ɾ ə
distret	d i s t ɾ 'e t	d i s t ɾ 'ɛ t
distreta	d i s t ɾ 'e t ə	d i s t ɾ 'ɛ t ə
distrets	d i s t ɾ 'e t s	d i s t ɾ 'ɛ t s
diumenge	d i w m 'e n ʒ ə	d i w m 'ɛ n ʒ ə
divers	d i β 'ɛ r s	d i β 'e s
dividend	d i β i ð 'e n	d i β i ð 'ɛ n
do	d 'ɔ	d 'o
dobla	d 'o b b l ə	d 'ɔ b b l ə
doble	d 'o b b l ə	d 'ɔ b b l ə
doblen	d 'o b b l ə n	d 'ɔ b b l ə n
dobles	d 'o b b l ə s	d 'ɔ b b l ə s
dolça	d 'o l s ə	d 'ɔ l s ə
dolces	d 'o l s ə s	d 'ɔ l s ə s
dolços	d 'o l s u s	d 'ɔ l s u s
dona	d 'ɔ n ə	d 'o n ə
donen	d 'o n ə n	d 'ɔ n ə n
dones	d 'ɔ n ə s	d 'o n ə s
dons	d 'ɔ n s	d 'o n s
dors	d 'ɔ r s	d 'o s
dotze	d 'o d z ə	d 'ɔ d z ə
dramaturg	d ɾ ə m ə t 'u r k	d ɾ ə m ə t 'u r
dreces	d ɾ 'ɛ s ə s	d ɾ 'e s ə s
duquessa	d u k 'ɛ s ə	d u k 'e s ə
Ebre	'e β ɾ ə	'ɛ β ɾ ə
ecosistema	ə k u s i s t 'e m ə	ə k u z i s t 'ɛ m ə
Eduard	ə ð u 'a r t	ə ð u 'a r
efímer	ə f 'i m ə r	ə f 'i m ə
ei	'e j	'ɛ j
Eivissa	ə j β 'i s ə	ə i β 'i s ə
eivissenc	ə j β i s 'ɛ ŋ	ə i β i s 'ɛ ŋ
eix	'e ʃ	'ɛ ʃ
ela	'e l ə	'ɛ l ə
element	ə l ə m 'e n	ɛ l ə m 'e n
Eloi	ə l 'ɔ j	ə l 'o i
em	'ə m	ə m
ema	'e m ə	'ɛ m ə
emir	ə m 'i r	ə m 'i
empatx	ə m p 'a t ʃ	ə m p 'a tʃ
empenta	ə m p 'ɛ n t ə	ə m p 'e n t ə
empra	'e m p ɾ ə	'ɛ m p ɾ ə
empremta	ə m p ɾ 'e m t ə	ə m p ɾ 'ɛ m t ə
empren	'e m p ɾ ə n	'ɛ m p ɾ ə n
empri	'e m p ɾ i	'ɛ m p ɾ i
en	'ə n	ə n
ena	'e n ə	'ɛ n ə
encendre	ə n s 'e n d ɾ ə	ə n s 'ɛ n d ɾ ə
endarrere	ə n d ə r 'e ɾ ə	ə n d ə r 'ɛ ɾ ə
endinsar	ə n d i n z 'a	ə n d i n s 'a
endinsat	ə n d i n z 'a t	ə n d i n s 'a t
ene	'e n ə	'ɛ n ə
enhorabona	ə n u ɾ ə β 'ɔ n ə	ə n u ɾ ə β 'o n ə
enmig	ə m m 'i t ʃ	ə n m 'i tʃ
enorme	ə n 'o r m ə	ə n 'ɔ r m ə
enormes	ə n 'o r m ə s	ə n 'ɔ r m ə s
enquesta	ə ŋ k 'e s t ə	ə ŋ k 'ɛ s t ə
enrenou	ə n r ə n 'ɔ w	ə n r ə n 'o w
enrere	ə n r 'e ɾ ə	ə n 'ɛ ɾ ə
ens	'ə n s	ə n s
entendre	ə n t 'e n d ɾ ə	ə n t 'ɛ n d ɾ ə
enter	ə n t 'e r	ə n t 'e
entre	'e n t ɾ ə	'ɛ n t ɾ ə
entrebanc	ə n t ɾ ə β 'a ŋ	ə n t ɾ ə β 'a n s
entren	'e n t ɾ ə n	'ɛ n t ɾ ə n
entres	'e n t ɾ ə s	'ɛ n t ɾ ə s
entri	'e n t ɾ i	'ɛ n t ɾ i
entrin	'e n t ɾ i n	'ɛ n t ɾ i n
entris	'e n t ɾ i s	'ɛ n t ɾ i s
entro	'e n t ɾ u	'ɛ n t ɾ u
enuig	ə n 'u t ʃ	ə n 'u tʃ
envers	ə m b 'ɛ r s	ə m b 'e s
ep	'e p	'ɛ p
epicens	ə p i s 'ɛ n s	ə p i s 'e n s
equivaler	ə k i β ə l 'ɛ	ə k i β ə l 'e
equivoco	ə k i β 'o k u	ə k i β 'ɔ k u
eren	'e ɾ ə n	'ɛ ɾ ə n
erra	'e r ə	'ɛ r ə
erres	'e r ə s	'ɛ r ə s
erroni	ə r 'ɔ n i	ə r 'o n i
error	ə r 'o r	ə r 'o
es	'ə s	ə s
escaig	ə s k 'a t ʃ	ə s k 'a tʃ
escalens	ə s k ə l 'ɛ n s	ə s k ə l 'e n s
escletxa	ə s k l 'e t ʃ ə	ə s k l 'ɛ t ʃ ə
escolar	ə s k u l 'a r	ə s k u l 'a
escolta	ə s k 'o l t ə	ə s k 'ɔ l t ə
escombra	ə s k 'o m b ɾ ə	ə s k 'ɔ m b ɾ ə
escreix	ə s k ɾ 'e ʃ	ə s k ɾ 'ɛ ʃ
escrot	ə s k ɾ 'o t	ə s k ɾ 'ɔ t
esfinx	ə s f 'i n ʃ	ə s f 'i n
esforç	ə s f 'ɔ r s	ə s f 'o r s
esguard	ə z ɣ w 'a r t	ə z ɣ w 'a r
esment	ə z m 'e n	e z m 'e n
espectacular	ə s p ə k t ə k u l 'a r	ə s p ə k t ə k u l 'a
espectre	ə s p 'e k t ɾ ə	ə s p 'ɛ k t ɾ ə
espinavessa	ə s p i n ə β 'ɛ s ə	ə s p i n ə β 'e s ə
espona	ə s p 'ɔ n ə	ə s p 'o n ə
esposa	ə s p 'ɔ z ə	ə s p 'o z ə
esprémer	ə s p ɾ 'e m ə	ə s p ɾ 'e m ə r
esquetx	ə s k 'e t ʃ	ə s k 'ɛ tʃ
esquitx	ə s k 'i t ʃ	ə s k 'i tʃ
essa	'ɛ s ə	'e s ə
esser	ə s 'ɛ	ə s 'e
ésser	'e s ə r	'e s ə
est	'e s t	'ɛ s t
esta	'e s t ə	'ɛ s t ə
estabeig	ə s t ə β 'ɛ t ʃ	ə s t ə β 'ɛ tʃ
estament	ə s t ə m 'e n	ɛ s t ə m 'e n
estàndard	ə s t 'a n d ə r t	ə s t 'a n d ə ɾ ð
estendre	ə s t 'e n d ɾ ə	ə s t 'ɛ n d ɾ ə
Ester	ə s t 'e r	ə s t 'e
estiueig	ə s t i w 'ɛ t ʃ	ə s t i w 'ɛ tʃ
estofa	ə s t 'o f ə	ə s t 'ɔ f ə
estoig	ə s t 'ɔ t ʃ	ə s t 'ɔ tʃ
estos	'e s t u s	'ɛ s t u s
estramoni	ə s t ɾ ə m 'ɔ n i	ə s t ɾ ə m 'o n i
estrateg	ə s t ɾ ə t 'ɛ k	ə s t ɾ ə t 'ɛ ɣ
esvoranc	ə z β u ɾ 'a ŋ	ə z β u ɾ 'a n s
ets	'e t s	'ɛ t s
eufoni	ə w f 'ɔ n i	ə w f 'o n i
evidentment	ə β i ð ə m m 'e n	ə β i ð ə n m 'e n
evolucionis	ə β u l u s i 'ɔ n i s	ə β u l u s i 'o n i s
excepte	ə k s 'e p t ə	ə k s 'ɛ p t ə
exclosa	ə k s k l 'ɔ z ə	ə k s k l 'o z ə
excloses	ə k s k l 'ɔ z ə s	ə k s k l 'o z ə s
exclosos	ə k s k l 'ɔ z u s	ə k s k l 'o z u s
expresses	ə k s p ɾ 'e s ə s	ə k s p ɾ 'ɛ s ə s
expressos	ə k s p ɾ 'e s u s	ə k s p ɾ 'ɛ s u s
extens	ə k s t 'ɛ n s	ə k s t 'e n s
exterior	ə k s t ə ɾ i 'o r	ə k s t ə ɾ i 'o
extrem	ə k s t ɾ 'e m	ə k s t ɾ 'ɛ m
extrema	ə k s t ɾ 'e m ə	ə k s t ɾ 'ɛ m ə
extret	ə k s t ɾ 'e t	ə k s t ɾ 'ɛ t
extreta	ə k s t ɾ 'e t ə	ə k s t ɾ 'ɛ t ə
extretes	ə k s t ɾ 'e t ə s	ə k s t ɾ 'ɛ t ə s
extrets	ə k s t ɾ 'e t s	ə k s t ɾ 'ɛ t s
fagosoma	f ə ɣ u z 'ɔ m ə	f ə ɣ u z 'o m ə
faig	f 'a t ʃ	f 'a tʃ
familiar	f ə m i l i 'a r	f ə m i l i 'a
fantasia	f ə n t ə z 'i ə	f ə n t ə s 'i ə
fantasies	f ə n t ə z 'i ə s	f ə n t ə s 'i ə s
faquir	f ə k 'i r	f ə k 'i
far	f 'a r	f 'a
farigola	f ə ɾ i ɣ 'o l ə	f ə ɾ i ɣ 'ɔ l ə
favor	f ə β 'o r	f ə β 'o
feble	f 'e b b l ə	f 'ɛ b b l ə
febles	f 'e b b l ə s	f 'ɛ b b l ə s
febre	f 'e β ɾ ə	f 'ɛ β ɾ ə
febres	f 'e β ɾ ə s	f 'ɛ β ɾ ə s
fecund	f ə k 'u n	f ə k 'u n d
feix	f 'e ʃ	f 'ɛ ʃ
feldspat	f ə l t s p 'a t	f ə l s p 'a t
fèmur	f 'ɛ m u r	f 'ɛ m u
fen	f 'e n	f 'ɛ n
Fènix	f 'ɛ n i k s	f 'ɛ n ʃ
fènix	f 'ɛ n i k s	f 'ɛ n ʃ
fens	f 'ɛ n s	f 'e n s
feren	f 'e ɾ ə n	f 'ɛ ɾ ə n
fes	f 'e s	f 'ɛ s
Fes	f 'e s	f 'ɛ s
fessin	f 'e s i n	f 'ɛ s i n
fessis	f 'e s i s	f 'ɛ s i s
festa	f 'e s t ə	f 'ɛ s t ə
festeig	f ə s t 'ɛ t ʃ	f ə s t 'ɛ tʃ
festes	f 'e s t ə s	f 'ɛ s t ə s
fet	f 'e t	f 'ɛ t
feta	f 'e t ə	f 'ɛ t ə
fetes	f 'e t ə s	f 'ɛ t ə s
fetge	f 'e d ʒ ə	f 'ɛ d ʒ ə
fets	f 'e t s	f 'ɛ t s
finestra	f i n 'e s t ɾ ə	f i n 'ɛ s t ɾ ə
fletxa	f l 'e t ʃ ə	f l 'ɛ t ʃ ə
fletxes	f l 'e t ʃ ə s	f l 'ɛ t ʃ ə s
flor	f l 'ɔ	f l 'o
flora	f l 'ɔ ɾ ə	f l 'o ɾ ə
flors	f l 'ɔ s	f l 'o s
foca	f 'o k ə	f 'ɔ k ə
focus	f 'o k u s	f 'ɔ k u s
folla	f 'o ʎ ə	f 'ɔ ʎ ə
folles	f 'o ʎ ə s	f 'ɔ ʎ ə s
folre	f 'o l r ə	f 'ɔ l r ə
fonda	f 'o n d ə	f 'ɔ n d ə
fondes	f 'o n d ə s	f 'ɔ n d ə s
fondo	f 'o n d u	f 'ɔ n d u
fondos	f 'o n d u s	f 'ɔ n d u s
fondre	f 'o n d ɾ ə	f 'ɔ n d ɾ ə
font	f 'ɔ n	f 'o n
foques	f 'o k ə s	f 'ɔ k ə s
fora	f 'ɔ ɾ ə	f 'o ɾ ə
forca	f 'o r k ə	f 'ɔ r k ə
foren	f 'o ɾ ə n	f 'ɔ ɾ ə n
forma	f 'o r m ə	f 'ɔ r m ə
formen	f 'o r m ə n	f 'ɔ r m ə n
formes	f 'o r m ə s	f 'ɔ r m ə s
formi	f 'o r m i	f 'ɔ r m i
formigueig	f u r m i ɣ 'ɛ t ʃ	f u r m i ɣ 'ɛ tʃ
formin	f 'o r m i n	f 'ɔ r m i n
formo	f 'o r m u	f 'ɔ r m u
forques	f 'o r k ə s	f 'ɔ r k ə s
fort	f 'ɔ r t	f 'o r t
fosca	f 'o s k ə	f 'ɔ s k ə
foscos	f 'o s k u s	f 'ɔ s k u s
fosques	f 'o s k ə s	f 'ɔ s k ə s
fossin	f 'o s i n	f 'ɔ s i n
fossis	f 'o s i s	f 'ɔ s i s
foten	f 'o t ə n	f 'ɔ t ə n
foti	f 'o t i	f 'ɔ t i
fotin	f 'o t i n	f 'ɔ t i n
fotis	f 'o t i s	f 'ɔ t i s
foto	f 'o t u	f 'ɔ t u
fotos	f 'o t u s	f 'ɔ t u s
fotre	f 'o t ɾ ə	f 'ɔ t ɾ ə
franctirador	f ɾ ə ŋ t i ɾ ə ð 'o	f ɾ ə ŋ k t i ɾ ə ð 'o
frankfurt	f ɾ ə ŋ k f 'u r t	f ɾ ə ŋ f 'u r t
fred	f ɾ 'ɛ t	f ɾ 'e t
frens	f ɾ 'ɛ n s	f ɾ 'e n s
fressa	f ɾ 'ɛ s ə	f ɾ 'e s ə
fuig	f 'u t ʃ	f 'u tʃ
funicular	f u n i k u l 'a r	f u n i k u l 'a
furor	f u ɾ 'o r	f u ɾ 'o
gemec	ʒ ə m 'e k	ʒ ə m 'ɛ k
gemma	ʒ 'e m m ə	ʒ 'ɛ m m ə
Gemma	ʒ 'e m m ə	ʒ 'ɛ m m ə
gespa	ʒ 'e s p ə	ʒ 'ɛ s p ə
gest	ʒ 'e s t	ʒ 'ɛ s t
gesta	ʒ 'e s t ə	ʒ 'ɛ s t ə
gestes	ʒ 'e s t ə s	ʒ 'ɛ s t ə s
gestos	ʒ 'e s t u s	ʒ 'ɛ s t u s
ginebra	ʒ i n 'e β ɾ ə	ʒ i n 'ɛ β ɾ ə
Ginebra	ʒ i n 'e β ɾ ə	ʒ i n 'ɛ β ɾ ə
ginesta	ʒ i n 'e s t ə	ʒ i n 'ɛ s t ə
gir	ʒ 'i r	ʒ 'i
Haia	'a j ə	i 'a j ə
haig	'a t ʃ	'a tʃ
hàmster	'a m s t ə r	'a m s t ə
haver	ə β 'ɛ	ə β 'e
he	'e	'ɛ
helicòpter	ə l i k 'ɔ p t ə r	ə l i k 'ɔ p t ə
hemangioma	ə m ə n ʒ i 'ɔ m ə	ə m ə n ʒ i 'o m ə
heroi	ə ɾ 'ɔ j	ə ɾ 'o i
heroic	ə ɾ 'ɔ j k	ə ɾ 'o i k
hevea	ə β 'ɛ ə	ə β 'e ə
hi	'i	i
híbrid	'i β ɾ i t	'i β ɾ i ð
hieràtic	j ə ɾ 'a t i k	i ə ɾ 'a t i k
hieràtics	j ə ɾ 'a t i k s	i ə ɾ 'a t i k s
hipnotisme	i b n u t 'i z m ə	i p n u t 'i z m ə
hitlerià	i l l ə ɾ i 'a	i b b l ə ɾ i 'a
hom	'ɔ m	u m
homes	'ɔ m ə s	u m ə s
honest	u n 'e s t	u n 'ɛ s t
honor	u n 'o r	u n 'o
honors	u n 'o r s	u n 'o s
honra	'o n r ə	'ɔ n r ə
hora	'ɔ ɾ ə	ə 'o ɾ ə
hores	'ɔ ɾ ə s	ə 'o ɾ ə s
hort	'ɔ r t	ə r t
hostessa	u s t 'ɛ s ə	u s t 'e s ə
húmer	'u m ə r	u m ə r
humor	u m 'o r	u m 'o
humus	'u m u s	u m u s
i	'i	i
iaia	j 'a j ə	i 'a j ə
iaies	j 'a j ə s	i 'a j ə s
iaio	j 'a j u	i 'a j u
iber	i β 'e r	i β 'e
iemenita	j ə m ə n 'i t ə	i ə m ə n 'i t ə
immens	i m m 'ɛ n s	i m m 'e n s
immers	i m m 'ɛ r s	i m m 'e s
imparell	i m p ə ɾ 'ɛ ʎ	i m p ə ɾ 'e ʎ
imperfecta	i m p ə r f 'e k t ə	i m p ə r f 'ɛ k t ə
imperfecte	i m p ə r f 'e k t ə	i m p ə r f 'ɛ k t ə
imperfectes	i m p ə r f 'e k t ə s	i m p ə r f 'ɛ k t ə s
imposes	i m p 'ɔ z ə s	i m p 'o z ə s
impremta	i m p ɾ 'e m t ə	i m p ɾ 'ɛ m t ə
imprudentment	i m p ɾ u ð ə m m 'e n	i m p ɾ u ð ə n m 'e n
independentment	i n d ə p ə n d ə m m 'e n	i n d ə p ə n d ə n m 'e n
inodor	i n u ð 'o r	i n u ð 'o
inquiet	i ŋ k i 'e t	i ŋ k i 'ɛ t
insecte	i n s 'e k t ə	i n s 'ɛ k t ə
insistentment	i n s i s t ə m m 'e n	i n s i s t ə n m 'e n
insular	i n s u l 'a r	i n s u l 'a
insulinoma	i n s u l i n 'ɔ m ə	i n s u l i n 'o m ə
insult	i n s 'u l	i n s 'u l t
intens	i n t 'ɛ n s	i n t 'e n s
interior	i n t ə ɾ i 'o r	i n t ə ɾ i 'o
intermitentment	i n t ə r m i t ə m m 'e n	i n t ə r m i t ə n m 'e n
interrompre	i n t ə r 'o m p ɾ ə	i n t ə r 'ɔ m p ɾ ə
invers	i m b 'ɛ r s	i m b 'e s
iònica	j 'ɔ n i k ə	i 'ɔ n i k ə
irregular	i r ə ɣ u l 'a r	i r ə ɣ u l 'a
jaguar	ʒ ə ɣ w 'a r	ʒ ə ɣ w 'a
jazz	ʒ 'a s	ʒ 'a z
jonc	ʒ 'o ŋ	ʒ 'o n s
jove	ʒ 'o β ə	ʒ 'ɔ β ə
joves	ʒ 'o β ə s	ʒ 'ɔ β ə s
jueu	ʒ u 'e w	ʒ u 'ɛ w
jutgessa	ʒ u d ʒ 'ɛ s ə	ʒ u d ʒ 'e s ə
khmer	k m 'e r	k m 'e
la	l 'ə	l ə
labor	l ə β 'o r	l ə β 'o
lacrosse	l ə k ɾ 'o s ə	l ə k ɾ 'ɔ s ə
lema	l 'e m ə	l 'ɛ m ə
lemes	l 'e m ə s	l 'ɛ m ə s
lepra	l 'e p ɾ ə	l 'ɛ p ɾ ə
les	l 'ə s	l ə s
li	l 'i	l i
licor	l i k 'o r	l i k 'o
líquid	l 'i k i t	l 'i k i ð
lisosoma	l i z u z 'ɔ m ə	l i z u z 'o m ə
llagosta	ʎ ə ɣ 'o s t ə	ʎ ə ɣ 'ɔ s t ə
llar	ʎ 'a r	ʎ 'a
llarg	ʎ 'a r k	ʎ 'a r
llargs	ʎ 'a r k s	ʎ 'a r s
llebeig	ʎ ə β 'ɛ t ʃ	ʎ ə β 'ɛ tʃ
llebre	ʎ 'e β ɾ ə	ʎ 'ɛ β ɾ ə
llega	ʎ 'e ɣ ə	ʎ 'ɛ ɣ ə
llegenda	ʎ ə ʒ 'e n d ə	ʎ ə ʒ 'ɛ n d ə
llegendes	ʎ ə ʒ 'e n d ə s	ʎ ə ʒ 'ɛ n d ə s
llegües	ʎ 'e ɣ w ə s	ʎ 'ɛ ɣ w ə s
llei	ʎ 'e j	ʎ 'ɛ j
Lleida	ʎ 'e j ð ə	ʎ 'ɛ j ð ə
lleig	ʎ 'e t ʃ	ʎ 'ɛ tʃ
lleis	ʎ 'e j s	ʎ 'ɛ j s
lleixa	ʎ 'e ʃ ə	ʎ 'ɛ ʃ ə
llenços	ʎ 'e n s u s	ʎ 'ɛ n s u s
llenja	ʎ 'e ɲ ə	ʎ 'ɛ ɲ ə
lleopard	ʎ ə u p 'a r t	ʎ ə u p 'a r
llepa	ʎ 'e p ə	ʎ 'ɛ p ə
llepen	ʎ 'e p ə n	ʎ 'ɛ p ə n
llest	ʎ 'e s t	ʎ 'ɛ s t
llesta	ʎ 'e s t ə	ʎ 'ɛ s t ə
llestes	ʎ 'e s t ə s	ʎ 'ɛ s t ə s
llestos	ʎ 'e s t u s	ʎ 'ɛ s t u s
llet	ʎ 'e t	ʎ 'ɛ t
lletges	ʎ 'e d ʒ ə s	ʎ 'ɛ d ʒ ə s
lletja	ʎ 'e d ʒ ə	ʎ 'ɛ d ʒ ə
lletjos	ʎ 'e d ʒ u s	ʎ 'ɛ d ʒ u s
lleu	ʎ 'e w	ʎ 'ɛ w
lleus	ʎ 'e w s	ʎ 'ɛ w s
lleva	ʎ 'e β ə	ʎ 'ɛ β ə
lleves	ʎ 'e β ə s	ʎ 'ɛ β ə s
llevo	ʎ 'e β u	ʎ 'ɛ β u
lloba	ʎ 'o β ə	ʎ 'ɔ β ə
lloen	ʎ 'o ə n	ʎ 'ɔ ə n
llop	ʎ 'o p	ʎ 'ɔ p
llosa	ʎ 'ɔ z ə	ʎ 'o z ə
lloses	ʎ 'ɔ z ə s	ʎ 'o z ə s
Londres	l 'o n d ɾ ə s	l 'ɔ n d ɾ ə s
lumbar	l u m b 'a r	l u m b 'a
lunar	l u n 'a r	l u n 'a
ma	m 'ə	m ə
macedoni	m ə s ə ð 'ɔ n i	m ə s ə ð 'o n i
Madrid	m ə ð ɾ 'i t	m ə ð ɾ 'i ð
Mahoma	m ə 'ɔ m ə	m ə j m ə
maig	m 'a t ʃ	m 'a tʃ
maldestre	m ə l d 'e s t ɾ ə	m ə l d 'ɛ s t ɾ ə
malifeta	m ə l i f 'e t ə	m ə l i f 'ɛ t ə
malnom	m ə l n 'ɔ m	m ə l n 'o m
malson	m ə l s 'ɔ n	m ə l s 'o n
mànager	m 'a n ə ʒ ə r	m 'a n ə ʒ ə
manc	m 'a ŋ	m 'a n s
maneig	m ə n 'ɛ t ʃ	m ə n 'ɛ tʃ
manifest	m ə n i f 'e s t	m ə n i f 'ɛ s t
manifesti	m ə n i f 'e s t i	m ə n i f 'ɛ s t i
Manresa	m ə n r 'ɛ z ə	m ə n 'ɛ z ə
mareig	m ə ɾ 'ɛ t ʃ	m ə ɾ 'ɛ tʃ
mart	m 'a r t	m 'a r
Mart	m 'a r t	m 'a r
màrtir	m 'a r t i r	m 'a r t i
mastodont	m ə s t u ð 'ɔ n	m ə s t u ð 'o n
matallops	m ə t ə ʎ 'o p s	m ə t ə ʎ 'ɔ p s
mateix	m ə t 'e ʃ	m ə t 'ɛ ʃ
matx	m 'a t ʃ	m 'a tʃ
me	m 'ə	m ə
membre	m 'e m b ɾ ə	m 'ɛ m b ɾ ə
membres	m 'e m b ɾ ə s	m 'ɛ m b ɾ ə s
mencionis	m ə n s i 'ɔ n i s	m ə n s i 'o n i s
mengen	m 'e n ʒ ə n	m 'ɛ n ʒ ə n
menges	m 'e n ʒ ə s	m 'ɛ n ʒ ə s
mengi	m 'e n ʒ i	m 'ɛ n ʒ i
mengin	m 'e n ʒ i n	m 'ɛ n ʒ i n
menja	m 'e n ʒ ə	m 'ɛ n ʒ ə
menjo	m 'e n ʒ u	m 'ɛ n ʒ u
menor	m ə n 'o r	m ə n 'o
mentre	m 'e n t ɾ ə	m 'ɛ n t ɾ ə
mer	m 'e r	m 'e
mero	m 'e ɾ u	m 'ɛ ɾ u
mes	m 'e s	m 'ɛ s
mesos	m 'e z u s	m 'ɛ z u s
mestressa	m ə s t ɾ 'ɛ s ə	m ə s t ɾ 'e s ə
metge	m 'e d ʒ ə	m 'ɛ d ʒ ə
metges	m 'e d ʒ ə s	m 'ɛ d ʒ ə s
metgessa	m ə d ʒ 'ɛ s ə	m ə d ʒ 'e s ə
metxa	m 'e t ʃ ə	m 'ɛ t ʃ ə
meu	m 'e w	m 'ɛ w
meus	m 'e w s	m 'ɛ w s
meva	m 'e β ə	m 'ɛ β ə
meves	m 'e β ə s	m 'ɛ β ə s
mig	m 'i t ʃ	m 'i tʃ
militar	m i l i t 'a r	m i l i t 'a
mocs	m 'o k s	m 'ɔ k s
modest	m u ð 'e s t	m u ð 'ɛ s t
moher	m u 'ɛ r	m u tʃ r
molecular	m u l ə k u l 'a r	m u l ə k u l 'a
moll	m 'ɔ ʎ	m 'o ʎ
molsa	m 'o l s ə	m 'ɔ l s ə
molta	m 'o l t ə	m 'ɔ l t ə
moltes	m 'o l t ə s	m 'ɔ l t ə s
Mon	m 'u n	m u n
monocroma	m u n u k ɾ 'ɔ m ə	m u n u k ɾ 'o m ə
monocromes	m u n u k ɾ 'ɔ m ə s	m u n u k ɾ 'o m ə s
Montblanc	m u m b l 'a ŋ	m u n b b l 'a ŋ
Montcada	m u ŋ k 'a ð ə	m u n k 'a ð ə
mora	m 'ɔ ɾ ə	m 'o ɾ ə
mores	m 'ɔ ɾ ə s	m 'o ɾ ə s
morro	m 'o r u	m 'ɔ r u
morros	m 'o r u s	m 'ɔ r u s
mort	m 'ɔ r t	m 'o r t
mosca	m 'o s k ə	m 'ɔ s k ə
mosques	m 'o s k ə s	m 'ɔ s k ə s
mossa	m 'o s ə	m 'ɔ s ə
mosso	m 'o s u	m 'ɔ s u
mossos	m 'o s u s	m 'ɔ s u s
mot	m 'o t	m 'ɔ t
moto	m 'o t u	m 'ɔ t u
motor	m u t 'o r	m u t 'o
motors	m u t 'o r s	m u t 'o s
motos	m 'o t u s	m 'ɔ t u s
mou	m 'ɔ w	m 'o w
mous	m 'ɔ w s	m 'o w s
multivers	m u l t i β 'ɛ r s	m u l t i β 'e s
muscular	m u s k u l 'a r	m u s k u l 'a
neboda	n ə β 'o ð ə	n ə β 'ɔ ð ə
nebot	n ə β 'o t	n ə β 'ɔ t
neda	n 'e ð ə	n 'ɛ ð ə
neden	n 'e ð ə n	n 'ɛ ð ə n
nedes	n 'e ð ə s	n 'ɛ ð ə s
nega	n 'e ɣ ə	n 'ɛ ɣ ə
neguen	n 'e ɣ ə n	n 'ɛ ɣ ə n
negues	n 'e ɣ ə s	n 'ɛ ɣ ə s
negui	n 'e ɣ i	n 'ɛ ɣ i
neguin	n 'e ɣ i n	n 'ɛ ɣ i n
nens	n 'ɛ n s	n 'e n s
neu	n 'e w	n 'ɛ w
neus	n 'e w s	n 'ɛ w s
neva	n 'e β ə	n 'ɛ β ə
nicens	n i s 'ɛ n s	n i s 'e n s
nihoni	n i 'ɔ n i	n i ə n i
noi	n 'ɔ j	n 'o i
nois	n 'ɔ j s	n 'o i s
nom	n 'ɔ m	n 'o m
noms	n 'ɔ m s	n 'o m s
nora	n 'ɔ ɾ ə	n 'o ɾ ə
nord	n 'ɔ r t	n 'o r
nores	n 'ɔ ɾ ə s	n 'o ɾ ə s
nosa	n 'ɔ z ə	n 'o z ə
noses	n 'ɔ z ə s	n 'o z ə s
nou	n 'ɔ w	n 'o w
nous	n 'ɔ w s	n 'o w s
novembre	n u β 'e m b ɾ ə	n u β 'ɛ m b ɾ ə
nuclear	n u k l e 'a r	n u k l e 'a
o	'ɔ	'o
objecte	u b ʒ 'e k t ə	u b ʒ 'ɛ k t ə
obscens	u p s 'ɛ n s	u p s 'e n s
ocular	u k u l 'a r	u k u l 'a
Odessa	u ð 'ɛ s ə	u ð 'e s ə
oest	u 'e s t	u 'ɛ s t
oi	'ɔ j	'o i
ombra	'o m b ɾ ə	'ɔ m b ɾ ə
ombreig	u m b ɾ 'ɛ t ʃ	u m b ɾ 'ɛ tʃ
ombres	'o m b ɾ ə s	'ɔ m b ɾ ə s
omple	'o m p l ə	'ɔ m p l ə
omplen	'o m p l ə n	'ɔ m p l ə n
omples	'o m p l ə s	'ɔ m p l ə s
omplo	'o m p l u	'ɔ m p l u
oncle	'o ŋ k l ə	'ɔ ŋ k l ə
oncles	'o ŋ k l ə s	'ɔ ŋ k l ə s
onzes	'o n z ə s	'ɔ n z ə s
opta	'o p t ə	'ɔ p t ə
opten	'o p t ə n	'ɔ p t ə n
opto	'o p t u	'ɔ p t u
or	'ɔ r	'o
orca	'o r k ə	'ɔ r k ə
orella	u ɾ 'ɛ ʎ ə	u ɾ 'e ʎ ə
ores	'ɔ ɾ ə s	'o ɾ ə s
ormeig	u r m 'ɛ t ʃ	u r m 'ɛ tʃ
ornament	u r n ə m 'e n	ɔ r n ə m 'e n
orques	'o r k ə s	'ɔ r k ə s
orquestra	u r k 'e s t ɾ ə	u r k 'ɛ s t ɾ ə
ortodox	u r t u ð 'ɔ k s	u r t u ð 'o k s
ortodoxa	u r t u ð 'o k s ə	u r t u ð 'ɔ k s ə
os	'ɔ s	'o s
ou	'ɔ w	'o w
ous	'ɔ w s	'o w s
ovella	u β 'ɛ ʎ ə	u β 'e ʎ ə
ovelles	u β 'ɛ ʎ ə s	u β 'e ʎ ə s
pacientment	p ə s i ə m m 'e n	p ə s i ə n m 'e n
pakistanès	p ə k i s t ə n 'ɛ s	p ə z i s t ə n 'ɛ s
pakistanesa	p ə k i s t ə n 'ɛ z ə	p ə z i s t ə n 'ɛ z ə
pakistaneses	p ə k i s t ə n 'ɛ z ə s	p ə z i s t ə n 'ɛ z ə s
pakistanesos	p ə k i s t ə n 'ɛ z u s	p ə z i s t ə n 'ɛ z u s
pandemoni	p ə n d ə m 'ɔ n i	p ə n d ə m 'o n i
parallamps	p ə ɾ ə ʎ 'a m s	p ə ɾ ə ʎ 'a m p s
paranoic	p ə ɾ ə n 'ɔ j k	p ə ɾ ə n 'o i k
parell	p ə ɾ 'ɛ ʎ	p ə ɾ 'e ʎ
parella	p ə ɾ 'ɛ ʎ ə	p ə ɾ 'e ʎ ə
parer	p ə ɾ 'ɛ	p ə ɾ 'e
parlessin	p ə r l 'e s i n	p ə r l 'ɛ s i n
parpelleig	p ə r p ə ʎ 'ɛ t ʃ	p ə r p ə ʎ 'ɛ tʃ
part	p 'a r t	p 'a r
particular	p ə r t i k u l 'a r	p ə r t i k u l 'a
passaport	p ə s ə p 'ɔ r t	p ə s ə p 'o r t
passaports	p ə s ə p 'ɔ r s	p ə s ə p 'o r t s
passatemps	p ə s ə t 'e m s	p ə s ə t 'ɛ m p s
passeig	p ə s 'ɛ t ʃ	p ə s 'ɛ tʃ
pastitx	p ə s t 'i t ʃ	p ə s t 'i tʃ
patrimoni	p ə t ɾ i m 'ɔ n i	p ə t ɾ i m 'o n i
peculiar	p ə k u l i 'a r	p ə k u l i 'a
pedra	p 'e ð ɾ ə	p 'ɛ ð ɾ ə
pedres	p 'e ð ɾ ə s	p 'ɛ ð ɾ ə s
pega	p 'e ɣ ə	p 'ɛ ɣ ə
pego	p 'e ɣ u	p 'ɛ ɣ u
peguen	p 'e ɣ ə n	p 'ɛ ɣ ə n
pegues	p 'e ɣ ə s	p 'ɛ ɣ ə s
peix	p 'e ʃ	p 'ɛ ʃ
peixos	p 'e ʃ u s	p 'ɛ ʃ u s
pendeloc	p ə n d ə l 'o k	p ə n d ə l 'ɔ k
penetra	p ə n 'e t ɾ ə	p ə n 'ɛ t ɾ ə
pengen	p 'e n ʒ ə n	p 'ɛ n ʒ ə n
penges	p 'e n ʒ ə s	p 'ɛ n ʒ ə s
pengi	p 'e n ʒ i	p 'ɛ n ʒ i
pengin	p 'e n ʒ i n	p 'ɛ n ʒ i n
peninsular	p ə n i n s u l 'a r	p ə n i n s u l 'a
penja	p 'e n ʒ ə	p 'ɛ n ʒ ə
penjo	p 'e n ʒ u	p 'ɛ n ʒ u
penombra	p ə n 'o m b ɾ ə	p ə n 'ɔ m b ɾ ə
pens	p 'ɛ n s	p 'e n s
per	p 'ə r	p ə r
pera	p 'ɛ ɾ ə	p 'e ɾ ə
Pere	p 'e ɾ ə	p 'ɛ ɾ ə
perfecta	p ə r f 'e k t ə	p ə r f 'ɛ k t ə
perfecte	p ə r f 'e k t ə	p ə r f 'ɛ k t ə
perfectes	p ə r f 'e k t ə s	p ə r f 'ɛ k t ə s
perfet	p ə r f 'e t	p ə r f 'ɛ t
perpendicular	p ə r p ə n d i k u l 'a r	p ə r p ə n d i k u l 'a
pesa	p 'e z ə	p 'ɛ z ə
pesen	p 'e z ə n	p 'ɛ z ə n
peses	p 'e z ə s	p 'ɛ z ə s
pesi	p 'e z i	p 'ɛ z i
peso	p 'e z u	p 'ɛ z u
pessebre	p ə s 'e β ɾ ə	p ə s 'ɛ β ɾ ə
pesta	p 'e s t ə	p 'ɛ s t ə
petges	p 'e d ʒ ə s	p 'ɛ d ʒ ə s
petja	p 'e d ʒ ə	p 'ɛ d ʒ ə
pirateig	p i ɾ ə t 'ɛ t ʃ	p i ɾ ə t 'ɛ tʃ
plaer	p l ə 'ɛ	p l ə 'e
plàncton	p l 'a ŋ k t o n	p l 'a ŋ t u n
plataforma	p l ə t ə f 'o r m ə	p l ə t ə f 'ɔ r m ə
plens	p l 'ɛ n s	p l 'e n s
plomo	p l 'o m u	p l 'ɔ m u
plor	p l 'ɔ	p l 'o
plora	p l 'ɔ ɾ ə	p l 'o ɾ ə
plores	p l 'ɔ ɾ ə s	p l 'o ɾ ə s
plou	p l 'ɔ w	p l 'o w
plovisqueig	p l u β i s k 'ɛ t ʃ	p l u β i s k 'ɛ tʃ
plutoni	p l u t 'ɔ n i	p l u t 'o n i
poblen	p 'o b b l ə n	p 'ɔ b b l ə n
poder	p u ð 'ɛ	p u ð 'e
podi	p 'o ð i	p 'ɔ ð i
podis	p 'o ð i s	p 'ɔ ð i s
poetessa	p u ə t 'ɛ s ə	p u ə t 'e s ə
polar	p u l 'a r	p u l 'a
polla	p 'o ʎ ə	p 'ɔ ʎ ə
poloni	p u l 'ɔ n i	p u l 'o n i
polpa	p 'o l p ə	p 'ɔ l p ə
pols	p 'o l s	p 'ɔ l s
poltre	p 'o l t ɾ ə	p 'ɔ l t ɾ ə
polze	p 'o l z ə	p 'ɔ l z ə
pon	p 'ɔ n	p 'o n
pons	p 'ɔ n s	p 'o n s
pont	p 'ɔ n	p 'o n
Pont	p 'ɔ n	p 'o n
pop	p 'o p	p 'ɔ p
popa	p 'o p ə	p 'ɔ p ə
popular	p u p u l 'a r	p u p u l 'a
porc	p 'ɔ r k	p 'o r k
porpra	p 'o r p ɾ ə	p 'ɔ r p ɾ ə
porro	p 'o r u	p 'ɔ r u
porros	p 'o r u s	p 'ɔ r u s
port	p 'ɔ r t	p 'o r t
porus	p 'o ɾ u s	p 'ɔ ɾ u s
posa	p 'ɔ z ə	p 'o z ə
poses	p 'ɔ z ə s	p 'o z ə s
post	p 'ɔ s t	p 'o s t
pòster	p 'ɔ s t ə r	p 'ɔ s t ə
posterior	p u s t ə ɾ i 'o r	p u s t ə ɾ i 'o
prec	p ɾ 'e k	p ɾ 'ɛ k
precepte	p ɾ ə s 'e p t ə	p ɾ ə s 'ɛ p t ə
precoç	p ɾ ə k 'ɔ s	p ɾ ə k 'o s
precs	p ɾ 'e k s	p ɾ 'ɛ k s
prefecte	p ɾ ə f 'e k t ə	p ɾ ə f 'ɛ k t ə
preferentment	p ɾ ə f ə ɾ ə m m 'e n	p ɾ ə f ə ɾ ə n m 'e n
prega	p ɾ 'e ɣ ə	p ɾ 'ɛ ɣ ə
prego	p ɾ 'e ɣ u	p ɾ 'ɛ ɣ u
prematur	p ɾ ə m ə t 'u r	p ɾ ə m ə t 'u
prémer	p ɾ 'e m ə	p ɾ 'e m ə r
premsa	p ɾ 'e m s ə	p ɾ 'ɛ m s ə
prendran	p ə n d ɾ 'a n	p ɾ ə n d ɾ 'a n
prens	p ɾ 'ɛ n s	p ɾ 'e n s
pressupost	p ɾ ə s u p 'ɔ s t	p ɾ ə s u p 'o s t
presta	p ɾ 'e s t ə	p ɾ 'ɛ s t ə
presten	p ɾ 'e s t ə n	p ɾ 'ɛ s t ə n
prestes	p ɾ 'e s t ə s	p ɾ 'ɛ s t ə s
presti	p ɾ 'e s t i	p ɾ 'ɛ s t i
prestin	p ɾ 'e s t i n	p ɾ 'ɛ s t i n
presto	p ɾ 'e s t u	p ɾ 'ɛ s t u
presumpció	p ɾ ə z u m s i 'o	p ɾ ə z u m p s i 'o
pretendre	p ɾ ə t 'e n d ɾ ə	p ɾ ə t 'ɛ n d ɾ ə
prevaler	p ɾ ə β ə l 'ɛ	p ɾ ə β ə l 'e
prior	p ɾ i 'o r	p ɾ i 'o
pro	p ɾ 'ɔ	p ɾ 'o
problemàtic	p ɾ u β l ə m 'a t i k	p ɾ u b b l ə m 'a t i k
problemàtica	p ɾ u β l ə m 'a t i k ə	p ɾ u b b l ə m 'a t i k ə
problemàtics	p ɾ u β l ə m 'a t i k s	p ɾ u b b l ə m 'a t i k s
problemàtiques	p ɾ u β l ə m 'a t i k ə s	p ɾ u b b l ə m 'a t i k ə s
proes	p ɾ 'ɔ ə s	p ɾ 'o ə s
projecte	p ɾ u ʒ 'e k t ə	p ɾ u ʒ 'ɛ k t ə
prona	p ɾ 'ɔ n ə	p ɾ 'o n ə
prones	p ɾ 'ɔ n ə s	p ɾ 'o n ə s
pronom	p ɾ u n 'ɔ m	p ɾ u n 'o m
prosa	p ɾ 'ɔ z ə	p ɾ 'o z ə
protesta	p ɾ u t 'e s t ə	p ɾ u t 'ɛ s t ə
prou	p ɾ 'ɔ w	p ɾ 'o w
prudentment	p ɾ u ð ə m m 'e n	p ɾ u ð ə n m 'e n
puig	p 'u t ʃ	p 'u tʃ
Puig	p 'u t ʃ	p 'u tʃ
pulmonar	p u l m u n 'a r	p u l m u n 'a
quadrilàter	k w ə ð ɾ i l 'a t ə r	k w ə ð ɾ i l 'a t ə
queixa	k 'e ʃ ə	k 'ɛ ʃ ə
quelcom	k ə l k 'ɔ m	k ə l k 'o m
quer	k 'ɛ r	k 'e
quid	k 'i t	k 'i ð
quiet	k i 'e t	k i 'ɛ t
quilowatt	k i l u β 'a t	k i l u β 'a t t
rabeig	r ə β 'ɛ t ʃ	r ə β 'ɛ tʃ
radar	r ə ð 'a r	r ə ð 'a
raig	r 'a t ʃ	r 'a tʃ
raigràs	r ə j ɣ ɾ 'a s	r ə i ɣ ɾ 'a s
rar	r 'a r	r 'a
rars	r 'a r s	r 'a s
rastreig	r ə s t ɾ 'ɛ t ʃ	r ə s t ɾ 'ɛ tʃ
re	r 'ɛ	r ə
rebost	r ə β 'ɔ s t	r ə β 'o s t
rebot	r ə β 'o t	r ə β 'ɔ t
rebrot	r ə β ɾ 'o t	r ə β ɾ 'ɔ t
rebuig	r ə β 'u t ʃ	r ə β 'u tʃ
rec	r 'e k	r 'ɛ k
reca	r 'e k ə	r 'ɛ k ə
recepta	r ə s 'e p t ə	r ə s 'ɛ p t ə
recompte	r ə k 'o m t ə	r ə k 'ɔ m p t ə
record	r ə k 'ɔ r t	r ə k 'o ɾ ð
recorre	r ə k 'o r ə	r ə k 'ɔ r ə
redempció	r ə ð ə m s i 'o	r ə ð ə m p s i 'o
reeixida	r ə ə ʃ 'i ð ə	r e ə ʃ 'i ð ə
reeixides	r ə ə ʃ 'i ð ə s	r e ə ʃ 'i ð ə s
reeixir	r ə ə ʃ 'i	r e ə ʃ 'i
reeixit	r ə ə ʃ 'i t	r e ə ʃ 'i t
reeixits	r ə ə ʃ 'i t s	r e ə ʃ 'i t s
reemplaçament	r e ə m p l ə s ə m 'e n	r ə ə m p l ə s ə m 'e n
refet	r ə f 'e t	r ə f 'ɛ t
refeta	r ə f 'e t ə	r ə f 'ɛ t ə
reforç	r ə f 'ɔ r s	r ə f 'o r s
reforma	r ə f 'o r m ə	r ə f 'ɔ r m ə
rega	r 'e ɣ ə	r 'ɛ ɣ ə
regateig	r ə ɣ ə t 'ɛ t ʃ	r ə ɣ ə t 'ɛ tʃ
rei	r 'e j	r 'ɛ j
reig	r 'e t ʃ	r 'ɛ tʃ
reina	r 'e j n ə	r 'ɛ j n ə
reis	r 'e j s	r 'ɛ j s
reixa	r 'e ʃ ə	r 'ɛ ʃ ə
rella	r 'ɛ ʎ ə	r 'e ʎ ə
relles	r 'ɛ ʎ ə s	r 'e ʎ ə s
relleu	r ə ʎ 'e w	r ə ʎ 'ɛ w
renda	r 'e n d ə	r 'ɛ n d ə
rendes	r 'e n d ə s	r 'ɛ n d ə s
renebot	r ə n ə β 'o t	r ə n ə β 'ɔ t
renec	r ə n 'e k	r ə n 'ɛ k
renom	r ə n 'ɔ m	r ə n 'o m
renou	r ə n 'ɔ w	r ə n 'o w
renten	r 'e n t ə n	r 'ɛ n t ə n
renti	r 'e n t i	r 'ɛ n t i
rentin	r 'e n t i n	r 'ɛ n t i n
repta	r 'e p t ə	r 'ɛ p t ə
repte	r 'e p t ə	r 'ɛ p t ə
reptes	r 'e p t ə s	r 'ɛ p t ə s
repto	r 'e p t u	r 'ɛ p t u
rere	r 'e ɾ ə	r 'ɛ ɾ ə
resa	r 'e z ə	r 'ɛ z ə
resclosa	r ə s k l 'ɔ z ə	r ə s k l 'o z ə
resen	r 'e z ə n	r 'ɛ z ə n
reso	r 'e z u	r 'ɛ z u
respir	r ə s p 'i r	r ə s p 'i
respon	r ə s p 'ɔ n	r ə s p 'o n
respost	r ə s p 'ɔ s t	r ə s p 'o s t
resta	r 'e s t ə	r 'ɛ s t ə
resten	r 'e s t ə n	r 'ɛ s t ə n
restes	r 'e s t ə s	r 'ɛ s t ə s
resti	r 'e s t i	r 'ɛ s t i
restin	r 'e s t i n	r 'ɛ s t i n
resto	r 'e s t u	r 'ɛ s t u
ret	r 'e t	r 'ɛ t
retard	r ə t 'a r t	r ə t 'a r
retir	r ə t 'i r	r ə t 'i
retret	r ə t ɾ 'e t	r ə t ɾ 'ɛ t
retrets	r ə t ɾ 'e t s	r ə t ɾ 'ɛ t s
retrògrad	r ə t ɾ 'ɔ ɣ ɾ ə t	r ə t ɾ 'ɔ ɣ ɾ ə ð
reverend	r ə β ə ɾ 'e n	r ə β ə ɾ 'ɛ n d
revetlla	r ə β 'e ʎ ʎ ə	r ə β 'ɛ ʎ ʎ ə
revolt	r ə β 'ɔ l	r ə β 'o l t
Riad	r i 'a t	r i 'a ð
Ribagorça	r i β ə ɣ 'o r s ə	r i β ə ɣ 'ɔ r s ə
Ricard	r i k 'a r t	r i k 'a r
rigor	r i ɣ 'o r	r i ɣ 'o
rock	r 'ɔ k	r 'o k k
roig	r 'ɔ t ʃ	r 'ɔ tʃ
rombe	r 'o m b ə	r 'ɔ m b ə
rombes	r 'o m b ə s	r 'ɔ m b ə s
rompre	r 'o m p ɾ ə	r 'ɔ m p ɾ ə
ronca	r 'o ŋ k ə	r 'ɔ ŋ k ə
ronda	r 'o n d ə	r 'ɔ n d ə
rondes	r 'o n d ə s	r 'ɔ n d ə s
rosa	r 'ɔ z ə	r 'o z ə
roses	r 'ɔ z ə s	r 'o z ə s
rossa	r 'o s ə	r 'ɔ s ə
rosses	r 'o s ə s	r 'ɔ s ə s
rossos	r 'o s u s	r 'ɔ s u s
rot	r 'o t	r 'ɔ t
rota	r 'o t ə	r 'ɔ t ə
rotaboc	r u t ə β 'o k	r u t ə β 'ɔ k
roti	r 'o t i	r 'ɔ t i
rotonda	r u t 'o n d ə	r u t 'ɔ n d ə
roure	r 'o w ɾ ə	r 'ɔ w ɾ ə
rovell	r u β 'ɛ ʎ	r u β 'e ʎ
rubor	r u β 'o r	r u β 'o
rumor	r u m 'o r	r u m 'o
sa	s 'ə	s ə
saber	s ə β 'ɛ	s ə β 'e
sabor	s ə β 'o r	s ə β 'o
sacseig	s ə k s 'ɛ t ʃ	s ə k s 'ɛ tʃ
safareig	s ə f ə ɾ 'ɛ t ʃ	s ə f ə ɾ 'ɛ tʃ
saig	s 'a t ʃ	s 'a tʃ
sancionin	s ə n s i 'ɔ n i n	s ə n s i 'o n i n
sandvitx	s ə n d b 'i t ʃ	s ə n d b 'i tʃ
saqueig	s ə k 'ɛ t ʃ	s ə k 'ɛ tʃ
sastressa	s ə s t ɾ 'ɛ s ə	s ə s t ɾ 'e s ə
satisfet	s ə t i s f 'e t	s ə t i s f 'ɛ t
satisfeta	s ə t i s f 'e t ə	s ə t i s f 'ɛ t ə
satisfetes	s ə t i s f 'e t ə s	s ə t i s f 'ɛ t ə s
satisfets	s ə t i s f 'e t s	s ə t i s f 'ɛ t s
saxofon	s ə k s u f 'ɔ n	s ə k s u f 'o n
secret	s ə k ɾ 'e t	s ə k ɾ 'ɛ t
secreta	s ə k ɾ 'e t ə	s ə k ɾ 'ɛ t ə
secretes	s ə k ɾ 'e t ə s	s ə k ɾ 'ɛ t ə s
secrets	s ə k ɾ 'e t s	s ə k ɾ 'ɛ t s
secular	s ə k u l 'a r	s ə k u l 'a
sega	s 'e ɣ ə	s 'ɛ ɣ ə
segrest	s ə ɣ ɾ 'e s t	s ə ɣ ɾ 'ɛ s t
segurs	s ə ɣ 'u s	s ə ɣ 'u r s
sembra	s 'e m b ɾ ə	s 'ɛ m b ɾ ə
sembren	s 'e m b ɾ ə n	s 'ɛ m b ɾ ə n
seminoma	s ə m i n 'ɔ m ə	s ə m i n 'o m ə
seminomes	s ə m i n 'ɔ m ə s	s ə m i n 'o m ə s
sempre	s 'e m p ɾ ə	s 'ɛ m p ɾ ə
sencer	s ə n s 'ɛ	s ə n s 'e
senda	s 'e n d ə	s 'ɛ n d ə
sense	s 'e n s ə	s 'ɛ n s ə
senten	s 'e n t ə n	s 'ɛ n t ə n
senti	s 'e n t i	s 'ɛ n t i
sentin	s 'e n t i n	s 'ɛ n t i n
sentis	s 'e n t i s	s 'ɛ n t i s
sento	s 'e n t u	s 'ɛ n t u
serp	s 'e r p	s 'ɛ r p
serreig	s ə r 'ɛ t ʃ	s ə r 'ɛ tʃ
sers	s 'e r s	s 'e s
setembre	s ə t 'e m b ɾ ə	s ə t 'ɛ m b ɾ ə
setge	s 'e d ʒ ə	s 'ɛ d ʒ ə
setges	s 'e d ʒ ə s	s 'ɛ d ʒ ə s
setmana	s ə m m 'a n ə	s ə d m 'a n ə
seu	s 'e w	s 'ɛ w
seus	s 'e w s	s 'ɛ w s
seva	s 'e β ə	s 'ɛ β ə
sever	s ə β 'e r	s ə β 'e
Sever	s ə β 'e r	s ə β 'e
seves	s 'e β ə s	s 'ɛ β ə s
si	s 'i	s i
siboc	s i β 'o k	s i β 'ɔ k
silur	s i l 'u	s i l 'u r
similar	s i m i l 'a r	s i m i l 'a
sistema	s i s t 'e m ə	s i s t 'ɛ m ə
sobre	s 'o β ɾ ə	s 'ɔ β ɾ ə
sobretot	s u β ɾ ə t 'o t	s u β ɾ ə t 'ɔ t
sobta	s 'o p t ə	s 'ɔ p t ə
sofre	s 'o f ɾ ə	s 'ɔ f ɾ ə
solar	s u l 'a r	s u l 'a
solc	s 'ɔ l k	s 'o l k
solell	s u l 'ɛ ʎ	s u l 'e ʎ
solquen	s 'o l k ə n	s 'ɔ l k ə n
solraig	s u l r 'a t ʃ	s u l r 'a tʃ
son	s 'ɔ n	s 'o n
sona	s 'ɔ n ə	s 'o n ə
sonda	s 'o n d ə	s 'ɔ n d ə
sondeig	s u n d 'ɛ t ʃ	s u n d 'ɛ tʃ
sondes	s 'o n d ə s	s 'ɔ n d ə s
sones	s 'ɔ n ə s	s 'o n ə s
soni	s 'ɔ n i	s 'o n i
sonin	s 'ɔ n i n	s 'o n i n
sonis	s 'ɔ n i s	s 'o n i s
sonor	s u n 'o r	s u n 'o
sons	s 'ɔ n s	s 'o n s
sopa	s 'o p ə	s 'ɔ p ə
sopen	s 'o p ə n	s 'ɔ p ə n
sopes	s 'o p ə s	s 'ɔ p ə s
sopluig	s u p l 'u t ʃ	s u p l 'u tʃ
sopor	s u p 'o r	s u p 'o
sord	s 'o r t	s 'o ɾ ð
sorna	s 'o r n ə	s 'ɔ r n ə
sort	s 'ɔ r t	s 'o r t
sorteig	s u r t 'ɛ t ʃ	s u r t 'ɛ tʃ
sospir	s u s p 'i r	s u s p 'i
sota	s 'o t ə	s 'ɔ t ə
sotragueig	s u t ɾ ə ɣ 'ɛ t ʃ	s u t ɾ ə ɣ 'ɛ tʃ
sous	s 'ɔ w s	s 'o w s
subaltern	s u p ə l t 'ɛ r n	s u β ə l t 'ɛ r n
subalterna	s u p ə l t 'ɛ r n ə	s u β ə l t 'ɛ r n ə
subalternes	s u p ə l t 'ɛ r n ə s	s u β ə l t 'ɛ r n ə s
subaquàtic	s u p ə k w 'a t i k	s u β ə k w 'a t i k
subjecte	s u b ʒ 'e k t ə	s u b ʒ 'ɛ k t ə
subratllar	s u b r ə ʎ ʎ 'a	s u β ɾ ə ʎ ʎ 'a
subrogar	s u b r u ɣ 'a	s u β ɾ u ɣ 'a
subsaharià	s u p s ə ə ɾ i 'a	s u p s ə ɣ ɾ i 'a
suèter	s u 'ɛ t ə r	s u 'ɛ t ə
suficientment	s u f i s i ə m m 'e n	s u f i s i ə n m 'e n
superior	s u p ə ɾ i 'o r	s u p ə ɾ i 'o
supero	s u p 'e ɾ u	s u p 'ɛ ɾ u
suport	s u p 'ɔ r t	s u p 'o r t
suprem	s u p ɾ 'e m	s u p ɾ 'ɛ m
tanmateix	t ə m m ə t 'e ʃ	t ə n m ə t 'ɛ ʃ
tard	t 'a r t	t 'a r
tàrtar	t 'a r t ə r	t 'a r t ə
Tàrtar	t 'a r t ə r	t 'a r t ə
tast	t 'a s t	t 'a s
te	t 'ə	t ə
tecla	t 'e k l ə	t 'ɛ k l ə
tecles	t 'e k l ə s	t 'ɛ k l ə s
teix	t 'e ʃ	t 'ɛ ʃ
tem	t 'e m	t 'ɛ m
tema	t 'e m ə	t 'ɛ m ə
temen	t 'e m ə n	t 'ɛ m ə n
témer	t 'e m ə	t 'e m ə r
temes	t 'e m ə s	t 'ɛ m ə s
temo	t 'e m u	t 'ɛ m u
temor	t ə m 'o r	t ə m 'o
tempesta	t ə m p 'e s t ə	t ə m p 'ɛ s t ə
templa	t 'e m p l ə	t 'ɛ m p l ə
temple	t 'e m p l ə	t 'ɛ m p l ə
temples	t 'e m p l ə s	t 'ɛ m p l ə s
temps	t 'e m s	t 'ɛ m p s
tempteig	t ə m t 'ɛ t ʃ	t ə m t 'ɛ tʃ
tenda	t 'e n d ə	t 'ɛ n d ə
tendes	t 'e n d ə s	t 'ɛ n d ə s
tenebra	t ə n 'e β ɾ ə	t ə n 'ɛ β ɾ ə
tenebres	t ə n 'e β ɾ ə s	t ə n 'ɛ β ɾ ə s
tenen	t 'e n ə n	t 'ɛ n ə n
tenor	t ə n 'o r	t ə n 'o
Ter	t 'e r	t 'e
terme	t 'e r m ə	t 'ɛ r m ə
termes	t 'e r m ə s	t 'ɛ r m ə s
terrestre	t ə r 'e s t ɾ ə	t ə r 'ɛ s t ɾ ə
terrestres	t ə r 'e s t ɾ ə s	t ə r 'ɛ s t ɾ ə s
terror	t ə r 'o r	t ə r 'o
test	t 'e s t	t 'ɛ s t
testa	t 'e s t ə	t 'ɛ s t ə
testicular	t ə s t i k u l 'a r	t ə s t i k u l 'a
testimoni	t ə s t i m 'ɔ n i	t ə s t i m 'o n i
testos	t 'e s t u s	t 'ɛ s t u s
teu	t 'e w	t 'ɛ w
teus	t 'e w s	t 'ɛ w s
teva	t 'e β ə	t 'ɛ β ə
teves	t 'e β ə s	t 'ɛ β ə s
text	t 'e k s t	t 'ɛ k s t
textos	t 'e k s t u s	t 'ɛ k s t u s
tigressa	t i ɣ ɾ 'ɛ s ə	t i ɣ ɾ 'e s ə
tir	t 'i r	t 'i
tiroteig	t i ɾ u t 'ɛ t ʃ	t i ɾ u t 'ɛ tʃ
titubeig	t i t u β 'ɛ t ʃ	t i t u β 'ɛ tʃ
titular	t i t u l 'a r	t i t u l 'a
to	t 'ɔ	t 'o
tomba	t 'o m b ə	t 'ɔ m b ə
tomben	t 'o m b ə n	t 'ɔ m b ə n
tombes	t 'o m b ə s	t 'ɔ m b ə s
ton	t 'u n	t u n
tons	t 'ɔ n s	t 'o n s
tonja	t 'ɔ ɲ ə	t 'o ɲ ə
topen	t 'o p ə n	t 'ɔ p ə n
topi	t 'o p i	t 'ɔ p i
topin	t 'o p i n	t 'ɔ p i n
topo	t 'o p u	t 'ɔ p u
torna	t 'o r n ə	t 'ɔ r n ə
torneig	t u r n 'ɛ t ʃ	t u r n 'ɛ tʃ
tornen	t 'o r n ə n	t 'ɔ r n ə n
tornes	t 'o r n ə s	t 'ɔ r n ə s
torni	t 'o r n i	t 'ɔ r n i
tornin	t 'o r n i n	t 'ɔ r n i n
tornis	t 'o r n i s	t 'ɔ r n i s
torno	t 'o r n u	t 'ɔ r n u
torra	t 'ɔ r ə	t 'o r ə
torre	t 'o r ə	t 'ɔ r ə
tors	t 'ɔ r s	t 'o s
tort	t 'ɔ r t	t 'o r t
tosca	t 'o s k ə	t 'ɔ s k ə
tot	t 'o t	t 'ɔ t
tota	t 'o t ə	t 'ɔ t ə
totes	t 'o t ə s	t 'ɔ t ə s
tothom	t u t 'ɔ m	t u t u m
tothora	t u t 'ɔ ɾ ə	t u t ə 'o ɾ ə
totxo	t 'o t ʃ u	t 'ɔ t ʃ u
tova	t 'o β ə	t 'ɔ β ə
transcendència	t ɾ ə s ə n d 'ɛ n s i ə	t ɾ ə n s ə n d 'ɛ n s i ə
transició	t ɾ ə n z i s i 'o	t ɾ ə n s i s i 'o
tremp	t ɾ 'e m	t ɾ 'ɛ m
Tremp	t ɾ 'e m	t ɾ 'ɛ m
trens	t ɾ 'ɛ n s	t ɾ 'e n s
trenta	t ɾ 'ɛ n t ə	t ɾ 'e n t ə
trentes	t ɾ 'ɛ n t ə s	t ɾ 'e n t ə s
trepa	t ɾ 'e p ə	t ɾ 'ɛ p ə
trepes	t ɾ 'e p ə s	t ɾ 'ɛ p ə s
trepig	t ɾ ə p 'i t ʃ	t ɾ ə p 'i k
tresor	t ɾ ə z 'ɔ r	t ɾ ə z 'o
tret	t ɾ 'e t	t ɾ 'ɛ t
treta	t ɾ 'e t ə	t ɾ 'ɛ t ə
tretes	t ɾ 'e t ə s	t ɾ 'ɛ t ə s
trets	t ɾ 'e t s	t ɾ 'ɛ t s
tretze	t ɾ 'e d z ə	t ɾ 'ɛ d z ə
treva	t ɾ 'e β ə	t ɾ 'ɛ β ə
tro	t ɾ 'ɔ	t ɾ 'o
tromba	t ɾ 'o m b ə	t ɾ 'ɔ m b ə
trompa	t ɾ 'o m p ə	t ɾ 'ɔ m p ə
trompes	t ɾ 'o m p ə s	t ɾ 'ɔ m p ə s
tron	t ɾ 'ɔ n	t ɾ 'o n
trona	t ɾ 'ɔ n ə	t ɾ 'o n ə
tronc	t ɾ 'o ŋ	t ɾ 'o ŋ k
trones	t ɾ 'ɔ n ə s	t ɾ 'o n ə s
troni	t ɾ 'ɔ n i	t ɾ 'o n i
tronin	t ɾ 'ɔ n i n	t ɾ 'o n i n
tronis	t ɾ 'ɔ n i s	t ɾ 'o n i s
tropa	t ɾ 'o p ə	t ɾ 'ɔ p ə
tropes	t ɾ 'o p ə s	t ɾ 'ɔ p ə s
tros	t ɾ 'ɔ s	t ɾ 'o s
tsar	t s 'a r	d z 'a
tsarista	t s ə ɾ 'i s t ə	d z ə ɾ 'i s t ə
tubular	t u β u l 'a r	t u β u l 'a
tumor	t u m 'o r	t u m 'o
Txetxènia	t ʃ ə t ʃ 'ɛ n i ə	ʃ ə t ʃ 'ɛ n i ə
udol	u ð 'o l	u ð 'ɔ l
ulterior	u l t ə ɾ i 'o r	u l t ə ɾ i 'o
un	'u n	u n
uniforme	u n i f 'o r m ə	u n i f 'ɔ r m ə
uniformes	u n i f 'o r m ə s	u n i f 'ɔ r m ə s
univers	u n i β 'ɛ r s	u n i β 'e s
uns	'u n s	u n s
us	'u s	u s
úter	'u t ə r	'u t ə
vaig	b 'a t ʃ	b 'a tʃ
valer	b ə l 'ɛ	b ə l 'e
valor	b ə l 'o r	b ə l 'o
vampir	b ə m p 'i r	b ə m p 'i
ve	b 'e	b 'ɛ
vehemència	b ə ə m 'ɛ n s i ə	b e ə m 'ɛ n s i ə
veloç	b ə l 'ɔ s	b ə l 'o s
vens	b 'ɛ n s	b 'e n s
ventre	b 'e n t ɾ ə	b 'ɛ n t ɾ ə
ver	b 'ɛ r	b 'e
verb	b 'ɛ r p	b 'ɛ r
verd	b 'ɛ r t	b 'ɛ r
vermell	b ə r m 'ɛ ʎ	b ə r m 'e ʎ
vermella	b ə r m 'ɛ ʎ ə	b ə r m 'e ʎ ə
vermelles	b ə r m 'ɛ ʎ ə s	b ə r m 'e ʎ ə s
vermells	b ə r m 'ɛ ʎ s	b ə r m 'e ʎ s
vers	b 'ɛ r s	b 'e s
ves	b 'e s	b 'ɛ s
vespa	b 'e s p ə	b 'ɛ s p ə
vespre	b 'e s p ɾ ə	b 'ɛ s p ɾ ə
veure's	b 'ɛ w ɾ ə s	b ə w ɾ 'ɛ s
Vicent	b i s 'ɛ n	b i s 'e n
vigor	b i ɣ 'o r	b i ɣ 'o
virrei	b i r 'e j	b i r 'ɛ j
voler	b u l 'ɛ	b u l 'e
vora	b 'ɔ ɾ ə	b 'o ɾ ə
voto	b 'o t u	b 'ɔ t u
vulgar	b u l ɣ 'a r	b u l ɣ 'a
web	b 'e p	s 'ɛ p
whiskj	w 'i s k i	b 'i s k
xipolleig	ʃ i p u ʎ 'ɛ t ʃ	ʃ i p u ʎ 'ɛ tʃ
xistorra	ʃ i s t 'ɔ r ə	ʃ i s t 'o r ə
xiuxiuejar	ʃ i w ʃ i w ə ʒ 'a	ʃ i w k s i w ə ʒ 'a
xop	ʃ 'o p	ʃ 'ɔ p
xou	ʃ 'ɔ w	ʃ 'o w
zirconi	z i r k 'ɔ n i	z i r k 'o n i
zumzeig	z u m z 'ɛ t ʃ	z u m z 'ɛ tʃ
de	d 'ə	d ə
que	k 'ə	k ə
la	l 'ə	l ə
i	'i	i
a	'ə	ə
el	'ə l	ə l
per	p 'ə r	p ə r
un	'u n	u n
en	'ə n	ə n
les	l 'ə s	l ə s
els	'ə l s	ə l s
del	d 'ə l	d ə l
amb	'ə m	ə m b
al	'ə l	ə l
es	'ə s	ə s
El	'ə l	ə l
dels	d 'ə l s	d ə l s
hi	'i	i
La	l 'ə	l ə
o	'ɔ	'o
si	s 'i	s i
em	'ə m	ə m
li	l 'i	l i
tot	t 'o t	t 'ɔ t
seva	s 'e β ə	s 'ɛ β ə
ens	'ə n s	ə n s
Els	'ə l s	ə l s
A	'ə	ə
aquest	ə k 'ɛ t	ə k 'ɛ s t
als	'ə l s	ə l s
sobre	s 'o β ɾ ə	s 'ɔ β ɾ ə
vaig	b 'a t ʃ	b 'a tʃ
En	'ə n	ə n
Per	p 'ə r	p ə r
Si	s 'i	s i
sense	s 'e n s ə	s 'ɛ n s ə
ho	'u	u
temps	t 'e m s	t 'ɛ m p s
De	d 'ə	d ə
pel	p 'ə l	p ə l
tots	t 'o t s	t 'ɔ t s
entre	'e n t ɾ ə	'ɛ n t ɾ ə
fet	f 'e t	f 'ɛ t
meva	m 'e β ə	m 'ɛ β ə
jo	ʒ 'ɔ	ʒ 'o
sempre	s 'e m p ɾ ə	s 'ɛ m p ɾ ə
I	'i	i
he	'e	'ɛ
us	'u s	u s
uns	'u n s	u n s
mateix	m ə t 'e ʃ	m ə t 'ɛ ʃ
cosa	k 'ɔ z ə	k 'o z ə
seves	s 'e β ə s	s 'ɛ β ə s
se	s 'ə	s ə
Un	'u n	u n
Les	l 'ə s	l ə s
sistema	s i s t 'e m ə	s i s t 'ɛ m ə
Em	'ə m	ə m
tota	t 'o t ə	t 'ɔ t ə
et	'ə t	ə t
mentre	m 'e n t ɾ ə	m 'ɛ n t ɾ ə
des	d 'e s	d 'ɛ s
Jo	ʒ 'ɔ	ʒ 'o
Es	'ə s	ə s
poder	p u ð 'ɛ	p u ð 'e
Al	'ə l	ə l
hores	'ɔ ɾ ə s	ə 'o ɾ ə s
aquell	ə k 'ɛ ʎ	ə k 'e ʎ
totes	t 'o t ə s	t 'ɔ t ə s
Aquest	ə k 'ɛ t	ə k 'ɛ s t
part	p 'a r t	p 'a r
coses	k 'ɔ z ə s	k 'o z ə s
setmana	s ə m m 'a n ə	s ə d m 'a n ə
Hi	'i	i
dona	d 'ɔ n ə	d 'o n ə
haver	ə β 'ɛ	ə β 'e
nom	n 'ɔ m	n 'o m
tenen	t 'e n ə n	t 'ɛ n ə n
Li	l 'i	l i
Amb	'ə m	ə m b
nens	n 'ɛ n s	n 'e n s
centre	s 'e n t ɾ ə	s 'ɛ n t ɾ ə
sota	s 'o t ə	s 'ɔ t ə
aquests	ə k 'ɛ t s	ə k 'ɛ s t s
bon	b 'ɔ n	b 'o n
ben	b 'e n	b 'ɛ n
pels	p 'ə l s	p ə l s
bona	b 'ɔ n ə	b 'o n ə
aquella	ə k 'ɛ ʎ ə	ə k 'e ʎ ə
saber	s ə β 'ɛ	s ə β 'e
mig	m 'i t ʃ	m 'i tʃ
mesos	m 'e z u s	m 'ɛ z u s
finestra	f i n 'e s t ɾ ə	f i n 'ɛ s t ɾ ə
cotxe	k 'o t ʃ ə	k 'ɔ t ʃ ə
compte	k 'o m t ə	k 'ɔ m p t ə
Ho	'u	u
moltes	m 'o l t ə s	m 'ɔ l t ə s
mateixa	m ə t 'e ʃ ə	m ə t 'ɛ ʃ ə
eren	'e ɾ ə n	'ɛ ɾ ə n
mes	m 'e s	m 'ɛ s
Queden	k 'e ð ə n	k 'ɛ ð ə n
web	b 'e p	s 'ɛ p
mort	m 'ɔ r t	m 'o r t
cos	k 'ɔ s	k 'o s
forma	f 'o r m ə	f 'ɔ r m ə
fora	f 'ɔ ɾ ə	f 'o ɾ ə
ve	b 'e	b 'ɛ
llei	ʎ 'e j	ʎ 'ɛ j
trenta	t ɾ 'ɛ n t ə	t ɾ 'e n t ə
sento	s 'e n t u	s 'ɛ n t u
He	'e	'ɛ
hora	'ɔ ɾ ə	ə 'o ɾ ə
Vaig	b 'a t ʃ	b 'a tʃ
se'n	s 'ə n	s 'ɛ n
parell	p ə ɾ 'ɛ ʎ	p ə ɾ 'e ʎ
Tot	t 'o t	t 'ɔ t
darrere	d ə r 'e ɾ ə	d ə r 'ɛ ɾ ə
teva	t 'e β ə	t 'ɛ β ə
exemple	ə g z 'e m p l ə	ə g z 'ɛ m p l ə
tretze	t ɾ 'e d z ə	t ɾ 'ɛ d z ə
tothom	t u t 'ɔ m	t u t u m
tema	t 'e m ə	t 'ɛ m ə
molta	m 'o l t ə	m 'ɔ l t ə
dotze	d 'o d z ə	d 'ɔ d z ə
dones	d 'ɔ n ə s	d 'o n ə s
aquells	ə k 'ɛ ʎ s	ə k 'e ʎ s
queda	k 'e ð ə	k 'ɛ ð ə
noi	n 'ɔ j	n 'o i
fort	f 'ɔ r t	f 'o r t
Ens	'ə n s	ə n s
valors	b ə l 'o r s	b ə l 'o s
llengua	ʎ 'e ŋ g w ə	ʎ 'ɛ ŋ g w ə
veig	b 'ɛ t ʃ	b 'ɛ tʃ
bancs	b 'a ŋ s	b 'a ŋ k s
tard	t 'a r t	t 'a r
segle	s 'e g g l ə	s 'ɛ ɣ l ə
Tots	t 'o t s	t 'ɔ t s
tros	t ɾ 'ɔ s	t ɾ 'o s
fred	f ɾ 'ɛ t	f ɾ 'e t
cabell	k ə β 'ɛ ʎ	k ə β 'e ʎ
Que	k 'ə	k ə
verd	b 'ɛ r t	b 'ɛ r
jove	ʒ 'o β ə	ʒ 'ɔ β ə
fets	f 'e t s	f 'ɛ t s
catorze	k ə t 'o r z ə	k ə t 'ɔ r z ə
Mentre	m 'e n t ɾ ə	m 'ɛ n t ɾ ə
records	r ə k 'ɔ r s	r ə k 'o r s
joves	ʒ 'o β ə s	ʒ 'ɔ β ə s
banc	b 'a ŋ	b 'a ŋ k
Sempre	s 'e m p ɾ ə	s 'ɛ m p ɾ ə
sobretot	s u β ɾ ə t 'o t	s u β ɾ ə t 'ɔ t
objectes	u b ʒ 'e k t ə s	u b ʒ 'ɛ k t ə s
faig	f 'a t ʃ	f 'a tʃ
to	t 'ɔ	t 'o
projecte	p ɾ u ʒ 'e k t ə	p ɾ u ʒ 'ɛ k t ə
meves	m 'e β ə s	m 'ɛ β ə s
flors	f l 'ɔ s	f l 'o s
dissabte	d i s 'a p t ə	d i s 'a b b t ə
Aquell	ə k 'ɛ ʎ	ə k 'e ʎ
resta	r 'e s t ə	r 'ɛ s t ə
terme	t 'e r m ə	t 'ɛ r m ə
llarg	ʎ 'a r k	ʎ 'a r
deixa	d 'e ʃ ə	d 'ɛ ʃ ə
d'acord	d ə k 'ɔ r t	d ə k 'o r t
cor	k 'ɔ r	k 'o
boca	b 'o k ə	b 'ɔ k ə
aquelles	ə k 'ɛ ʎ ə s	ə k 'e ʎ ə s
temes	t 'e m ə s	t 'ɛ m ə s
tecla	t 'e k l ə	t 'ɛ k l ə
parella	p ə ɾ 'ɛ ʎ ə	p ə ɾ 'e ʎ ə
homes	'ɔ m ə s	u m ə s
centres	s 'e n t ɾ ə s	s 'ɛ n t ɾ ə s
bar	b 'a r	b 'a
Madrid	m ə ð ɾ 'i t	m ə ð ɾ 'i ð
Lleida	ʎ 'e j ð ə	ʎ 'ɛ j ð ə
Des	d 'e s	d 'ɛ s
Aquests	ə k 'ɛ t s	ə k 'ɛ s t s
se'ls	s 'ə l s	s 'ɛ l s
peix	p 'e ʃ	p 'ɛ ʃ
maig	m 'a t ʃ	m 'a tʃ
favor	f ə β 'o r	f ə β 'o
d'aquell	d ə k 'ɛ ʎ	d ə k 'e ʎ
camps	k 'a m s	k 'a m p s
Aquella	ə k 'ɛ ʎ ə	ə k 'e ʎ ə
trens	t ɾ 'ɛ n s	t ɾ 'e n s
cabells	k ə β 'ɛ ʎ s	k ə β 'e ʎ s
vora	b 'ɔ ɾ ə	b 'o ɾ ə
posa	p 'ɔ z ə	p 'o z ə
bosc	b 'ɔ s k	b 'o s k
aspectes	ə s p 'e k t ə s	ə s p 'ɛ k t ə s
valor	b ə l 'o r	b ə l 'o
se'ns	s 'ə n s	s 'ɛ n s
s'ho	s 'u	s u
noms	n 'ɔ m s	n 'o m s
festa	f 'e s t ə	f 'ɛ s t ə
fes	f 'e s	f 'ɛ s
desembre	d ə z 'e m b ɾ ə	d ə z 'ɛ m b ɾ ə
torna	t 'o r n ə	t 'ɔ r n ə
suport	s u p 'ɔ r t	s u p 'o r t
queden	k 'e ð ə n	k 'ɛ ð ə n
peixos	p 'e ʃ u s	p 'ɛ ʃ u s
l'hora	l 'ɔ ɾ ə	l i 'o ɾ ə
haig	'a t ʃ	'a tʃ
foto	f 'o t u	f 'ɔ t u
concret	k u ŋ k ɾ 'e t	k u ŋ k ɾ 'ɛ t
coll	k 'ɔ ʎ	k 'o ʎ
Pere	p 'e ɾ ə	p 'ɛ ɾ ə
O	'ɔ	'o
sons	s 'ɔ n s	s 'o n s
setembre	s ə t 'e m b ɾ ə	s ə t 'ɛ m b ɾ ə
conte	k 'o n t ə	k 'ɔ n t ə
bo	b 'ɔ	b 'o
a	'ə	ə
flor	f l 'ɔ	f l 'o
d'aquella	d ə k 'ɛ ʎ ə	d ə k 'e ʎ ə
bossa	b 'o s ə	b 'ɔ s ə
bones	b 'ɔ n ə s	b 'o n ə s
Entre	'e n t ɾ ə	'ɛ n t ɾ ə
pedra	p 'e ð ɾ ə	p 'ɛ ð ɾ ə
novembre	n u β 'e m b ɾ ə	n u β 'ɛ m b ɾ ə
nois	n 'ɔ j s	n 'o i s
formes	f 'o r m ə s	f 'ɔ r m ə s
cotxes	k 'o t ʃ ə s	k 'ɔ t ʃ ə s
compra	k 'o m p ɾ ə	k 'ɔ m p ɾ ə
anterior	ə n t ə ɾ i 'o r	ə n t ə ɾ i 'o
Us	'u s	u s
vermell	b ə r m 'ɛ ʎ	b ə r m 'e ʎ
setmanes	s ə m m 'a n ə s	s ə d m 'a n ə s
respecte	r ə s p 'e k t ə	r ə s p 'ɛ k t ə
record	r ə k 'ɔ r t	r ə k 'o ɾ ð
me	m 'ə	m ə
mateixos	m ə t 'e ʃ u s	m ə t 'ɛ ʃ u s
gossos	g 'o s u s	g 'ɔ s u s
feta	f 'e t ə	f 'ɛ t ə
d'aquells	d ə k 'ɛ ʎ s	d ə k 'e ʎ s
amor	ə m 'o r	ə m 'o
Pel	p 'ə l	p ə l
Et	'ə t	ə t
se'm	s 'ə m	s 'ɛ m
plens	p l 'ɛ n s	p l 'e n s
dimecres	d i m 'e k ɾ ə s	d i m 'ɛ k ɾ ə s
deixen	d 'e ʃ ə n	d 'ɛ ʃ ə n
Sense	s 'e n s ə	s 'ɛ n s ə
transport	t ɾ ə n s p 'ɔ r t	t ɾ ə n s p 'o r t
processos	p ɾ u s 'e s u s	p ɾ u s 'ɛ s u s
pols	p 'o l s	p 'ɔ l s
pedres	p 'e ð ɾ ə s	p 'ɛ ð ɾ ə s
passeig	p ə s 'ɛ t ʃ	p ə s 'ɛ tʃ
membres	m 'e m b ɾ ə s	m 'ɛ m b ɾ ə s
font	f 'ɔ n	f 'o n
esforç	ə s f 'ɔ r s	ə s f 'o r s
desig	d ə z 'i t ʃ	d ə z 'i ɣ
alhora	ə l 'ɔ ɾ ə	ə l i 'o ɾ ə
Se	s 'ə	s ə
textos	t 'e k s t u s	t 'ɛ k s t u s
tempesta	t ə m p 'e s t ə	t ə m p 'ɛ s t ə
objecte	u b ʒ 'e k t ə	u b ʒ 'ɛ k t ə
fosca	f 'o s k ə	f 'ɔ s k ə
fer-ho	f 'e ɾ u	f 'ɛ ɾ u
entendre	ə n t 'e n d ɾ ə	ə n t 'ɛ n d ɾ ə
dolça	d 'o l s ə	d 'ɔ l s ə
defecte	d ə f 'e k t ə	d ə f 'ɛ k t ə
correspon	k u r ə s p 'ɔ n	k u r ə s p 'o n
Manresa	m ə n r 'ɛ z ə	m ə n 'ɛ z ə
Consell	k u n s 'ɛ ʎ	k u n s 'e ʎ
ves	b 'e s	b 'ɛ s
tret	t ɾ 'e t	t ɾ 'ɛ t
torno	t 'o r n u	t 'ɔ r n u
sistemes	s i s t 'e m ə s	s i s t 'ɛ m ə s
respon	r ə s p 'ɔ n	r ə s p 'o n
queixes	k 'e ʃ ə s	k 'ɛ ʃ ə s
metges	m 'e d ʒ ə s	m 'ɛ d ʒ ə s
gest	ʒ 'e s t	ʒ 'ɛ s t
formen	f 'o r m ə n	f 'ɔ r m ə n
festes	f 'e s t ə s	f 'ɛ s t ə s
cognoms	k u g n 'ɔ m s	k u g n 'o m s
caràcter	k ə ɾ 'a k t ə r	k ə ɾ 'a k t ə
caos	k 'a o s	k 'a u s
bons	b 'ɔ n s	b 'o n s
boig	b 'ɔ t ʃ	b 'ɔ tʃ
aspecte	ə s p 'e k t ə	ə s p 'ɛ k t ə
arbre	'a β ɾ ə	'a ɾ β ɾ ə
i	'i	i
vespre	b 'e s p ɾ ə	b 'ɛ s p ɾ ə
sabent	s ə β 'ɛ n	s ə β 'e n
reforma	r ə f 'o r m ə	r ə f 'ɔ r m ə
quedo	k 'e ð u	k 'ɛ ð u
projectes	p ɾ u ʒ 'e k t ə s	p ɾ u ʒ 'ɛ k t ə s
nord	n 'ɔ r t	n 'o r
menor	m ə n 'o r	m ə n 'o
lleis	ʎ 'e j s	ʎ 'ɛ j s
hom	'ɔ m	u m
enrere	ə n r 'e ɾ ə	ə n 'ɛ ɾ ə
doble	d 'o b b l ə	d 'ɔ b b l ə
disposen	d i s p 'o z ə n	d i s p 'ɔ z ə n
cercle	s 'e r k l ə	s 'ɛ r k l ə
arbres	'a β ɾ ə s	'a ɾ β ɾ ə s
Moltes	m 'o l t ə s	m 'ɔ l t ə s
D'acord	d ə k 'ɔ r t	d ə k 'o r t
Als	'ə l s	ə l s
ésser	'e s ə r	'e s ə
A	'ə	ə
voler	b u l 'ɛ	b u l 'e
trets	t ɾ 'e t s	t ɾ 'ɛ t s
son	s 'ɔ n	s 'o n
restes	r 'e s t ə s	r 'ɛ s t ə s
popular	p u p u l 'a r	p u p u l 'a
menors	m ə n 'o r s	m ə n 'o s
fer-me	f 'e r m ə	f 'ɛ r m ə
d'aquelles	d ə k 'ɛ ʎ ə s	d ə k 'e ʎ ə s
bombes	b 'o m b ə s	b 'ɔ m b ə s
vermelles	b ə r m 'ɛ ʎ ə s	b ə r m 'e ʎ ə s
transports	t ɾ ə n s p 'ɔ r s	t ɾ ə n s p 'o r t s
trajecte	t ɾ ə ʒ 'e k t ə	t ɾ ə ʒ 'ɛ k t ə
teves	t 'e β ə s	t 'ɛ β ə s
se'l	s 'ə l	s 'ɛ l
s'aixeca	s ə ʃ 'e k ə	s ə ʃ 'ɛ k ə
presenten	p ɾ ə z 'e n t ə n	p ɾ ə z 'ɛ n t ə n
plaer	p l ə 'ɛ	p l ə 'e
perd	p 'ɛ r t	p 'ɛ r
llar	ʎ 'a r	ʎ 'a
interior	i n t ə ɾ i 'o r	i n t ə ɾ i 'o
interessa	i n t ə ɾ 'ɛ s ə	i n t ə ɾ 'e s ə
fotos	f 'o t u s	f 'ɔ t u s
fonts	f 'ɔ n s	f 'o n s
finestres	f i n 'e s t ɾ ə s	f i n 'ɛ s t ɾ ə s
fer-se	f 'e r s ə	f 'ɛ r s ə
esport	ə s p 'ɔ r t	ə s p 'o r t
deixo	d 'e ʃ u	d 'ɛ ʃ u
ampolla	ə m p 'o ʎ ə	ə m p 'ɔ ʎ ə
acord	ə k 'ɔ r t	ə k 'o r t
Veig	b 'ɛ t ʃ	b 'ɛ tʃ
Sento	s 'e n t u	s 'ɛ n t u
Guíxols	g 'i k s u l s	g 'i ʃ u l s
Faig	f 'a t ʃ	f 'a tʃ
Dissabte	d i s 'a p t ə	d i s 'a b b t ə
Conca	k 'o ŋ k ə	k 'ɔ ŋ k ə
tronc	t ɾ 'o ŋ	t ɾ 'o ŋ k
sentin	s 'e n t i n	s 'ɛ n t i n
segles	s 'e g g l ə s	s 'ɛ ɣ l ə s
representen	r ə p ɾ ə z 'e n t ə n	r ə p ɾ ə z 'ɛ n t ə n
regles	r 'e g g l ə s	r 'ɛ ɣ l ə s
quedi	k 'e ð i	k 'ɛ ð i
provoca	p ɾ u β 'o k ə	p ɾ u β 'ɔ k ə
pressupost	p ɾ ə s u p 'ɔ s t	p ɾ ə s u p 'o s t
premsa	p ɾ 'e m s ə	p ɾ 'ɛ m s ə
port	p 'ɔ r t	p 'o r t
parelles	p ə ɾ 'ɛ ʎ ə s	p ə ɾ 'e ʎ ə s
metge	m 'e d ʒ ə	m 'ɛ d ʒ ə
llargs	ʎ 'a r k s	ʎ 'a r s
immens	i m m 'ɛ n s	i m m 'e n s
gros	g ɾ 'ɔ s	g ɾ 'o s
familiars	f ə m i l i 'a r s	f ə m i l i 'a s
error	ə r 'o r	ə r 'o
enorme	ə n 'o r m ə	ə n 'ɔ r m ə
conceptes	k u n s 'e p t ə s	k u n s 'ɛ p t ə s
comptes	k 'o m t ə s	k 'ɔ m p t ə s
atendre	ə t 'e n d ɾ ə	ə t 'ɛ n d ɾ ə
abelles	ə β 'ɛ ʎ ə s	ə β 'e ʎ ə s
Uns	'u n s	u n s
Totes	t 'o t ə s	t 'ɔ t ə s
Boi	b 'ɔ j	b 'o i
tornes	t 'o r n ə s	t 'ɔ r n ə s
tinguessin	t i ŋ g 'e s i n	t i ŋ g 'ɛ s i n
termes	t 'e r m ə s	t 'ɛ r m ə s
t'he	t 'e	t 'ɛ
solar	s u l 'a r	s u l 'a
rugbi	r 'u g b i	r 'u g β i
rosa	r 'ɔ z ə	r 'o z ə
particular	p ə r t i k u l 'a r	p ə r t i k u l 'a
mots	m 'o t s	m 'ɔ t s
moto	m 'o t u	m 'ɔ t u
mot	m 'o t	m 'ɔ t
llest	ʎ 'e s t	ʎ 'ɛ s t
llengües	ʎ 'e ŋ g w ə s	ʎ 'ɛ ŋ g w ə s
l'univers	l u n i β 'ɛ r s	l u n i β 'e s
gola	g 'o l ə	g 'ɔ l ə
enmig	ə m m 'i t ʃ	ə n m 'i tʃ
efectes	ə f 'e k t ə s	ə f 'ɛ k t ə s
distret	d i s t ɾ 'e t	d i s t ɾ 'ɛ t
contes	k 'o n t ə s	k 'ɔ n t ə s
consell	k u n s 'ɛ ʎ	k u n s 'e ʎ
concepte	k u n s 'e p t ə	k u n s 'ɛ p t ə
Tremp	t ɾ 'e m	t ɾ 'ɛ m
Tothom	t u t 'ɔ m	t u t u m
Peso	p 'e z u	p 'ɛ z u
Pesa	p 'e z ə	p 'ɛ z ə
Fes	f 'e s	f 'ɛ s
Per	p 'ə r	p ə r
En	'ə n	ə n
vers	b 'ɛ r s	b 'e s
secret	s ə k ɾ 'e t	s ə k ɾ 'ɛ t
raig	r 'a t ʃ	r 'a tʃ
plataforma	p l ə t ə f 'o r m ə	p l ə t ə f 'ɔ r m ə
peninsular	p ə n i n s u l 'a r	p ə n i n s u l 'a
orelles	u ɾ 'ɛ ʎ ə s	u ɾ 'e ʎ ə s
morts	m 'ɔ r s	m 'o r t s
militar	m i l i t 'a r	m i l i t 'a
menja	m 'e n ʒ ə	m 'ɛ n ʒ ə
mateixes	m ə t 'e ʃ ə s	m ə t 'ɛ ʃ ə s
intento	i n t 'e n t u	i n t 'ɛ n t u
intenten	i n t 'e n t ə n	i n t 'ɛ n t ə n
humor	u m 'o r	u m 'o
golf	g 'ɔ l f	g 'o l f
fossin	f 'o s i n	f 'ɔ s i n
fantasia	f ə n t ə z 'i ə	f ə n t ə s 'i ə
familiar	f ə m i l i 'a r	f ə m i l i 'a
errors	ə r 'o r s	ə r 'o s
entren	'e n t ɾ ə n	'ɛ n t ɾ ə n
enormes	ə n 'o r m ə s	ə n 'ɔ r m ə s
cost	k 'ɔ s t	k 'o s t
corre	k 'o r ə	k 'ɔ r ə
copes	k 'o p ə s	k 'ɔ p ə s
afores	ə f 'ɔ ɾ ə s	ə f 'o ɾ ə s
Torna	t 'o r n ə	t 'ɔ r n ə
Eren	'e ɾ ə n	'ɛ ɾ ə n
Compte	k 'o m t ə	k 'ɔ m p t ə
Bon	b 'ɔ n	b 'o n
Antoni	ə n t 'ɔ n i	ə n t 'o n i
vivendes	b i β 'e n d ə s	b i β 'ɛ n d ə s
vivenda	b i β 'e n d ə	b i β 'ɛ n d ə
vermells	b ə r m 'ɛ ʎ s	b ə r m 'e ʎ s
vermella	b ə r m 'ɛ ʎ ə	b ə r m 'e ʎ ə
tornen	t 'o r n ə n	t 'ɔ r n ə n
tast	t 'a s t	t 'a s
sona	s 'ɔ n ə	s 'o n ə
similar	s i m i l 'a r	s i m i l 'a
segurs	s ə ɣ 'u s	s ə ɣ 'u r s
repte	r 'e p t ə	r 'ɛ p t ə
recompte	r ə k 'o m t ə	r ə k 'ɔ m p t ə
quiet	k i 'e t	k i 'ɛ t
quelcom	k ə l k 'ɔ m	k ə l k 'o m
queixa	k 'e ʃ ə	k 'ɛ ʃ ə
plàncton	p l 'a ŋ k t o n	p l 'a ŋ t u n
plor	p l 'ɔ	p l 'o
perfecte	p ə r f 'e k t ə	p ə r f 'ɛ k t ə
neboda	n ə β 'o ð ə	n ə β 'ɔ ð ə
lo	l 'u	l u
llop	ʎ 'o p	ʎ 'ɔ p
llagosta	ʎ ə ɣ 'o s t ə	ʎ ə ɣ 'ɔ s t ə
l'orella	l u ɾ 'ɛ ʎ ə	l u ɾ 'e ʎ ə
intens	i n t 'ɛ n s	i n t 'e n s
herois	ə ɾ 'ɔ j s	ə ɾ 'o i s
gotes	g 'o t ə s	g 'ɔ t ə s
gota	g 'o t ə	g 'ɔ t ə
glop	g l 'o p	g l 'ɔ p
fosques	f 'o s k ə s	f 'ɔ s k ə s
fetge	f 'e d ʒ ə	f 'ɛ d ʒ ə
feix	f 'e ʃ	f 'ɛ ʃ
evidentment	ə β i ð ə m m 'e n	ə β i ð ə n m 'e n
esports	ə s p 'ɔ r s	ə s p 'o r t s
esperi	ə s p 'e ɾ i	ə s p 'ɛ ɾ i
entenc	ə n t 'e ŋ	ə n t 'ɛ ŋ
endarrere	ə n d ə r 'e ɾ ə	ə n d ə r 'ɛ ɾ ə
encendre	ə n s 'e n d ɾ ə	ə n s 'ɛ n d ɾ ə
donen	d 'o n ə n	d 'ɔ n ə n
dimonis	d i m 'ɔ n i s	d i m 'o n i s
descens	d ə s 'ɛ n s	d ə s 'e n s
desa	d 'e z ə	d 'ɛ z ə
deixi	d 'e ʃ i	d 'ɛ ʃ i
d'hora	d 'ɔ ɾ ə	d i 'o ɾ ə
creix	k ɾ 'e ʃ	k ɾ 'ɛ ʃ
convoquen	k u m b 'o k ə n	k u m b 'ɔ k ə n
concerts	k u n s 'ɛ r s	k u n s 'ɛ r t s
compta	k 'o m t ə	k 'ɔ m t ə
compro	k 'o m p ɾ u	k 'ɔ m p ɾ u
aliment	ə l i m 'e n	a l i m 'e n
agenda	ə ʒ 'e n d ə	ə ʒ 'ɛ n d ə
Santander	s ə n t ə n d 'e r	s ə n t ə n d 'e
Respecte	r ə s p 'e k t ə	r ə s p 'ɛ k t ə
Londres	l 'o n d ɾ ə s	l 'ɔ n d ɾ ə s
Intento	i n t 'e n t u	i n t 'ɛ n t u
Horts	'ɔ r s	ə r t s
Evidentment	ə β i ð ə m m 'e n	ə β i ð ə n m 'e n
Deixo	d 'e ʃ u	d 'ɛ ʃ u
Coll	k 'ɔ ʎ	k 'o ʎ
Bona	b 'ɔ n ə	b 'o n ə
Benidorm	b ə n i ð 'o r m	b ə n i ð 'o m
o	'ɔ	'o
per	p 'ə r	p ə r
torni	t 'o r n i	t 'ɔ r n i
tons	t 'ɔ n s	t 'o n s
testimonis	t ə s t i m 'ɔ n i s	t ə s t i m 'o n i s
te	t 'ə	t ə
suposa	s u p 'ɔ z ə	s u p 'o z ə
sencera	s ə n s 'ɛ ɾ ə	s ə n s 'e ɾ ə
sabor	s ə β 'o r	s ə β 'o
s'adonessin	s ə ð u n 'e s i n	s ə ð u n 'ɛ s i n
retrobo	r ə t ɾ 'o β u	r ə t ɾ 'ɔ β u
renda	r 'e n d ə	r 'ɛ n d ə
prendrà	p ə n d ɾ 'a	p ɾ ə n d ɾ 'a
parer	p ə ɾ 'ɛ	p ə ɾ 'e
oberts	u β 'ɛ r s	u β 'ɛ r t s
neix	n 'e ʃ	n 'ɛ ʃ
n'he	n 'e	n 'ɛ
motor	m u t 'o r	m u t 'o
menjo	m 'e n ʒ u	m 'ɛ n ʒ u
membre	m 'e m b ɾ ə	m 'ɛ m b ɾ ə
mantenen	m ə n t 'e n ə n	m ə n t 'ɛ n ə n
malson	m ə l s 'ɔ n	m ə l s 'o n
lleixa	ʎ 'e ʃ ə	ʎ 'ɛ ʃ ə
grega	g ɾ 'e ɣ ə	g ɾ 'ɛ ɣ ə
goig	g 'ɔ t ʃ	g 'ɔ tʃ
foscos	f 'o s k u s	f 'ɔ s k u s
forts	f 'ɔ r s	f 'o r t s
foren	f 'o ɾ ə n	f 'ɔ ɾ ə n
fer-nos	f 'e r n u s	f 'ɛ r n u s
fer-li	f 'e r l i	f 'ɛ r l i
farigola	f ə ɾ i ɣ 'o l ə	f ə ɾ i ɣ 'ɔ l ə
exterior	ə k s t ə ɾ i 'o r	ə k s t ə ɾ i 'o
esperen	ə s p 'e ɾ ə n	ə s p 'ɛ ɾ ə n
escolar	ə s k u l 'a r	ə s k u l 'a
element	ə l ə m 'e n	ɛ l ə m 'e n
eix	'e ʃ	'ɛ ʃ
distreta	d i s t ɾ 'e t ə	d i s t ɾ 'ɛ t ə
dimoni	d i m 'ɔ n i	d i m 'o n i
creixi	k ɾ 'e ʃ i	k ɾ 'ɛ ʃ i
corren	k 'o r ə n	k 'ɔ r ə n
comparseros	k u m p ə r s 'e ɾ u s	k u m p ə r s 'ɛ ɾ u s
cognom	k u g n 'ɔ m	k u g n 'o m
celles	s 'ɛ ʎ ə s	s 'e ʎ ə s
celebra	s ə l 'e β ɾ ə	s ə l 'ɛ β ɾ ə
aparells	ə p ə ɾ 'ɛ ʎ s	ə p ə ɾ 'e ʎ s
Sota	s 'o t ə	s 'ɔ t ə
Pontevedra	p u n t ə β 'e ð ɾ ə	p u n t ə β 'ɛ ð ɾ ə
Pels	p 'ə l s	p ə l s
Menjo	m 'e n ʒ u	m 'ɛ n ʒ u
Espero	ə s p 'e ɾ u	ə s p 'ɛ ɾ u
Centre	s 'e n t ɾ ə	s 'ɛ n t ɾ ə
volent	b u l 'ɛ n	b u l 'e n
vigor	b i ɣ 'o r	b i ɣ 'o
vehemència	b ə ə m 'ɛ n s i ə	b e ə m 'ɛ n s i ə
univers	u n i β 'ɛ r s	u n i β 'e s
tresor	t ɾ ə z 'ɔ r	t ɾ ə z 'o
transforma	t ɾ ə n s f 'o r m ə	t ɾ ə n s f 'ɔ r m ə
tonto	t 'o n t u	t 'ɔ n t u
testimoni	t ə s t i m 'ɔ n i	t ə s t i m 'o n i
temor	t ə m 'o r	t ə m 'o
tecles	t 'e k l ə s	t 'ɛ k l ə s
te'n	t 'ə n	t 'ɛ n
t'ho	t 'u	t u
subjectes	s u b ʒ 'e k t ə s	s u b ʒ 'ɛ k t ə s
sorteig	s u r t 'ɛ t ʃ	s u r t 'ɛ tʃ
sopars	s u p 'a s	s u p 'a r s
sofre	s 'o f ɾ ə	s 'ɔ f ɾ ə
sistema	s i s t 'e m ə	s i s t 'ɛ m ə
similars	s i m i l 'a r s	s i m i l 'a s
sencer	s ə n s 'ɛ	s ə n s 'e
s'espolsa	s ə s p 'o l s ə	s ə s p 'ɔ l s ə
s'accepten	s ə k s 'e p t ə n	s ə k s 'ɛ p t ə n
ronda	r 'o n d ə	r 'ɔ n d ə
rere	r 'e ɾ ə	r 'ɛ ɾ ə
reformes	r ə f 'o r m ə s	r ə f 'ɔ r m ə s
recorre	r ə k 'o r ə	r ə k 'ɔ r ə
prosa	p ɾ 'ɔ z ə	p ɾ 'o z ə
problemàtica	p ɾ u β l ə m 'a t i k ə	p ɾ u b b l ə m 'a t i k ə
presta	p ɾ 'e s t ə	p ɾ 'ɛ s t ə
presses	p ɾ 'e s ə s	p ɾ 'ɛ s ə s
presento	p ɾ ə z 'e n t u	p ɾ ə z 'ɛ n t u
ports	p 'ɔ r s	p 'o r t s
poguessin	p u ɣ 'e s i n	p u ɣ 'ɛ s i n
podi	p 'o ð i	p 'ɔ ð i
plora	p l 'ɔ ɾ ə	p l 'o ɾ ə
penja	p 'e n ʒ ə	p 'ɛ n ʒ ə
pengi	p 'e n ʒ i	p 'ɛ n ʒ i
pengen	p 'e n ʒ ə n	p 'ɛ n ʒ ə n
passaport	p ə s ə p 'ɔ r t	p ə s ə p 'o r t
pacientment	p ə s i ə m m 'e n	p ə s i ə n m 'e n
omple	'o m p l ə	'ɔ m p l ə
ombres	'o m b ɾ ə s	'ɔ m b ɾ ə s
motors	m u t 'o r s	m u t 'o s
mercadeig	m ə r k ə ð 'ɛ t ʃ	m ə r k ə ð 'ɛ tʃ
mengen	m 'e n ʒ ə n	m 'ɛ n ʒ ə n
matrimoni	m ə t ɾ i m 'ɔ n i	m ə t ɾ i m 'o n i
mareig	m ə ɾ 'ɛ t ʃ	m ə ɾ 'ɛ tʃ
m'interessa	m i n t ə ɾ 'ɛ s ə	m i n t ə ɾ 'e s ə
llosa	ʎ 'ɔ z ə	ʎ 'o z ə
lletja	ʎ 'e d ʒ ə	ʎ 'ɛ d ʒ ə
lleig	ʎ 'e t ʃ	ʎ 'ɛ tʃ
l'aparell	l ə p ə ɾ 'ɛ ʎ	l ə p ə ɾ 'e ʎ
interiors	i n t ə ɾ i 'o r s	i n t ə ɾ i 'o s
inquiet	i ŋ k i 'e t	i ŋ k i 'ɛ t
grecs	g ɾ 'e k s	g ɾ 'ɛ k s
grec	g ɾ 'e k	g ɾ 'ɛ k
golfes	g 'o l f ə s	g 'ɔ l f ə s
gespa	ʒ 'e s p ə	ʒ 'ɛ s p ə
gasoil	g ə z 'ɔ j l	g ə z 'o i l
fotre	f 'o t ɾ ə	f 'ɔ t ɾ ə
folre	f 'o l r ə	f 'ɔ l r ə
fetes	f 'e t ə s	f 'ɛ t ə s
fer-ne	f 'e r n ə	f 'ɛ r n ə
fer-la	f 'e r l ə	f 'ɛ r l ə
extrem	ə k s t ɾ 'e m	ə k s t ɾ 'ɛ m
exempts	ə g z 'e m t s	ə g z 'ɛ m t s
excepte	ə k s 'e p t ə	ə k s 'ɛ p t ə
estàndard	ə s t 'a n d ə r t	ə s t 'a n d ə ɾ ð
espongiformes	ə s p u n ʒ i f 'o r m ə s	ə s p u n ʒ i f 'ɔ r m ə s
esnob	ə z n 'ɔ p	ə z n 'o p
esmorzen	ə z m 'o r z ə n	ə z m 'ɔ r z ə n
escolta	ə s k 'o l t ə	ə s k 'ɔ l t ə
escletxa	ə s k l 'e t ʃ ə	ə s k l 'ɛ t ʃ ə
enquestes	ə ŋ k 'e s t ə s	ə ŋ k 'ɛ s t ə s
enquesta	ə ŋ k 'e s t ə	ə ŋ k 'ɛ s t ə
empremtes	ə m p ɾ 'e m t ə s	ə m p ɾ 'ɛ m t ə s
efecte	ə f 'e k t ə	ə f 'ɛ k t ə
distrets	d i s t ɾ 'e t s	d i s t ɾ 'ɛ t s
digui'm	d 'i ɣ i m	d i ɣ 'i m
difondre	d i f 'o n d ɾ ə	d i f 'ɔ n d ɾ ə
d'orella	d u ɾ 'ɛ ʎ ə	d u ɾ 'e ʎ ə
d'hores	d 'ɔ ɾ ə s	d i 'o ɾ ə s
d'homes	d 'ɔ m ə s	d u m ə s
creixen	k ɾ 'e ʃ ə n	k ɾ 'ɛ ʃ ə n
concretes	k u ŋ k ɾ 'e t ə s	k u ŋ k ɾ 'ɛ t ə s
conca	k 'o ŋ k ə	k 'ɔ ŋ k ə
comte	k 'o m t ə	k 'ɔ m t ə
compren	k 'o m p ɾ ə n	k 'ɔ m p ɾ ə n
comenten	k u m 'e n t ə n	k u m 'ɛ n t ə n
colze	k 'o l z ə	k 'ɔ l z ə
closos	k l 'ɔ z u s	k l 'o z u s
certs	s 'ɛ r s	s 'ɛ r t s
cera	s 'ɛ ɾ ə	s 'e ɾ ə
ceptre	s 'e p t ɾ ə	s 'ɛ p t ɾ ə
cegues	s 'e ɣ ə s	s 'ɛ ɣ ə s
capgròs	k ə b g ɾ 'ɔ s	k ə p ɣ ɾ 'ɔ s
brolla	b ɾ 'o ʎ ə	b ɾ 'ɔ ʎ ə
bots	b 'o t s	b 'ɔ t s
bosses	b 'o s ə s	b 'ɔ s ə s
borsa	b 'o r s ə	b 'ɔ r s ə
atzar	ə d z 'a r	ə d z 'a
atur	ə t 'u r	ə t 'u
anteriors	ə n t ə ɾ i 'o r s	ə n t ə ɾ i 'o s
ampolles	ə m p 'o ʎ ə s	ə m p 'ɔ ʎ ə s
aliens	ə l i 'ɛ n s	ə l i 'e n s
aimara	ə j m 'a ɾ ə	ə i m 'a ɾ ə
agafant-me	ə ɣ ə f 'a m m ə	ə ɣ ə f 'a n m ə
adonar-se'n	ə ð u n 'a r s ə n	ə ð u n ə r s 'ɛ n
accepto	ə k s 'e p t u	ə k s 'ɛ p t u
Web	b 'e p	s 'ɛ p
Torre	t 'o r ə	t 'ɔ r ə
Tornes	t 'o r n ə s	t 'ɔ r n ə s
Tenen	t 'e n ə n	t 'ɛ n ə n
Temps	t 'e m s	t 'ɛ m p s
Sabent	s ə β 'ɛ n	s ə β 'e n
Ricard	r i k 'a r t	r i k 'a r
Ribagorça	r i β ə ɣ 'o r s ə	r i β ə ɣ 'ɔ r s ə
Regne	r 'e g n ə	r 'ɛ g n ə
Popular	p u p u l 'a r	p u p u l 'a
Mig	m 'i t ʃ	m 'i tʃ
Me	m 'ə	m ə
Llei	ʎ 'e j	ʎ 'ɛ j
Hom	'ɔ m	u m
Formes	f 'o r m ə s	f 'ɔ r m ə s
Escolti'm	ə s k 'o l t i m	ə s k u l t 'i m
Escolta	ə s k 'o l t ə	ə s k 'ɔ l t ə
Entro	'e n t ɾ u	'ɛ n t ɾ u
Eivissa	ə j β 'i s ə	ə i β 'i s ə
Dones	d 'ɔ n ə s	d 'o n ə s
Dimecres	d i m 'e k ɾ ə s	d i m 'ɛ k ɾ ə s
Descarrega't	d ə s k ə r 'ɛ ɣ ə t	d ə s k ə r ə ɣ 'a t
Del	d 'ə l	d ə l
Corts	k 'o r s	k 'o r t s
Celoni	s ə l 'ɔ n i	s ə l 'o n i
Camps	k 'a m s	k 'a m p s
Belgrad	b ə l ɣ ɾ 'a t	b ə l ɣ ɾ 'a ð
Balears	b ə l e 'a r s	b ə l e 'a s
per	p 'ə r	p ə r
Hi	'i	i
De	d 'ə	d ə
xops	ʃ 'o p s	ʃ 'ɔ p s
vinguessis	b i ŋ g 'e s i s	b i ŋ g 'ɛ s i s
tornin	t 'o r n i n	t 'ɔ r n i n
titular	t i t u l 'a r	t i t u l 'a
tenda	t 'e n d ə	t 'ɛ n d ə
suficientment	s u f i s i ə m m 'e n	s u f i s i ə n m 'e n
sers	s 'e r s	s 'e s
s'esgoten	s ə z ɣ 'o t ə n	s ə z ɣ 'ɔ t ə n
rock	r 'ɔ k	r 'o k k
revolt	r ə β 'ɔ l	r ə β 'o l t
retorna	r ə t 'o r n ə	r ə t 'ɔ r n ə
resten	r 'e s t ə n	r 'ɛ s t ə n
resolt	r ə z 'ɔ l t	r ə z 'o l t
relacioni	r ə l ə s i 'ɔ n i	r ə l ə s i 'o n i
rebuig	r ə β 'u t ʃ	r ə β 'u tʃ
pors	p 'o s	p 'o r s
porc	p 'ɔ r k	p 'o r k
pop	p 'o p	p 'ɔ p
ponts	p 'ɔ n s	p 'o n s
plaers	p l ə 'ɛ s	p l ə 'e s
pegues	p 'e ɣ ə s	p 'ɛ ɣ ə s
ombra	'o m b ɾ ə	'ɔ m b ɾ ə
oi	'ɔ j	'o i
nèctar	n 'ɛ k t ə r	n 'ɛ k t ə
morro	m 'o r u	m 'ɔ r u
mor	m 'ɔ r	m 'o
molesta	m u l 'e s t ə	m u l 'ɛ s t ə
militars	m i l i t 'a r s	m i l i t 'a s
llet	ʎ 'e t	ʎ 'ɛ t
lleixes	ʎ 'e ʃ ə s	ʎ 'ɛ ʃ ə s
llars	ʎ 'a r s	ʎ 'a s
irrompre	i r 'o m p ɾ ə	i r 'ɔ m p ɾ ə
insistentment	i n s i s t ə m m 'e n	i n s i s t ə n m 'e n
honest	u n 'e s t	u n 'ɛ s t
hipnotitza	i b n u t 'i d z ə	i p n u t 'i d z ə
greix	g ɾ 'e ʃ	g ɾ 'ɛ ʃ
fonda	f 'o n d ə	f 'ɔ n d ə
fer-te	f 'e r t ə	f 'ɛ r t ə
fer-se'n	f 'e r s ə n	f ə r s 'ɛ n
feble	f 'e b b l ə	f 'ɛ b b l ə
espectacular	ə s p ə k t ə k u l 'a r	ə s p ə k t ə k u l 'a
entri	'e n t ɾ i	'ɛ n t ɾ i
entenguin	ə n t 'e ŋ g i n	ə n t 'ɛ ŋ g i n
ema	'e m ə	'ɛ m ə
do	d 'ɔ	d 'o
distendre	d i s t 'e n d ɾ ə	d i s t 'ɛ n d ɾ ə
descomptes	d ə s k 'o m t ə s	d ə s k 'ɔ m p t ə s
descompte	d ə s k 'o m t ə	d ə s k 'ɔ m p t ə
desamors	d ə z ə m 'o r s	d ə z ə m 'o s
decret	d ə k ɾ 'e t	d ə k ɾ 'ɛ t
corro	k 'o r u	k 'ɔ r u
copa	k 'o p ə	k 'ɔ p ə
concentren	k u n s 'e n t ɾ ə n	k u n s 'ɛ n t ɾ ə n
compres	k 'o m p ɾ ə s	k 'ɔ m p ɾ ə s
beix	b 'e ʃ	b 'ɛ ʃ
arruinats	ə r u j n 'a t s	ə r u i n 'a t s
apart	ə p 'a r t	ə p 'a r
amors	ə m 'o r s	ə m 'o s
afronta	ə f ɾ 'o n t ə	ə f ɾ 'ɔ n t ə
adonar-me'n	ə ð u n 'a r m ə n	ə ð u n ə r m 'ɛ n
accepten	ə k s 'e p t ə n	ə k s 'ɛ p t ə n
accepta	ə k s 'e p t ə	ə k s 'ɛ p t ə
absort	ə p s 'ɔ r t	ə p s 'o r t
Tota	t 'o t ə	t 'ɔ t ə
Sistema	s i s t 'e m ə	s i s t 'ɛ m ə
Setmana	s ə m m 'a n ə	s ə d m 'a n ə
Se'm	s 'ə m	s 'ɛ m
Ronda	r 'o n d ə	r 'ɔ n d ə
Queda	k 'e ð ə	k 'ɛ ð ə
Port	p 'ɔ r t	p 'o r t
Nord	n 'ɔ r t	n 'o r
Ginebra	ʒ i n 'e β ɾ ə	ʒ i n 'ɛ β ɾ ə
Fonts	f 'ɔ n s	f 'o n s
Error	ə r 'o r	ə r 'o
Engega	ə n ʒ 'e ɣ ə	ə n ʒ 'ɛ ɣ ə
Deixa	d 'e ʃ ə	d 'ɛ ʃ ə
Clos	k l 'ɔ s	k l 'o s
Arbre	'a β ɾ ə	'a ɾ β ɾ ə
que	k 'ə	k ə
Us	'u s	u s
Que	k 'ə	k ə
La	l 'ə	l ə
En	'ə n	ə n
xopa	ʃ 'o p ə	ʃ 'ɔ p ə
xop	ʃ 'o p	ʃ 'ɔ p
web	b 'e p	s 'ɛ p
vuitens	b u j t 'ɛ n s	b u j t 'e n s
vodka	b 'o t k ə	b 'ɔ ð k ə
virrei	b i r 'e j	b i r 'ɛ j
vingueren	b i ŋ g 'e ɾ ə n	b i ŋ g 'ɛ ɾ ə n
vetlli	b 'e ʎ ʎ i	b 'ɛ ʎ ʎ i
vetlles	b 'e ʎ ʎ ə s	b 'ɛ ʎ ʎ ə s
vespres	b 'e s p ɾ ə s	b 'ɛ s p ɾ ə s
verb	b 'ɛ r p	b 'ɛ r
vendre'ns	b 'ɛ n d ɾ ə n s	b ə n d ɾ 'ɛ n s
vendre'ls	b 'ɛ n d ɾ ə l s	b ə n d ɾ 'ɛ l s
valoren	b ə l 'o ɾ ə n	b ə l 'ɔ ɾ ə n
uniforme	u n i f 'o r m ə	u n i f 'ɔ r m ə
tsars	t s 'a r s	d z 'a s
tronxos	t ɾ 'o n ʃ u s	t ɾ 'ɔ n ʃ u s
trontolla	t ɾ u n t 'o ʎ ə	t ɾ u n t 'ɔ ʎ ə
tron	t ɾ 'ɔ n	t ɾ 'o n
tro	t ɾ 'ɔ	t ɾ 'o
tresors	t ɾ ə z 'ɔ r s	t ɾ ə z 'o s
trepig	t ɾ ə p 'i t ʃ	t ɾ ə p 'i k
trasplantessin	t ɾ ə s p l ə n t 'e s i n	t ɾ ə s p l ə n t 'ɛ s i n
transoceànic	t ɾ ə n z u s e 'a n i k	t ɾ ə n s u s e 'a n i k
transmetent-me	t ɾ ə n z m ə t 'e m m ə	t ɾ ə n z m ə t 'ɛ m m ə
transició	t ɾ ə n z i s i 'o	t ɾ ə n s i s i 'o
transcorre	t ɾ ə n s k 'o r ə	t ɾ ə n s k 'ɔ r ə
transcendència	t ɾ ə s ə n d 'ɛ n s i ə	t ɾ ə n s ə n d 'ɛ n s i ə
transcendentals	t ɾ ə s ə n d ə n t 'a l s	t ɾ ə n s ə n d ə n t 'a l s
tova	t 'o β ə	t 'ɔ β ə
totxo	t 'o t ʃ u	t 'ɔ t ʃ u
totes	t 'o t ə s	t 'ɔ t ə s
tot	t 'o t	t 'ɔ t
torre	t 'o r ə	t 'ɔ r ə
torneig	t u r n 'ɛ t ʃ	t u r n 'ɛ tʃ
torero	t u ɾ 'e ɾ u	t u ɾ 'ɛ ɾ u
topen	t 'o p ə n	t 'ɔ p ə n
tomba	t 'o m b ə	t 'ɔ m b ə
tirallongues	t i ɾ ə ʎ 'o ŋ g ə s	t i ɾ ə ʎ 'ɔ ŋ g ə s
tirallonga	t i ɾ ə ʎ 'o ŋ g ə	t i ɾ ə ʎ 'ɔ ŋ g ə
testos	t 'e s t u s	t 'ɛ s t u s
testa	t 'e s t ə	t 'ɛ s t ə
terraqüi	t ə r 'a k w i	t ə r 'a k i
tenor	t ə n 'o r	t ə n 'o
tempteig	t ə m t 'ɛ t ʃ	t ə m t 'ɛ tʃ
tecleig	t ə k l 'ɛ t ʃ	t ə k l 'ɛ tʃ
te'm	t 'ə m	t 'ɛ m
te'l	t 'ə l	t 'ɛ l
t'interessa	t i n t ə ɾ 'ɛ s ə	t i n t ə ɾ 'e s ə
t'enjoro	t ə ɲ 'o ɾ u	t ə ɲ 'ɔ ɾ u
successos	s u k s 'e s u s	s u k s 'ɛ s u s
subministressin	s u b m i n i s t ɾ 'e s i n	s u b m i n i s t ɾ 'ɛ s i n
sospesen	s u s p 'e z ə n	s u s p 'ɛ z ə n
sospesa	s u s p 'e z ə	s u s p 'ɛ z ə
sorna	s 'o r n ə	s 'ɔ r n ə
sopes	s 'o p ə s	s 'ɔ p ə s
sopen	s 'o p ə n	s 'ɔ p ə n
sopa	s 'o p ə	s 'ɔ p ə
sonors	s u n 'o r s	s u n 'o s
sonor	s u n 'o r	s u n 'o
silvestres	s i l β 'e s t ɾ ə s	s i l β 'ɛ s t ɾ ə s
serps	s 'e r p s	s 'ɛ r p s
serp	s 'e r p	s 'ɛ r p
serens	s ə ɾ 'ɛ n s	s ə ɾ 'e n s
ser-ho	s 'e ɾ u	s 'ɛ ɾ u
ser-hi	s 'e ɾ i	s 'ɛ ɾ i
sentis	s 'e n t i s	s 'ɛ n t i s
senten	s 'e n t ə n	s 'ɛ n t ə n
sempre	s 'e m p ɾ ə	s 'ɛ m p ɾ ə
semblessin	s ə m b l 'e s i n	s ə m b l 'ɛ s i n
seitons	s ə j t 'o n s	s ə i t 'o n s
satisfets	s ə t i s f 'e t s	s ə t i s f 'ɛ t s
satisfet	s ə t i s f 'e t	s ə t i s f 'ɛ t
sapiens	s ə p i 'ɛ n s	s ə p i 'e n s
sandvitx	s ə n d b 'i t ʃ	s ə n d b 'i tʃ
salpebra	s ə l p 'e β ɾ ə	s ə l p 'ɛ β ɾ ə
s'oposen	s u p 'o z ə n	s u p 'ɔ z ə n
s'interessa	s i n t ə ɾ 'ɛ s ə	s i n t ə ɾ 'e s ə
s'equivoquen	s ə k i β 'o k ə n	s ə k i β 'ɔ k ə n
s'empitjori	s ə m p i d ʒ 'o ɾ i	s ə m p i d ʒ 'ɔ ɾ i
s'amaguessin	s ə m ə ɣ 'e s i n	s ə m ə ɣ 'ɛ s i n
s'alimenten	s ə l i m 'e n t ə n	s ə l i m 'ɛ n t ə n
s'aixequen	s ə ʃ 'e k ə n	s ə ʃ 'ɛ k ə n
s'adonen	s ə ð 'o n ə n	s ə ð 'ɔ n ə n
rotonda	r u t 'o n d ə	r u t 'ɔ n d ə
rosses	r 'o s ə s	r 'ɔ s ə s
roses	r 'ɔ z ə s	r 'o z ə s
ronden	r 'o n d ə n	r 'ɔ n d ə n
ronca	r 'o ŋ k ə	r 'ɔ ŋ k ə
rigor	r i ɣ 'o r	r i ɣ 'o
revers	r ə β 'ɛ r s	r ə β 'e s
retrets	r ə t ɾ 'e t s	r ə t ɾ 'ɛ t s
retard	r ə t 'a r t	r ə t 'a r
responc	r ə s p 'ɔ ŋ	r ə s p 'o ŋ k
responc	r ə s p 'ɔ ŋ	r ə s p 'o ŋ k
respecto	r ə s p 'e k t u	r ə s p 'ɛ k t u
respectessin	r ə s p ə k t 'e s i n	r ə s p ə k t 'ɛ s i n
resoldre'ls	r ə z 'ɔ l d ɾ ə l s	r ə z u l d ɾ 'ɛ l s
resen	r 'e z ə n	r 'ɛ z ə n
reptes	r 'e p t ə s	r 'ɛ p t ə s
reproduint-la	r ə p ɾ u ð u 'i n l ə	r ə p ɾ u ð 'u i n l ə
repensar-nos-ho	r ə p ə n s 'a r n u z u	r ə p ə n s ə r n 'ɔ z u
renoven	r ə n 'o β ə n	r ə n 'ɔ β ə n
renecs	r ə n 'e k s	r ə n 'ɛ k s
rencontre	r ə ŋ k 'o n t ɾ ə	r ə ŋ k 'ɔ n t ɾ ə
regne	r 'e g n ə	r 'ɛ g n ə
regla	r 'e g g l ə	r 'ɛ ɣ l ə
redimensioni	r ə ð i m ə n s i 'ɔ n i	r ə ð i m ə n s i 'o n i
recorren	r ə k 'o r ə n	r ə k 'ɔ r ə n
records	r ə k 'ɔ r s	r ə k 'o r s
reconeixent-ne	r ə k u n ə ʃ 'e n n ə	r ə k u n ə ʃ 'ɛ n n ə
reconduir-lo	r ə k u n d u 'i r l u	r ə k u n d 'u i r l u
recolzo	r ə k 'o l z u	r ə k 'ɔ l z u
recolza	r ə k 'o l z ə	r ə k 'ɔ l z ə
receptes	r ə s 'e p t ə s	r ə s 'ɛ p t ə s
rec	r 'e k	r 'ɛ k
rebessin	r ə β 'e s i n	r ə β 'ɛ s i n
raigràs	r ə j ɣ ɾ 'a s	r ə i ɣ ɾ 'a s
quiosc	k i 'ɔ s k	k i 'o s k
quilowatt	k i l u β 'a t	k i l u β 'a t t
quieta	k i 'e t ə	k i 'ɛ t ə
quedin-se	k 'e ð i n s ə	k ə ð 'i n s ə
quedes	k 'e ð ə s	k 'ɛ ð ə s
promocionin	p ɾ u m u s i 'ɔ n i n	p ɾ u m u s i 'o n i n
prometre'm	p ɾ u m 'ɛ t ɾ ə m	p ɾ u m ə t ɾ 'ɛ m
problemàtics	p ɾ u β l ə m 'a t i k s	p ɾ u b b l ə m 'a t i k s
pretenguin	p ɾ ə t 'e ŋ g i n	p ɾ ə t 'ɛ ŋ g i n
pretendre	p ɾ ə t 'e n d ɾ ə	p ɾ ə t 'ɛ n d ɾ ə
prest	p ɾ 'e s t	p ɾ 'ɛ s t
preromàntics	p ɾ ə r u m 'a n t i k s	p ɾ ə ɾ u m 'a n t i k s
prerafaelites	p ɾ ə r ə f ə e l 'i t ə s	p ɾ ə ɾ ə f ə e l 'i t ə s
prengueren	p ɾ ə ŋ g 'e ɾ ə n	p ɾ ə ŋ g 'ɛ ɾ ə n
prenent-se	p ɾ ə n 'e n s ə	p ɾ ə n 'ɛ n s ə
premsa	p ɾ 'e m s ə	p ɾ 'ɛ m s ə
posicioni	p u z i s i 'ɔ n i	p u z i s i 'o n i
poses	p 'ɔ z ə s	p 'o z ə s
posar-nos-hi	p u z 'a r n u z i	p u z ə r n 'ɔ z i
porta-me-les	p 'ɔ r t ə m ə l ə s	p u r t ə m 'ɛ l ə s
porro	p 'o r u	p 'ɔ r u
poprock	p u p ɾ 'ɔ k	p u p ɾ 'o k k
pont	p 'ɔ n	p 'o n
podent	p u ð 'ɛ n	p u ð 'e n
plumero	p l u m 'e ɾ u	p l u m 'ɛ ɾ u
plors	p l 'ɔ s	p l 'o s
petitburgès	p ə t i d b u r ʒ 'ɛ s	p ə t i t b u r ʒ 'ɛ s
perpetren	p ə r p 'e t ɾ ə n	p ə r p 'ɛ t ɾ ə n
permetre'm	p ə r m 'ɛ t ɾ ə m	p ə r m ə t ɾ 'ɛ m
perfectes	p ə r f 'e k t ə s	p ə r f 'ɛ k t ə s
perfecta	p ə r f 'e k t ə	p ə r f 'ɛ k t ə
penjolls	p ə n ʒ 'ɔ ʎ s	p ə n ʒ 'o ʎ s
penjo	p 'e n ʒ u	p 'ɛ n ʒ u
penetren	p ə n 'e t ɾ ə n	p ə n 'ɛ t ɾ ə n
pega	p 'e ɣ ə	p 'ɛ ɣ ə
peculiar	p ə k u l i 'a r	p ə k u l i 'a
patrimoni	p ə t ɾ i m 'ɔ n i	p ə t ɾ i m 'o n i
parpelleig	p ə r p ə ʎ 'ɛ t ʃ	p ə r p ə ʎ 'ɛ tʃ
ovelles	u β 'ɛ ʎ ə s	u β 'e ʎ ə s
orienten	u ɾ i 'e n t ə n	u ɾ i 'ɛ n t ə n
orella	u ɾ 'ɛ ʎ ə	u ɾ 'e ʎ ə
operen	u p 'e ɾ ə n	u p 'ɛ ɾ ə n
oncle	'o ŋ k l ə	'ɔ ŋ k l ə
oloro	u l 'o ɾ u	u l 'ɔ ɾ u
ofendre's	u f 'ɛ n d ɾ ə s	u f ə n d ɾ 'ɛ s
oest	u 'e s t	u 'ɛ s t
nuclear	n u k l e 'a r	n u k l e 'a
netegessin	n ə t ə ʒ 'e s i n	n ə t ə ʒ 'ɛ s i n
nedes	n 'e ð ə s	n 'ɛ ð ə s
neden	n 'e ð ə n	n 'ɛ ð ə n
mosso	m 'o s u	m 'ɔ s u
mosca	m 'o s k ə	m 'ɔ s k ə
morses	m 'o r s ə s	m 'ɔ r s ə s
morros	m 'o r u s	m 'ɔ r u s
mora	m 'ɔ ɾ ə	m 'o ɾ ə
mon	m 'u n	m u n
moll	m 'ɔ ʎ	m 'o ʎ
molest	m u l 'e s t	m u l 'ɛ s t
millorin	m i ʎ 'o ɾ i n	m i ʎ 'ɔ ɾ i n
metros	m 'e t ɾ u s	m 'ɛ t ɾ u s
metgessa	m ə d ʒ 'ɛ s ə	m ə d ʒ 'e s ə
mengi	m 'e n ʒ i	m 'ɛ n ʒ i
marxessin	m ə r ʃ 'e s i n	m ə r ʃ 'ɛ s i n
manifesta	m ə n i f 'e s t ə	m ə n i f 'ɛ s t ə
maneig	m ə n 'ɛ t ʃ	m ə n 'ɛ tʃ
malsons	m ə l s 'ɔ n s	m ə l s 'o n s
ma	m 'ə	m ə
lluirà	ʎ u i ɾ 'a	ʎ u j ɾ 'a
lloses	ʎ 'ɔ z ə s	ʎ 'o z ə s
llesta	ʎ 'e s t ə	ʎ 'ɛ s t ə
llenja	ʎ 'e ɲ ə	ʎ 'ɛ ɲ ə
llengües	ʎ 'e ŋ g w ə s	ʎ 'ɛ ŋ g w ə s
llegendes	ʎ ə ʒ 'e n d ə s	ʎ ə ʒ 'ɛ n d ə s
lepra	l 'e p ɾ ə	l 'ɛ p ɾ ə
lamento	l ə m 'e n t u	l ə m 'ɛ n t u
labor	l ə β 'o r	l ə β 'o
l'interessa	l i n t ə ɾ 'ɛ s ə	l i n t ə ɾ 'e s ə
l'espurneig	l ə s p u r n 'ɛ t ʃ	l ə s p u r n 'ɛ tʃ
l'ascens	l ə s 'ɛ n s	l ə s 'e n s
l'Univers	l u n i β 'ɛ r s	l u n i β 'e s
l'Antoni	l ə n t 'ɔ n i	l ə n t 'o n i
jueva	ʒ u 'e β ə	ʒ u 'ɛ β ə
jonc	ʒ 'o ŋ	ʒ 'o n s
introduir-lo	i n t ɾ u ð u 'i r l u	i n t ɾ u ð 'u i r l u
interrompre	i n t ə r 'o m p ɾ ə	i n t ə r 'ɔ m p ɾ ə
insatisfets	i n s ə t i s f 'e t s	i n s ə t i s f 'ɛ t s
insatisfeta	i n s ə t i s f 'e t ə	i n s ə t i s f 'ɛ t ə
inquiets	i ŋ k i 'e t s	i ŋ k i 'ɛ t s
ingresses	i ŋ g ɾ 'e s ə s	i ŋ g ɾ 'ɛ s ə s
inconscientment	i ŋ k u n s i ə m m 'e n	i ŋ k u n s i ə n m 'e n
incerts	i n s 'ɛ r s	i n s 'ɛ r t s
import	i m p 'ɔ r t	i m p 'o r t
imperfecte	i m p ə r f 'e k t ə	i m p ə r f 'ɛ k t ə
ignoren	i g n 'o ɾ ə n	i g n 'ɔ ɾ ə n
idoni	i ð 'ɔ n i	i ð 'o n i
híbrid	'i β ɾ i t	'i β ɾ i ð
horts	'ɔ r s	ə r t s
hora	'ɔ ɾ ə	ə 'o ɾ ə
honor	u n 'o r	u n 'o
haguessis	ə ɣ 'e s i s	ə ɣ 'ɛ s i s
haguessin	ə ɣ 'e s i n	ə ɣ 'ɛ s i n
guspires	g u s p 'i ɾ ə s	g s p 'i ɾ ə s
guspira	g u s p 'i ɾ ə	g s p 'i ɾ ə
guard	g w 'a r t	g w 'a r
greixos	g ɾ 'e ʃ u s	g ɾ 'ɛ ʃ u s
golfo	g 'o l f u	g 'ɔ l f u
gestos	ʒ 'e s t u s	ʒ 'ɛ s t u s
gesta	ʒ 'e s t ə	ʒ 'ɛ s t ə
generen	ʒ ə n 'e ɾ ə n	ʒ ə n 'ɛ ɾ ə n
gemecs	ʒ ə m 'e k s	ʒ ə m 'ɛ k s
gemec	ʒ ə m 'e k	ʒ ə m 'ɛ k
gairell	g ə j ɾ 'e ʎ	g ə i ɾ 'e ʎ
fèmur	f 'ɛ m u r	f 'ɛ m u
fuig	f 'u t ʃ	f 'u tʃ
frens	f ɾ 'ɛ n s	f ɾ 'e n s
frankfurt	f ɾ ə ŋ k f 'u r t	f ɾ ə ŋ f 'u r t
fots	f 'o t s	f 'ɔ t s
fotre-li	f 'o t ɾ ə l i	f u t ɾ 'ɛ l i
fot	f 'o t	f 'ɔ t
formi	f 'o r m i	f 'ɔ r m i
foques	f 'o k ə s	f 'ɔ k ə s
fletxes	f l 'e t ʃ ə s	f l 'ɛ t ʃ ə s
fletxa	f l 'e t ʃ ə	f l 'ɛ t ʃ ə
fixi's	f 'i k s i s	f i k s 'i s
fiquessin	f i k 'e s i n	f i k 'ɛ s i n
finestra	f i n 'e s t ɾ ə	f i n 'ɛ s t ɾ ə
fer-lo	f 'e r l u	f 'ɛ r l u
fer-hi	f 'e ɾ i	f 'ɛ ɾ i
fent-se	f 'e n s ə	f 'ɛ n s ə
fent-lo	f 'e n l u	f 'ɛ n l u
fen	f 'e n	f 'ɛ n
feldspat	f ə l t s p 'a t	f ə l s p 'a t
feixos	f 'e ʃ u s	f 'ɛ ʃ u s
favor	f ə β 'o r	f ə β 'o
fantasiós	f ə n t ə z i 'o s	f ə n t ə s i 'o s
fantasies	f ə n t ə z 'i ə s	f ə n t ə s 'i ə s
familiar	f ə m i l i 'a r	f ə m i l i 'a
extret	ə k s t ɾ 'e t	ə k s t ɾ 'ɛ t
extrems	ə k s t ɾ 'e m s	ə k s t ɾ 'ɛ m s
exteriors	ə k s t ə ɾ i 'o r s	ə k s t ə ɾ i 'o s
extens	ə k s t 'ɛ n s	ə k s t 'e n s
expliquessin	ə k s p l i k 'e s i n	ə k s p l i k 'ɛ s i n
exjugador	ə g ʒ u ɣ ə ð 'o	ə g z ʒ u ɣ ə ð 'o
exemples	ə g z 'e m p l ə s	ə g z 'ɛ m p l ə s
exemplars	ə g z ə m p l 'a r s	ə g z ə m p l 'a s
exemplar	ə g z ə m p l 'a r	ə g z ə m p l 'a
evolucioni	ə β u l u s i 'ɔ n i	ə β u l u s i 'o n i
estudiïn	ə s t u ð 'i i n	ə s t u ð i 'i n
estrenjent-me	ə s t ɾ ə ɲ 'e m m ə	ə s t ɾ ə ɲ 'ɛ m m ə
esquists	ə s k 'i s t s	ə s k 'i s s
esport	ə s p 'ɔ r t	ə s p 'o r t
espessa	ə s p 'ɛ s ə	ə s p 'e s ə
espero	ə s p 'e ɾ u	ə s p 'ɛ ɾ u
esperessis	ə s p ə ɾ 'e s i s	ə s p ə ɾ 'ɛ s i s
esperessin	ə s p ə ɾ 'e s i n	ə s p ə ɾ 'ɛ s i n
esmicola	ə z m i k 'o l ə	ə z m i k 'ɔ l ə
esment	ə z m 'e n	e z m 'e n
esgrogueint-se	ə z ɣ ɾ u ɣ ə 'i n s ə	ə z ɣ ɾ u ɣ 'ɛ j n s ə
esfinx	ə s f 'i n ʃ	ə s f 'i n
escombra	ə s k 'o m b ɾ ə	ə s k 'ɔ m b ɾ ə
escolto	ə s k 'o l t u	ə s k 'ɔ l t u
escolti'm	ə s k 'o l t i m	ə s k u l t 'i m
escolti	ə s k 'o l t i	ə s k 'ɔ l t i
escoltes	ə s k 'o l t ə s	ə s k 'ɔ l t ə s
enviïn	ə m b 'i i n	ə m b i 'i n
envers	ə m b 'ɛ r s	ə m b 'e s
enuig	ə n 'u t ʃ	ə n 'u tʃ
enter	ə n t 'e r	ə n t 'e
entendre'n	ə n t 'e n d ɾ ə n	ə n t ə n d ɾ 'ɛ n
engego	ə n ʒ 'e ɣ u	ə n ʒ 'ɛ ɣ u
engega	ə n ʒ 'e ɣ ə	ə n ʒ 'ɛ ɣ ə
endreço	ə n d ɾ 'e s u	ə n d ɾ 'ɛ s u
empentes	ə m p 'ɛ n t ə s	ə m p 'e n t ə s
empenta	ə m p 'ɛ n t ə	ə m p 'e n t ə
elabori	ə l ə β 'o ɾ i	ə l ə β 'ɔ ɾ i
eixos	'e ʃ u s	'ɛ ʃ u s
eivissencs	ə j β i s 'ɛ ŋ s	ə i β i s 'ɛ ŋ s
duo	d 'u o	d 'u u
dorm	d 'ɔ r m	d 'o r m
doni'm	d 'o n i m	d u n 'i m
donessin	d u n 'e s i n	d u n 'ɛ s i n
dobla	d 'o b b l ə	d 'ɔ b b l ə
dissoldre's	d i s 'ɔ l d ɾ ə s	d i s u l d ɾ 'ɛ s
disposo	d i s p 'o z u	d i s p 'ɔ z u
disfressa	d i s f ɾ 'ɛ s ə	d i s f ɾ 'e s ə
discretes	d i s k ɾ 'e t ə s	d i s k ɾ 'ɛ t ə s
discrepo	d i s k ɾ 'e p u	d i s k ɾ 'ɛ p u
discrepi	d i s k ɾ 'e p i	d i s k ɾ 'ɛ p i
dirigeixi's	d i ɾ i ʒ 'ɛ ʃ i s	d i ɾ i ʒ ə ʃ 'i s
digueren	d i ɣ 'e ɾ ə n	d i ɣ 'ɛ ɾ ə n
dient-se	d i 'e n s ə	d i 'ɛ n s ə
detesto	d ə t 'e s t u	d ə t 'ɛ s t u
detecta	d ə t 'e k t ə	d ə t 'ɛ k t ə
destorb	d ə s t 'o r p	d ə s t 'o ɾ
desigs	d ə z 'i t ʃ s	d ə z 'i k s
desfer-li	d ə s f 'e r l i	d ə s f 'ɛ r l i
desesper	d ə z ə s p 'e r	d ə z ə s p 'e
desemboca	d ə z ə m b 'o k ə	d ə z ə m b 'ɔ k ə
desamor	d ə z ə m 'o r	d ə z ə m 'o
desacord	d ə z ə k 'ɔ r t	d ə z ə k 'o r t
demanar-nos-ho	d ə m ə n 'a r n u z u	d ə m ə n ə r n 'ɔ z u
deixis	d 'e ʃ i s	d 'ɛ ʃ i s
deixi'm	d 'e ʃ i m	d ə ʃ 'i m
deixessin	d ə ʃ 'e s i n	d ə ʃ 'ɛ s i n
deixes	d 'e ʃ ə s	d 'ɛ ʃ ə s
deixa't	d 'e ʃ ə t	d ə ʃ 'a t
deixa'm	d 'e ʃ ə m	d ə ʃ 'a m
deessa	d ə 'ɛ s ə	d ə 'e s ə
decrets	d ə k ɾ 'e t s	d ə k ɾ 'ɛ t s
dactilars	d ə k t i l 'a r s	d ə k t i l 'a s
d'aparells	d ə p ə ɾ 'ɛ ʎ s	d ə p ə ɾ 'e ʎ s
d'aparell	d ə p ə ɾ 'ɛ ʎ	d ə p ə ɾ 'e ʎ
cuinar	k u j n 'a	k u i n 'a
cromos	k ɾ 'o m u s	k ɾ 'ɔ m u s
creïn	k ɾ 'e i n	k ɾ ə 'i n
cremes	k ɾ 'e m ə s	k ɾ 'ɛ m ə s
cremen	k ɾ 'e m ə n	k ɾ 'ɛ m ə n
crema	k ɾ 'e m ə	k ɾ 'ɛ m ə
creessin	k ɾ ə 'e s i n	k ɾ ə 'ɛ s i n
covard	k u β 'a r t	k u β 'a r
cosinus	k u s 'i n u s	k u z 'i n u s
cosa	k 'ɔ z ə	k 'o z ə
cos	k 'ɔ s	k 'o s
cors	k 'ɔ r s	k 'o s
continuessin	k u n t i n u 'e s i n	k u n t i n u 'ɛ s i n
contesto	k u n t 'e s t u	k u n t 'ɛ s t u
contenen	k u n t 'e n ə n	k u n t 'ɛ n ə n
consta	k 'o n s t ə	k 'ɔ n s t ə
considero	k u n s i ð 'e ɾ u	k u n s i ð 'ɛ ɾ u
conques	k 'o ŋ k ə s	k 'ɔ ŋ k ə s
connecta	k u n n 'e k t ə	k u n n 'ɛ k t ə
condemna	k u n d 'e m n ə	k u n d 'ɛ m n ə
completa-la	k u m p l 'ɛ t ə l ə	k u m p l ə t 'a l ə
comparsero	k u m p ə r s 'e ɾ u	k u m p ə r s 'ɛ ɾ u
cofoi	k u f 'ɔ j	k u f 'o i
coco	k 'o k u	k 'ɔ k u
clor	k l 'ɔ r	k l 'o
cercles	s 'e r k l ə s	s 'ɛ r k l ə s
centígrads	s ə n t 'i ɣ ɾ ə t s	s ə n t 'i ɣ ɾ ə ð s
centelleig	s ə n t ə ʎ 'ɛ t ʃ	s ə n t ə ʎ 'ɛ tʃ
celebren	s ə l 'e β ɾ ə n	s ə l 'ɛ β ɾ ə n
cec	s 'e k	s 'ɛ k
cars	k 'a r s	k 'a s
car	k 'a r	k 'a
capvespre	k ə b b 'e s p ɾ ə	k ə b b 'ɛ s p ɾ ə
cantimplora	k ə n t i m p l 'ɔ ɾ ə	k ə n t i m p l 'o ɾ ə
brots	b ɾ 'o t s	b ɾ 'ɔ t s
brollen	b ɾ 'o ʎ ə n	b ɾ 'ɔ ʎ ə n
botes	b 'o t ə s	b 'ɔ t ə s
bot	b 'o t	b 'ɔ t
bord	b 'o r t	b 'o ɾ ð
bons	b 'ɔ n s	b 'o n s
bombolles	b u m b 'o ʎ ə s	b u m b 'ɔ ʎ ə s
bolquen	b 'o l k ə n	b 'ɔ l k ə n
boirina	b u j ɾ 'i n ə	b u i ɾ 'i n ə
bo	b 'ɔ	b 'o
bes	b 'e s	b 'ɛ s
bateig	b ə t 'ɛ t ʃ	b ə t 'ɛ tʃ
bable	b 'a β l ə	b 'a b b l ə
atribuir-ho	ə t ɾ i β u 'i ɾ u	ə t ɾ i β 'u j ɾ u
assaigs	ə s 'a t ʃ s	ə s 'a tʃ s
asimètrica	ə s i m 'ɛ t ɾ i k ə	ə z i m 'ɛ t ɾ i k ə
arribessin	ə r i β 'e s i n	ə r i β 'ɛ s i n
arregla	ə r 'e g g l ə	ə r 'ɛ g g l ə
aqüífer	ə k w 'i f ə r	ə k w 'i f ə
aproven	ə p ɾ 'o β ə n	ə p ɾ 'ɔ β ə n
apretar-me-les	ə p ɾ ə t 'a r m ə l ə s	ə p ɾ ə t ə r m 'ɛ l ə s
aportessin	ə p u r t 'e s i n	ə p u r t 'ɛ s i n
aparegueren	ə p ə ɾ ə ɣ 'e ɾ ə n	ə p ə ɾ ə ɣ 'ɛ ɾ ə n
anglosaxons	ə ŋ g l u s ə k s 'o n s	ə ŋ g l u z ə k s 'o n s
anessin	ə n 'e s i n	ə n 'ɛ s i n
anar-se-la	ə n 'a r s ə l ə	ə n ə r s 'ɛ l ə
anar-se'n	ə n 'a r s ə n	ə n ə r s 'ɛ n
ambdós	ə m d 'o s	ə m b d 'o s
ambdues	ə m d 'u ə s	ə m b d 'u ə s
alteren	ə l t 'e ɾ ə n	ə l t 'ɛ ɾ ə n
alletin	ə ʎ 'e t i n	ə ʎ 'ɛ t i n
alegre	ə l 'e ɣ ɾ ə	ə l 'ɛ ɣ ɾ ə
aixeco	ə ʃ 'e k u	ə ʃ 'ɛ k u
aixeca	ə ʃ 'e k ə	ə ʃ 'ɛ k ə
aiguamolls	ə j ɣ w ə m 'ɔ ʎ s	ə j ɣ u ə m 'o ʎ s
aiguaforts	ə j ɣ w ə f 'ɔ r s	ə j ɣ w ə f 'o r t s
agrupa'ls	ə ɣ ɾ 'u p ə l s	ə ɣ ɾ u p 'a l s
agrair-li	ə ɣ ɾ ə 'i r l i	ə ɣ ɾ 'a i r l i
agafessin	ə ɣ ə f 'e s i n	ə ɣ ə f 'ɛ s i n
afruitat	ə f ɾ u j t 'a t	ə f ɾ u i t 'a t
afecten	ə f 'e k t ə n	ə f 'ɛ k t ə n
afecte	ə f 'e k t ə	ə f 'ɛ k t ə
adscrit	ə t s k ɾ 'i t	ə ts k ɾ 'i t
adornen	ə ð 'o r n ə n	ə ð 'ɔ r n ə n
adequa	ə ð 'e k w ə	ə ð 'ɛ k w ə
acords	ə k 'ɔ r s	ə k 'o r s
aconsellen	ə k u n s 'e ʎ ə n	ə k u n s 'ɛ ʎ ə n
a	'ə	ə
Zürich	z u ɾ 'i k	ə w ɾ 'i tʃ
Zagreb	z ə ɣ ɾ 'e p	z ə ɣ ɾ 'ɛ p
Xop	ʃ 'o p	ʃ 'ɔ p
Weissmann	b ə j s m 'a n n	b ə i s m 'a n n
Webs	b 'e p s	s 'ɛ p s
Vicent	b i s 'ɛ n	b i s 'e n
Vermella	b ə r m 'ɛ ʎ ə	b ə r m 'e ʎ ə
Ve	b 'e	b 'ɛ
Txetxènia	t ʃ ə t ʃ 'ɛ n i ə	ʃ ə t ʃ 'ɛ n i ə
Trodheim	t ɾ u ð 'ɛ j m	t ɾ u ð 'ɛ i m
Tret	t ɾ 'e t	t ɾ 'ɛ t
Transports	t ɾ ə n s p 'ɔ r s	t ɾ ə n s p 'o r t s
Transport	t ɾ ə n s p 'ɔ r t	t ɾ ə n s p 'o r t
Tort	t 'ɔ r t	t 'o r t
Torno	t 'o r n u	t 'ɔ r n u
Torni	t 'o r n i	t 'ɔ r n i
Ton	t 'u n	t u n
Ter	t 'e r	t 'e
Tema	t 'e m ə	t 'ɛ m ə
Te'n	t 'ə n	t 'ɛ n
Te	t 'ə	t ə
Taipei	t ə j p 'ɛ j	t ə i p 'ɛ j
T'ho	t 'u	t u
Sobre	s 'o β ɾ ə	s 'ɔ β ɾ ə
Sistemes	s i s t 'e m ə s	s i s t 'ɛ m ə s
Sistema	s i s t 'e m ə	s i s t 'ɛ m ə
Se'l	s 'ə l	s 'ɛ l
Saqueig	s ə k 'ɛ t ʃ	s ə k 'ɛ tʃ
S'ho	s 'u	s u
Rosa	r 'ɔ z ə	r 'o z ə
Riad	r i 'a t	r i 'a ð
Revetlla	r ə β 'e ʎ ʎ ə	r ə β 'ɛ ʎ ʎ ə
Quedo	k 'e ð u	k 'ɛ ð u
QUIR	k 'i r	k 'i
Ponç	p 'ɔ n s	p 'o n s
Pont	p 'ɔ n	p 'o n
Pladellorens	p l ə ð ə ʎ u ɾ 'ɛ n s	p l ə ð ə ʎ u ɾ 'e n s
Pingu	p 'i ŋ g u	p 'i ŋ g
Perecamps	p ə ɾ ə k 'a m s	p ə ɾ ə k 'a m p s
Peix	p 'e ʃ	p 'ɛ ʃ
Parella	p ə ɾ 'ɛ ʎ ə	p ə ɾ 'e ʎ ə
PIME	p 'i m e	p 'i m ə
Os	'ɔ s	'o s
Omple	'o m p l ə	'ɔ m p l ə
Nois	n 'ɔ j s	n 'o i s
Neix	n 'e ʃ	n 'ɛ ʃ
Müller	m u ʎ 'e	m w ʎ 'e
Munich	m u n 'i k	m u n 'i tʃ
Mossos	m 'o s u s	m 'ɔ s u s
Mora	m 'ɔ ɾ ə	m 'o ɾ ə
Molta	m 'o l t ə	m 'ɔ l t ə
Menja	m 'e n ʒ ə	m 'ɛ n ʒ ə
Mastercard	m ə s t ə r k 'a r t	m ə s t ə r k 'a r
Martens	m ə r t 'ɛ n s	m ə r t 'e n s
Malone	m ə l 'o n ə	m ə l 'ɔ n ə
Magog	m ə ɣ 'ɔ k	m ə ɣ 'o k
Lo	l 'u	l u
Llevo	ʎ 'e β u	ʎ 'ɛ β u
L'Antoni	l ə n t 'ɔ n i	l ə n t 'o n i
Kirsten	k 'i r s t ə n	k 'i s t ə n
Kinkel	k i ŋ k 'ɛ l	k i n 'ɛ l
Jofre	ʒ 'o f ɾ ə	ʒ 'ɔ f ɾ ə
Jeroni	ʒ ə ɾ 'ɔ n i	ʒ ə ɾ 'o n i
Ignoro	i g n 'o ɾ u	i g n 'ɔ ɾ u
Hug	'u k	ə k
Haig	'a t ʃ	'a tʃ
Gaspart	g ə s p 'a r t	g ə s p 'a r
Frankfurt	f ɾ ə ŋ k f 'u r t	f ɾ ə ŋ f 'u r t
Fixi's	f 'i k s i s	f i k s 'i s
Finestres	f i n 'e s t ɾ ə s	f i n 'ɛ s t ɾ ə s
Festes	f 'e s t ə s	f 'ɛ s t ə s
Festa	f 'e s t ə	f 'ɛ s t ə
Fent-ho	f 'e n t u	f 'ɛ n t u
Explica'ls	ə k s p l 'i k ə l s	ə k s p l i k 'a l s
Exempcions	ə g z ə m s i 'o n s	ə g z ə m p s i 'o n s
Esports	ə s p 'ɔ r s	ə s p 'o r t s
Esperi	ə s p 'e ɾ i	ə s p 'ɛ ɾ i
Espera'm	ə s p 'e ɾ ə m	ə s p ə ɾ 'a m
Escolti	ə s k 'o l t i	ə s k 'ɔ l t i
Escolta'm	ə s k 'o l t ə m	ə s k u l t 'a m
Ernest	ə r n 'e s t	ə r n 'ɛ s t
Entren	'e n t ɾ ə n	'ɛ n t ɾ ə n
Elisenda	ə l i z 'e n d ə	ə l i z 'ɛ n d ə
Eindhoven	ə j n d 'o β ə n	ə i n d 'ɔ β ə n
Efecte	ə f 'e k t ə	ə f 'ɛ k t ə
Ebre	'e β ɾ ə	'ɛ β ɾ ə
Ebre	'e β ɾ ə	'ɛ β ɾ ə
Detroit	d ə t ɾ 'ɔ j t	d ə t ɾ 'o i t
Deixi	d 'e ʃ i	d 'ɛ ʃ i
Darrere	d ə r 'e ɾ ə	d ə r 'ɛ ɾ ə
Copia-la	k u p 'i ə l ə	k u p i 'a l ə
Copa	k 'o p ə	k 'ɔ p ə
Consta	k 'o n s t ə	k 'ɔ n s t ə
Connecta	k u n n 'e k t ə	k u n n 'ɛ k t ə
Comptes	k 'o m t ə s	k 'ɔ m p t ə s
Compta	k 'o m t ə	k 'ɔ m t ə
Comparseros	k u m p ə r s 'e ɾ u s	k u m p ə r s 'ɛ ɾ u s
Chirac	t ʃ i ɾ 'a k	k i ɾ 'a k
Cheng	t ʃ 'ɛ ŋ	k 'ɛ ŋ
Carreras	k ə r 'e ɾ ə s	k ə r 'ɛ ɾ ə s
Capgrossos	k ə b g ɾ 'ɔ s u s	k ə p ɣ ɾ 'ɔ s u s
Brasília	b ɾ ə z 'i l i ə	b ɾ ə s 'i l i ə
Bons	b 'ɔ n s	b 'o n s
Bodes	b 'o ð ə s	b 'ɔ ð ə s
Banotti	b ə n 'ɔ t i	b ə n 'ɔ t t i
Banc	b 'a ŋ	b 'a ŋ k
Avisa'm	ə β 'i z ə m	ə β i z 'a m
Aquelles	ə k 'ɛ ʎ ə s	ə k 'e ʎ ə s
Anterior	ə n t ə ɾ i 'o r	ə n t ə ɾ i 'o
Amor	ə m 'o r	ə m 'o
Alhora	ə l 'ɔ ɾ ə	ə l i 'o ɾ ə
Alfred	ə l f ɾ 'ɛ t	ə l f ɾ 'e t
Aixeca	ə ʃ 'e k ə	ə ʃ 'ɛ k ə
Agustí	ə ɣ u s t 'i	ə ɣ s t 'i
Agenda	ə ʒ 'e n d ə	ə ʒ 'ɛ n d ə
Acosta't	ə k 'ɔ s t ə t	ə k u s t 'a t
amb	ə m	ə m b
promig	p ɾ u m 'i t ʃ	p ɾ u m 'i tʃ
dient-me	d i 'e m m ə	d i 'ɛ m m ə
Virrei	b i r 'e j	b i r 'ɛ j
Suprem	s u p ɾ 'e m	s u p ɾ 'ɛ m
Son	s 'ɔ n	s 'o n
Se'n	s 'ə n	s 'ɛ n
S'aixeca	s ə ʃ 'e k ə	s ə ʃ 'ɛ k ə
Prem	p ɾ 'e m	p ɾ 'ɛ m
Pons	p 'ɔ n s	p 'o n s
Poder	p u ð 'ɛ	p u ð 'e
Plataforma	p l ə t ə f 'o r m ə	p l ə t ə f 'ɔ r m ə
Oh	'ɔ	'o
N'he	n 'e	n 'ɛ
Mes	m 'e s	m 'ɛ s
Le	l 'e	l 'ɛ
L'hora	l 'ɔ ɾ ə	l i 'o ɾ ə
Jonc	ʒ 'o ŋ	ʒ 'o n s
Interessa	i n t ə ɾ 'ɛ s ə	i n t ə ɾ 'e s ə
Hèlsinki	'ɛ l s i ŋ k i	'ɛ l s i n i
Huc	'u k	u k
Hisenda	i z 'e n d ə	i z 'ɛ n d ə
Grenoble	g ɾ ə n 'o b b l ə	g ɾ ə n 'ɔ b b l ə
Familiar	f ə m i l i 'a r	f ə m i l i 'a
Explota	ə k s p l 'o t ə	ə k s p l 'ɔ t ə
Escola't	ə s k 'ɔ l ə t	ə s k u l 'a t
Error	ə r 'o r	ə r 'o
Endreço	ə n d ɾ 'e s u	ə n d ɾ 'ɛ s u
Ela	'e l ə	'ɛ l ə
Dona'm	d 'ɔ n ə m	d u n 'a m
Desi	d 'e z i	d 'ɛ z i
Contesta	k u n t 'e s t ə	k u n t 'ɛ s t ə
Compto	k 'o m t u	k 'ɔ m t u
Chamonix	t ʃ ə m u n 'i k s	k ə m u n 'i k s
COCO	k 'o k u	k 'ɔ k u
Ben	b 'e n	b 'ɛ n
Atocha	ə t 'ɔ t ʃ ə	ə t 'ɔ k ə
Artur	ə r t 'u r	ə r t 'u
Aprendrem	ə p ə n d ɾ 'ɛ m	ə p ɾ ə n d ɾ 'ɛ m
Anvers	ə m b 'ɛ r s	ə m b 'e s
Agnelli	ə g n 'e ʎ i	ə g n 'ɛ ʎ i
Acosta-t'hi	ə k 'ɔ s t ə t i	ə k u s t 'a t i
