A	'ə	 ə 
aalenià	ə ə l ə n i 'a	 ə e l ə n i 'a 
aaleniana	ə ə l ə n i 'a n ə	 ə e l ə n i 'a n ə 
aalenianes	ə ə l ə n i 'a n ə s	 ə e l ə n i 'a n ə s 
aalenians	ə ə l ə n i 'a n s	 ə e l ə n i 'a n s 
abaixareu	ə β ə ʃ ə ɾ 'ɛ w	 ə β ə ʃ ə ɾ 'ə w 
abandonament	ə β ə n d o n ə m 'e n t	 ə β ə n d 'ɔ n ə m 'e n t 
abandonis	ə β ə n d 'ɔ n i s	 ə β ə n d 'o n i s 
abastament	ə β ə s t ə m 'e n t	 ə β 'a s t ə m 'e n t 
aberrants	ə β ə r 'a n s	 ə β ə r 'a n t s 
abonament	ə β o n ə m 'e n t	 ə β 'ɔ n ə m 'e n t 
abreviaria	ə β ɾ ə v i ə ɾ 'i ə	 ə β ɾ ə v 'i ə ɾ 'i ə 
abreviatura	ə β ɾ ə v i ə t 'u ɾ ə	 ə β ɾ ə v 'i ə t 'u ɾ ə 
absents	ə t s 'e n s	 ə t s 'e n t s 
absorbent	ə t s o ɾ β 'e n t	 ə t s 'o ɾ β 'e n t 
abstemis	ə p s t 'ɛ m i s	 ə t s t 'ɛ m i s 
abstenció	ə p s t ə n s i 'o	 ə t s t ə n s i 'o 
abstencions	ə p s t ə n s i 'o n s	 ə t s t ə n s i 'o n s 
abstindre	ə p s t 'i n d ɾ ə	 ə t s t 'i n d ɾ ə 
abstinguda	ə p s t i ŋ g 'u ð ə	 ə t s t 'i ŋ g 'u ð ə 
abstingudes	ə p s t i ŋ g 'u ð ə s	 ə t s t 'i ŋ g 'u ð ə s 
abstingut	ə p s t i ŋ g 'u t	 ə t s t 'i ŋ g 'u t 
abstinguts	ə p s t i ŋ g 'u t s	 ə t s t 'i ŋ g 'u t s 
abundants	ə β u n d 'a n s	 ə β u n d 'a n t s 
acabament	ə k ə β ə m 'e n t	 ə k 'a β ə m 'e n t 
accadi	ə k k 'a ð i	 ə t s 'a ð i 
aclariment	ə k l ə ɾ i m 'e n t	 ə k l 'a ɾ i m 'e n t 
açò	ə s 'ɔ	 'a s 'ɔ 
acolliment	ə k o ʎ i m 'e n t	 ə k 'ɔ ʎ i m 'e n t 
acomiadament	ə k o m i ə ð ə m 'e n t	 ə k o m i 'a ð ə m 'e n t 
acompanyament	ə k o m p ə ɲ ə m 'e n t	 ə k o m p 'a ɲ ə m 'e n t 
acostament	ə k o s t ə m 'e n t	 ə k 'ɔ s t ə m 'e n t 
adesiara	ə ð ə z i 'a ɾ ə	 'a ð ə z i 'a ɾ ə 
adhesiu	ə ð ə z 'i w	 ə ð ə s 'i w 
adiguí	ə ð i ɣ 'i	 ə ð 'i ɣ 'i 
adoctrinament	ə ð o t t ɾ i n ə m 'e n t	 ə ð o t t ɾ 'i n ə m 'e n t 
adolescent	ə ð o l ə t s 'e n t	 ə ð o l ə s k 'e n t 
adolescents	ə ð o l ə t s 'e n s	 ə ð o l ə s k 'e n t s 
adscripció	ə s k ɾ i t s i 'o	 ə t s k ɾ i t s i 'o 
adscrit	ə s k ɾ 'i t	 ə t s k ɾ 'i t 
adscrita	ə s k ɾ 'i t ə	 ə t s k ɾ 'i t ə 
adscrites	ə s k ɾ 'i t ə s	 ə t s k ɾ 'i t ə s 
adscrits	ə s k ɾ 'i t s	 ə t s k ɾ 'i t s 
adscriure	ə s k ɾ 'i w ɾ ə	 ə t s k ɾ 'i w ɾ ə 
adults	ə ð 'u l s	 ə ð 'u l t s 
afaitada	ə f ə j t 'a ð ə	 ə f ə i t 'a ð ə 
afaitades	ə f ə j t 'a ð ə s	 ə f ə i t 'a ð ə s 
afaitar	ə f ə j t 'a	 ə f ə i t 'a 
afaitat	ə f ə j t 'a t	 ə f ə i t 'a t 
afaitats	ə f ə j t 'a t s	 ə f ə i t 'a t s 
afectuosa	ə f ə t t u 'o z ə	 ə f ə t t u 'o s ə 
afectuoses	ə f ə t t u 'o z ə s	 ə f ə t t u 'o s ə s 
Afganistan	ə v ɣ ə n i s t 'a n	 ə f ɣ ə n i s t 'a n 
aflores	ə f l 'ɔ ɾ ə s	 ə f l 'o ɾ ə s 
afrikaans	ə f ɾ i k ə 'a n s	 ə f ɾ i k 'a 'a n s 
afronta	ə f ɾ 'o n t ə	 ə f ɾ 'ɔ n t ə 
afusellament	ə f u z ə ʎ ə m 'e n t	 ə f u z 'ə ʎ ə m 'e n t 
agenda	ə ʒ 'e n d ə	 ə ʒ 'ɛ n d ə 
agermanament	ə ʒ ə ɾ m ə n ə m 'e n t	 ə ʒ ə ɾ m 'a n ə m 'e n t 
agraïment	ə ɣ ɾ ə i m 'e n t	 ə ɣ ɾ 'a i m 'e n t 
agricultura	ə ɣ ɾ i k u l t 'u ɾ ə	 ə ɣ ɾ i k 'u l t 'u ɾ ə 
agudesa	ə ɣ u ð 'ə z ə	 ə ɣ 'u ð 'ə z ə 
agullat	ə ɣ u ʎ 'a t	 ə ɣ 'u ʎ 'a t 
agulleta	ə ɣ u ʎ 'ə t ə	 ə ɣ 'u ʎ 'ə t ə 
aidada	ə j ð 'a ð ə	 ə i ð 'a ð ə 
aidades	ə j ð 'a ð ə s	 ə i ð 'a ð ə s 
aidant	ə j ð 'a n t	 ə i ð 'a n t 
aidar	ə j ð 'a	 ə i ð 'a 
aidat	ə j ð 'a t	 ə i ð 'a t 
aidats	ə j ð 'a t s	 ə i ð 'a t s 
aïllada	ə i ʎ 'a ð ə	 ə 'i ʎ 'a ð ə 
aïllades	ə i ʎ 'a ð ə s	 ə 'i ʎ 'a ð ə s 
aïllament	ə i ʎ ə m 'e n t	 ə 'i ʎ ə m 'e n t 
aïllant	ə i ʎ 'a n t	 ə 'i ʎ 'a n t 
aïllar	ə i ʎ 'a	 ə 'i ʎ 'a 
aïllat	ə i ʎ 'a t	 ə 'i ʎ 'a t 
aïllats	ə i ʎ 'a t s	 ə 'i ʎ 'a t s 
aixecament	ə ʃ ə k ə m 'e n t	 ə ʃ 'ɛ k ə m 'e n t 
ajuntament	ə ʒ u n t ə m 'e n t	 ə ʒ 'u n t ə m 'e n t 
ajustament	ə ʒ u s t ə m 'e n t	 ə ʒ 'u s t ə m 'e n t 
àlber	'a l β ə	 'a l β e  
alçament	ə l s ə m 'e n t	 'a l s ə m 'e n t 
alcohol	ə l k o 'ɔ l	 ə l k o 'a l 
alegre	ə l 'e ɣ ɾ ə	 ə l 'ə ɣ ɾ ə 
algutzir	ə l ɣ u d z 'i	 ə l ɣ 'u d z 'i 
aliment	ə l i m 'e n t	 'a l i m 'e n t 
alineada	ə l i n e 'a ð ə	 ə l i n ə 'a ð ə 
alineament	ə l i n e ə m 'e n t	 ə l i n 'ə ə m 'e n t 
alinear	ə l i n e 'a	 ə l i n 'ə 'a 
alineat	ə l i n e 'a t	 ə l i n 'e 'a t 
alineats	ə l i n e 'a t s	 ə l i n 'e 'a t s 
alleugerada	ə ʎ ə w ʒ ə ɾ 'a ð ə	 ə ʎ 'ɛ w ʒ ə ɾ 'a ð ə 
alleugerades	ə ʎ ə w ʒ ə ɾ 'a ð ə s	 ə ʎ 'ɛ w ʒ ə ɾ 'a ð ə s 
alleugerant	ə ʎ ə w ʒ ə ɾ 'a n t	 ə ʎ 'ɛ w ʒ ə ɾ 'a n t 
alleugerar	ə ʎ ə w ʒ ə ɾ 'a	 ə ʎ 'ɛ w ʒ ə ɾ 'a 
alleugerat	ə ʎ ə w ʒ ə ɾ 'a t	 ə ʎ 'ɛ w ʒ ə ɾ 'a t 
alleugerats	ə ʎ ə w ʒ ə ɾ 'a t s	 ə ʎ 'ɛ w ʒ ə ɾ 'a t s 
alleugerida	ə ʎ ə w ʒ ə ɾ 'i ð ə	 ə ʎ 'ɛ w ʒ ə ɾ 'i ð ə 
alleugerides	ə ʎ ə w ʒ ə ɾ 'i ð ə s	 ə ʎ 'ɛ w ʒ ə ɾ 'i ð ə s 
alleugerint	ə ʎ ə w ʒ ə ɾ 'i n t	 ə ʎ 'ɛ w ʒ ə ɾ 'i n t 
alleugerir	ə ʎ ə w ʒ ə ɾ 'i	 ə ʎ 'ɛ w ʒ ə ɾ 'i 
alleugerit	ə ʎ ə w ʒ ə ɾ 'i t	 ə ʎ 'ɛ w ʒ ə ɾ 'i t 
alleugerits	ə ʎ ə w ʒ ə ɾ 'i t s	 ə ʎ 'ɛ w ʒ ə ɾ 'i t s 
alleujament	ə ʎ ə w ʒ ə m 'e n t	 ə ʎ 'ə u ʒ ə m 'e n t 
almirallessa	ə l m i ɾ ə ʎ 'ə s ə	 ə l m i ɾ ə ʎ 'e s ə 
Altai	ə l t 'a j	 ə l t 'a i 
altea	ə l t 'ɛ ə	 ə l t 'e ə 
altrament	ə l t ɾ ə m 'e n t	 'a l t ɾ ə m 'e n t 
amainada	ə m ə j n 'a ð ə	 ə m ə i n 'a ð ə 
amainades	ə m ə j n 'a ð ə s	 ə m ə i n 'a ð ə s 
amainant	ə m ə j n 'a n t	 ə m ə i n 'a n t 
amainar	ə m ə j n 'a	 ə m ə i n 'a 
amainat	ə m ə j n 'a t	 ə m ə i n 'a t 
amainats	ə m ə j n 'a t s	 ə m ə i n 'a t s 
amants	ə m 'a n s	 ə m 'a n t s 
amarants	ə m ə ɾ 'a n s	 ə m ə ɾ 'a n t s 
amarg	ə m 'a ɾ k	 ə m 'a ɾ ə 
ambigu	ə m b 'i ɣ u	 ə m b 'i ɣ 
ambigú	ə m b i ɣ 'u	 ə m b 'i ɣ 'u 
ambulants	ə m b u l 'a n s	 ə m b u l 'a n t s 
amens	ə m 'ə n s	 ə m 'e n s 
ametler	ə m ə l l 'e	 ə m ə ʎ 'e 
amhàric	ə m 'a ɾ i k	 ə m ə ɾ i k 
ampolla	ə m p 'o ʎ ə	 ə m p 'ɔ ʎ ə 
anàrquica	ə n 'a ɾ k i k ə	 ə n 'a ɾ k 'i k ə 
anàrquics	ə n 'a ɾ k i t s	 ə n 'a ɾ k 'i t s 
Andreu	ə n d ɾ 'e w	 ə n d ɾ 'ɛ w 
anemoscopi	ə n ə m o s k 'ɔ p i	 ə n 'ə m o s k 'ɔ p i 
angiïtis	ə n ʒ i 'i t i s	 ə n ʒ 'i 'i t i s 
Ànglia	'a ŋ g l i ə	 'a ŋ g l 'i ə 
angoixa	ə ŋ g 'o ʃ ə	 ə ŋ g 'ɔ ʃ ə 
angoixat	ə ŋ g o ʃ 'a t	 ə ŋ g o i ʃ 'a t 
angoixats	ə ŋ g o ʃ 'a t s	 ə ŋ g o i ʃ 'a t s 
anhel	ə n 'ɛ l	 ə n 'a l 
anhela	ə n 'ɛ l ə	 ə n ə l ə 
anhelo	ə n 'ɛ l o	 ə n i l o 
animositat	ə n i m o z i t 'a t	 ə n 'i m o z i t 'a t 
anoienc	ə n o j 'ə ŋ k	 ə n o i 'ə ŋ k 
anorèxia	ə n o ɾ 'ɛ t s i ə	 ə n o ɾ 'ə t s i ə 
Antillia	ə n t i ʎ 'i ə	 ə n t 'i ʎ 'i ə 
antimoni	ə n t i m 'ɔ n i	 ə n t i m 'o n i 
antiquada	ə n t i k w 'a ð ə	 ə n t i k 'a ð ə 
antiquades	ə n t i k w 'a ð ə s	 ə n t i k 'a ð ə s 
antiquats	ə n t i k w 'a t s	 ə n t i k 'a t s 
Antoni	ə n t 'ɔ n i	 ə n t 'o n i 
aparcament	ə p ə ɾ k ə m 'e n t	 ə p 'a ɾ k ə m 'e n t 
aparell	ə p ə ɾ 'ə ʎ	 ə p ə ɾ 'e ʎ 
apartament	ə p ə ɾ t ə m 'e n t	 ə p 'a ɾ t ə m 'e n t 
apèndix	ə p 'ɛ n d i t s	 ə p 'ɛ n d i 
apicultura	ə p i k u l t 'u ɾ ə	 ə p i k 'u l t 'u ɾ ə 
aplaudiment	ə p l ə w ð i m 'e n t	 ə p l 'a w ð i m 'e n t 
apòstols	ə p 'ɔ s t o l s	 ə p 'ɔ s t 'ɔ l s 
apòstrofs	ə p 'ɔ s t ɾ o f s	 ə p 'ɔ s t ɾ 'o t s 
aprehendre	ə p ɾ ə 'ɛ n d ɾ ə	 ə p ɾ ə o n d ɾ ə 
aprofitament	ə p ɾ o f i t ə m 'e n t	 ə p ɾ o f 'i t ə m 'e n t 
aquell	ə k 'ə ʎ	 ə k 'e ʎ 
aqueus	ə k 'ɛ w s	 ə k 'ə 'u s 
aqüicultura	ə k w i k u l t 'u ɾ ə	 ə k i k 'u l t 'u ɾ ə 
arborètum	ə ɾ β o ɾ 'ɛ t u m	 ə ɾ β o ɾ 'ə t u m 
àrguens	'a ɾ ɣ ə n s	 'a ɾ ɣ 'e n s 
arguïts	ə ɾ ɣ u 'i t s	 ə ɾ ɣ 'i t s 
argument	ə ɾ ɣ u m 'e n t	 'a ɾ ɣ u m 'e n t 
armament	ə ɾ m ə m 'e n t	 'a ɾ m ə m 'e n t 
armistici	ə ɾ m i s t 'i s i	 ə ɾ m 'i s t 'i s i 
armisticis	ə ɾ m i s t 'i s i s	 ə ɾ m 'i s t 'i s i s 
arqueà	ə ɾ k e 'a	 ə ɾ k 'ə 'a 
arrabassar	ə r ə β ə s 'a	 ə r 'a β ə s 'a 
arranjament	ə r ə n ʒ ə m 'e n t	 ə r 'a n ʒ ə m 'e n t 
arreglada	ə r ə g g l 'a ð ə	 ə r ə ɣ l 'a ð ə 
arreglades	ə r ə g g l 'a ð ə s	 ə r ə ɣ l 'a ð ə s 
arreglant	ə r ə g g l 'a n t	 ə r ə ɣ l 'a n t 
arreglar	ə r ə g g l 'a	 ə r ə ɣ l 'a 
arreglat	ə r ə g g l 'a t	 ə r ə ɣ l 'a t 
arreglats	ə r ə g g l 'a t s	 ə r ə ɣ l 'a t s 
arrelament	ə r ə l ə m 'e n t	 ə r 'ɛ l ə m 'e n t 
arrodoniment	ə r o ð o n i m 'e n t	 ə r o ð 'ɔ n i m 'e n t 
arts	'a ɾ s	 'a ɾ t s 
arxiduquessa	ə ɾ ʃ i ð u k 'ə s ə	 ə ɾ ʃ i ð 'u k 'e s ə 
arxipèlag	ə ɾ ʃ i p 'ɛ l ə k	 ə ɾ ʃ i p 'ə l ə k 
asimètric	ə s i m 'ɛ t ɾ i k	 ə z i m 'ɛ t ɾ i k 
asímptota	ə z 'i m t o t ə	 ə z 'i m i t 'ɔ t ə 
aspirants	ə s p i ɾ 'a n s	 ə s p i ɾ 'a n t s 
assaig	ə s 'a t ʃ	 ə s 'a 'i ə 
assentament	ə s ə n t ə m 'e n t	 ə s 'ɛ n t ə m 'e n t 
assessorament	ə s ə s o ɾ ə m 'e n t	 ə s ə s 'ɔ ɾ ə m 'e n t 
assetjament	ə s ə d ʒ ə m 'e n t	 ə s 'ə d ʒ ə m 'e n t 
asseure	ə s 'ə w ɾ ə	 ə s 'ɛ w ɾ ə 
assignada	ə s i n n 'a ð ə	 ə s i ə n 'a ð ə 
assignades	ə s i n n 'a ð ə s	 ə s i ə n 'a ð ə s 
associatiu	ə s o s i ə t 'i w	 ə s o s 'i ə t 'i w 
associatius	ə s o s i ə t 'i w s	 ə s o s 'i ə t 'i w s 
associativa	ə s o s i ə t 'i v ə	 ə s o s 'i ə t 'i v ə 
associatives	ə s o s i ə t 'i v ə s	 ə s o s 'i ə t 'i v ə s 
assoliment	ə s o l i m 'e n t	 ə s 'ɔ l i m 'e n t 
astènia	ə s t 'è n i ə	 ə s t 'ɛ n i ə 
astènic	ə s t 'è n i k	 ə s t 'ɛ n i k 
asteroide	ə s t ə ɾ 'ɔ j ð ə	 ə s t ə ɾ 'ɔ 'i ð ə 
astorament	ə s t o ɾ ə m 'e n t	 ə s t 'ɔ ɾ ə m 'e n t 
astronauta	ə s t ɾ o n 'a w t ə	 ə s t ɾ o n 'a 'u t ə 
astronautes	ə s t ɾ o n 'a w t ə s	 ə s t ɾ o n 'a 'u t ə s 
atemptada	ə t ə m t 'a ð ə	 ə t ə m ə t 'a ð ə 
atemptades	ə t ə m t 'a ð ə s	 ə t ə m ə t 'a ð ə s 
atemptat	ə t ə m t 'a t	 ə t ə m ə t 'a t 
atemptats	ə t ə m t 'a t s	 ə t ə m ə t 'a t s 
atendre	ə t 'e n d ɾ ə	 ə t 'ə n d ɾ ə 
atlàntic	ə l l 'a n t i k	 ə t l 'a n t i k 
atles	'a l l ə s	 'a b b l ə s 
Atles	'a l l ə s	 'a b b l ə s 
atracament	ə t ɾ ə k ə m 'e n t	 ə t ɾ 'a k ə m 'e n t 
atraient	ə t ɾ ə j 'e n t	 ə t ɾ ə i 'e n t 
atrèsies	ə t ɾ 'ɛ z i ə s	 ə t ɾ 'ə z i ə s 
atreure	ə t ɾ 'ə w ɾ ə	 ə t ɾ 'ɛ w ɾ ə 
atrofiaria	ə t ɾ o f i ə ɾ 'i ə	 ə t ɾ o f 'i ə ɾ 'i ə 
atropellament	ə t ɾ o p ə ʎ ə m 'e n t	 ə t ɾ o p 'ə ʎ ə m 'e n t 
aurèola	ə w ɾ 'ɛ o l ə	 ə w ɾ 'ə 'ɔ l ə 
Àustria	'a w s t ɾ i ə	 'a w s t ɾ 'i ə 
autèntic	ə w t 'è n t i k	 ə w t 'ɛ n t i k 
autòmats	ə w t 'ɔ m ə t s	 ə w t 'ɔ m 'a t s 
autoretrat	ə w t o r ə t ɾ 'a t	 ə w t o ɾ ə t ɾ 'a t 
autoretrats	ə w t o r ə t ɾ 'a t s	 ə w t o ɾ ə t ɾ 'a t s 
autosuficiència	ə w t o s u f i s i 'ɛ n s i ə	 ə w t o z u f i s i 'ɛ n s i ə 
autosuficient	ə w t o s u f i s i 'e n t	 ə w t o z u f i s i 'e n t 
avançament	ə v ə n s ə m 'e n t	 ə v 'a n s ə m 'e n t 
avantbraç	ə v ə m b ɾ 'a s	 ə v ə n t ə ɾ 'a s 
avantpassat	ə v ə m p ə s 'a t	 ə v ə n t p ə s 'a t 
avantpassats	ə v ə m p ə s 'a t s	 ə v ə n t p ə s 'a t s 
avinguda	ə v i ŋ g 'u ð ə	 ə v 'i ŋ g 'u ð ə 
avingudes	ə v i ŋ g 'u ð ə s	 ə v 'i ŋ g 'u ð ə s 
avituallament	ə v i t u ə ʎ ə m 'e n t	 ə v i t u 'a ʎ ə m 'e n t 
avorriment	ə v o r i m 'e n t	 ə v 'ɔ r i m 'e n t 
avortament	ə v o ɾ t ə m 'e n t	 ə v 'ɔ ɾ t ə m 'e n t 
babaues	b ə β 'a w ə s	 b ə β 'a ə s 
barbacoa	b ə ɾ β ə k 'o ə	 b ə ɾ β ə k 'ɔ ə 
bàrbar	b 'a ɾ β ə	 b 'a ɾ β 'a 
bards	b 'a ɾ s	 b 'a ɾ t s 
barranquisme	b ə r ə ŋ k 'i z m ə	 b ə r 'a ŋ k 'i z m ə 
basament	b ə z ə m 'e n t	 b 'a z ə m 'e n t 
bastament	b ə s t ə m 'e n t	 b 'a s t ə m 'e n t 
bastard	b ə s t 'a ɾ t	 b ə s t 'a ɾ ə 
bastiment	b ə s t i m 'e n t	 b 'a s t i m 'e n t 
bateria	b ə t ə ɾ 'i ə	  b e t ə ɾ 'i ə 
bateries	b ə t ə ɾ 'i ə s	  b e t ə ɾ 'i ə s 
Batle	b 'a l l ə	 b 'a b b l ə 
Batle	b 'a l l ə	 b 'a b b l ə 
baül	b ə 'u l	 b 'a 'u l 
beata	b e 'a t ə	 b ə 'a t ə 
becllarg	b ə k ʎ 'a ɾ k	 b ə k ʎ 'a ɾ ə 
becquerel	b ə k k ə ɾ 'ɛ l	 b 'ɛ k k ə ɾ 'ɛ l 
beisbol	b ə j z β 'ɔ l	 b 'ə j z β 'ɔ l 
benedictí	b ə n ə ð i t t 'i	 b ə n ə ð 'i t t 'i 
beneficiarà	b ə n ə f i s i ə ɾ 'a	 b ə n ə f i s i 'a ɾ 'a 
beneficiosa	b ə n ə f i s i 	 b ə n ə f i s i 'o s ə 
beneficioses	b ə n ə f i s i 'o z ə s	 b ə n ə f i s i 'o s ə s 
beneficiosos	b ə n ə f i s i 'o z o s	 b ə n ə f i s i 'o s o s 
beneït	b ə n ə 'i t	 b ə n 'e 'i t 
beneïts	b ə n ə 'i t s	 b ə n ə 'i s 
Besalú	b ə z ə l 'u	 b ə z 'a l 'u 
besnebot	b ə z n ə β 'o t	 b ə z n ə β 'ɔ t 
beure	b 'ə w ɾ ə	 b 'ɛ w ɾ ə 
bíceps	b 'i s ə t s	 b 'i s 'ə t s 
Bigorra	b i ɣ 'ɔ r ə	 b i ɣ 'o r ə 
biogènesi	b i o ʒ 'ɛ n ə z i	 b i o ʒ 'ə n ə z i 
bioluminescència	b i o l u m i n ə t s 'ɛ n s i ə	 b i o l u m 'i n ə t s 'ɛ n s i ə 
bioma	b i 'ɔ m ə	 b i 'o m ə 
bisexual	b i s ə t s u 'a l	 b 'i z ə t s u 'a l 
bisexualitat	b i s ə t s u ə l i t 'a t	 b 'i z ə t s u ə l i t 'a t 
bisexuals	b i s ə t s u 'a l s	 b 'i z ə t s u 'a l s 
bitlles	b 'i l l ə s	 b 'i ʎ ʎ ə s 
bizantí	b i z ə n t 'i	 b i z 'a n t 'i 
bizantina	b i z ə n t 'i n ə	 b i z 'a n t 'i n ə 
Blancaneus	b l ə ŋ k ə n 'ɛ w s	 b l ə ŋ k ə n 'ə 'u s 
blens	b l 'ə n s	 b l 'e n s 
boc	b 'o k	 b 'ɔ k 
boca	b 'o k ə	 b 'ɔ k ə 
bocs	b 'o t s	 b 'ɔ t s 
boda	b 'o ð ə	 b 'ɔ ð ə 
bodes	b 'o ð ə s	 b 'ɔ ð ə s 
boicotejada	b o j k o t ə ʒ 'a ð ə	 b 'ɔ j k o t ə ʒ 'a ð ə 
boicotejades	b o j k o t ə ʒ 'a ð ə s	 b 'ɔ j k o t ə ʒ 'a ð ə s 
boicotejar	b o j k o t ə ʒ 'a	 b 'ɔ j k o t ə ʒ 'a 
boicotejat	b o j k o t ə ʒ 'a t	 b 'ɔ j k o t ə ʒ 'a t 
boicotejats	b o j k o t ə ʒ 'a t s	 b 'ɔ j k o t ə ʒ 'a t s 
boirina	b o j ɾ 'i n ə	 b o i ɾ 'i n ə 
boirum	b o j ɾ 'u m	 b 'ɔ j ɾ 'u m 
bolca	b 'o l k ə	 b 'ɔ l k ə 
bolquen	b 'o l k ə n	 b 'ɔ l k ə n 
bolxevic	b o l ʃ ə v 'i k	 b 'ɔ l ʃ ə v 'i k 
bolxevisme	b o l ʃ ə v 'i z m ə	 b 'ɔ l ʃ ə v 'i z m ə 
bomba	b 'o m b ə	 b 'ɔ m b ə 
bomber	b o m b 'e	 b 'o m b 'e 
bombes	b 'o m b ə s	 b 'ɔ m b ə s 
bombo	b 'o m b o	 b 'ɔ m b o 
bombolla	b o m b 'o ʎ ə	 b o m b 'ɔ ʎ ə 
bonze	b 'ɔ n z ə	 b 'o n z ə 
bonzessa	b o n z 'ə s ə	 b 'o n z 'e s ə 
boques	b 'o k ə s	 b 'ɔ k ə s 
borda	b 'o ɾ ð ə	 b 'ɔ ɾ ð ə 
bordo	b 'o ɾ ð o	 b 'ɔ ɾ ð o 
borratxera	b o r ə t ʃ 'e ɾ ə	 b o r 'a t ʃ 'e ɾ ə 
borrut	b o r 'u t	 b 'o r 'u t 
borsa	b 'o ɾ s ə	 b 'ɔ ɾ s ə 
borsari	b o ɾ s 'a ɾ i	 b 'o s 'a ɾ i 
borsària	b o ɾ s 'a ɾ i ə	 b 'o s 'a ɾ i ə 
borses	b 'o ɾ s ə s	 b 'ɔ ɾ s ə s 
borsista	b o ɾ s 'i s t ə	 b 'o s 'i s t ə 
bossa	b 'o s ə	 b 'ɔ s ə 
bosses	b 'o s ə s	 b 'ɔ s ə s 
bossut	b o s 'u t	 b 'o s 'u t 
boxa	b 'o t s ə	 b 'ɔ t s ə 
boxes	b 'o t s ə s	 b 'ɔ t s ə s 
brànquia	b ɾ 'a ŋ k i ə	 b ɾ 'a ŋ k 'i ə 
brànquies	b ɾ 'a ŋ k i ə s	 b ɾ 'a ŋ k 'i ə s 
brètol	b ɾ 'ɛ t o l	 b ɾ 'ə t o l 
brètola	b ɾ 'ɛ t o l ə	 b ɾ 'ə t o l ə 
brètoles	b ɾ 'ɛ t o l ə s	 b ɾ 'ə t o l ə s 
brètols	b ɾ 'ɛ t o ls	 b ɾ 'ə t o l s 
bretxa	b ɾ 'e t ʃ ə	 b ɾ 'ɛ t ʃ ə 
broda	b ɾ 'o ð ə	 b ɾ 'ɔ ð ə 
brolla	b ɾ 'o ʎ ə	 b ɾ 'ɔ ʎ ə 
brollen	b ɾ 'o ʎ ə n	 b ɾ 'ɔ ʎ ə n 
bruguera	b ɾ u ɣ 'e ɾ ə	 b ɾ 'u ɣ 'e ɾ ə 
brúixola	b ɾ 'u ʃ o l ə	 b ɾ 'u ʃ 'ɔ l ə 
bruixot	b ɾ u ʃ 'ɔ t	 b ɾ 'u ʃ 'ɔ t 
brullola	b ɾ u ʎ 'ɔ l ə	 b ɾ 'u ʎ 'ɔ l ə 
búbal	b 'u β ə l	 b 'u β 'a l 
búfal	b 'u f ə l	 b 'u f 'a l 
búfals	b 'u f ə l s	 b 'u f 'a l s 
búgula	b 'u ɣ u l ə	 b 'u ɣ 'u l ə 
buidada	b u j ð 'a ð ə	 b u i ð 'a ð ə 
buidades	b u j ð 'a ð ə s	 b u i ð 'a ð ə s 
buidar	b u j ð 'a	 b u i ð 'a 
buidatge	b u j ð 'a d ʒ ə	 b u i ð 'a d ʒ ə 
buidor	b u j ð 'o	 b u i ð 'o 
búlgara	b 'u l ɣ ə ɾ ə	 b 'u l ɣ 'a ɾ ə 
burgundi	b u ɾ ɣ 'u n d i	 b 'u ɾ ɣ 'u n d i 
burundès	b u ɾ u n d 'ə s	 b u ɾ 'u n d 'ə s 
burundesa	b u ɾ u n d 'ə z ə	 b u ɾ 'u n d 'ə z ə 
burundeses	b u ɾ u n d 'ə z ə s	 b u ɾ 'u n d 'ə z ə s 
butè	b u t 'ə	 b 'u t 'ə 
butxaca	b u t ʃ 'a k ə	 b 'u t ʃ 'a k ə 
butxaques	b u t ʃ 'a k ə s	 b 'u t ʃ 'a k ə s 
cadascú	k ə ð ə s k 'u	 k 'a ð ə s k 'u 
cadascun	k ə ð ə s k 'u n	 k 'a ð ə s k 'u n 
caiguda	k ə j ɣ 'u ð ə	 k 'a j ɣ 'u ð ə 
caigudes	k ə j ɣ 'u ð ə s	 k 'a j ɣ 'u ð ə s 
caigut	k ə j ɣ 'u t	 k 'a j ɣ 'u t 
caiguts	k ə j ɣ 'u t s	 k 'a j ɣ 'u t s 
calabruixar	k ə l ə β ɾ u ʃ 'a	 k ə l ə β ɾ 'u ʃ 'a 
Calabuig	k ə l ə β 'u t ʃ	 k ə l ə β 'u ʃ 
calamarsejar	k ə l ə m ə ɾ s ə ʒ 'a	 k ə l ə m 'a ɾ s ə ʒ 'a 
calàndria	k ə l 'a n d ɾ i ə	 k ə l 'a n d ɾ 'i ə 
caler	k ə l 'ə	 k ə l 'e 
campament	k ə m p ə m 'e n t	 k 'a m p ə m 'e n t 
candela	k ə n d 'ɛ l ə	 k ə n d 'ə l ə 
canela	k ə n 'ɛ l ə	 k ə n 'ə l ə 
caneles	k ə n 'ɛ l ə s	 k ə n 'ə l ə s 
caníbals	k ə n 'i β ə l s	 k ə n 'i β 'a l s 
canoa	k ə n 'o ə	 k ə n 'ɔ ə 
cansament	k ə n s ə m 'e n t	 k 'a n s ə m 'e n t 
cantants	k ə n t 'a n s	 k ə n t 'a n t s 
càpsules	k 'a t s u l ə s	 k 'a s u l ə s 
capteniment	k ə t t ə n i m 'e n t	 k ə t t 'ɛ n i m 'e n t 
caputxeta	k ə p u t ʃ 'ə t ə	 k ə p 'u t ʃ 'ə t ə 
caputxí	k ə p u t ʃ 'i	 k ə p 'u t ʃ 'i 
caputxina	k ə p u t ʃ 'i n ə	 k ə p 'u t ʃ 'i n ə 
caputxino	k ə p u t ʃ 'i n o	 k ə p 'u t ʃ 'i n o 
caputxins	k ə p u t ʃ 'i n s	 k ə p 'u t ʃ 'i n s 
carbassejar	k ə ɾ β ə s ə ʒ 'a	 k ə ɾ β 'a s ə ʒ 'a 
carboni	k ə ɾ β 'ɔ n i	 k ə ɾ β 'o n i 
carbonis	k ə ɾ β 'ɔ n i s	 k ə ɾ β 'o n i s 
carei	k ə ɾ 'ə j	 k ə ɾ 'ə i 
carranquejar	k ə r ə ŋ k ə ʒ 'a	 k ə r 'a ŋ k ə ʒ 'a 
casament	k ə z ə m 'e n t	 k 'a z ə m 'e n t 
castanyer	k ə s t ə ɲ 'e	 k ə s t 'a ɲ 'e 
castanyereda	k ə s t ə ɲ ə ɾ 'ə ð ə	 k ə s t 'a ɲ ə ɾ 'ə ð ə 
catastròfic	k ə t ə s t ɾ 'ɔ f i k	 k 'a t ə s t ɾ 'ɔ f i k 
catastròfica	k ə t ə s t ɾ 'ɔ f i k ə	 k 'a t ə s t ɾ 'ɔ f i k ə 
catastròfics	k ə t ə s t ɾ 'ɔ f i t s	 k 'a t ə s t ɾ 'ɔ f i t s 
catastròfiques	k ə t ə s t ɾ 'ɔ f i k ə s	 k 'a t ə s t ɾ 'ɔ f i k ə s 
catastrofisme	k ə t ə s t ɾ o f 'i z m ə	 k 'a t ə s t ɾ o f 'i z m ə 
Caterina	k ə t ə ɾ 'i n ə	  k e t ə ɾ 'i n ə 
catorze	k ə t 'o ɾ z ə	 k ə t 'ɔ ɾ z ə 
cautela	k ə w t 'ɛ l ə	 k ə w t 'ə l ə 
cautxú	k ə w t ʃ 'u	 k 'a w t ʃ 'u 
cavernícola	k ə v ə ɾ n 'i k o l ə	  k e v ə ɾ n 'i k o l ə 
Ceilan	s ə j l 'a n	 s ə i l 'a n 
cella	s 'ə ʎ ə	 s 'e ʎ ə 
celles	s 'ə ʎ ə s	 s 'e ʎ ə s 
celtibèric	s ə l t i β 'ɛ ɾ i k	 s 'ɛ l t i β 'ɛ ɾ i k 
cens	s 'ə n s	 s 'e n s 
centre	s 'e n t ɾ ə	 s 'ɛ n t ɾ ə 
centren	s 'e n t ɾ ə n	 s 'ɛ n t ɾ ə n 
centres	s 'e n t ɾ ə s	 s 'ɛ n t ɾ ə s 
cèntrica	s 'è n t ɾ i k ə	 s 'ɛ n t ɾ 'i k ə 
cèntriques	s 'è n t ɾ i k ə s	 s 'ɛ n t ɾ i k ə s 
centro	s 'e n t ɾ o	 s 'ɛ n t ɾ o 
ceptre	s 'e t t ɾ ə	 s 'ə t t ɾ ə 
cèrcols	s 'ɛ ɾ k o l s	 s 'ɛ ɾ k 'ɔ l s 
cerquem	s ə ɾ k 'ə m	 s 'ɛ ɾ k 'ə m 
cessament	s ə s ə m 'e n t	 s 'ə s ə m 'e n t 
cessen	s 'e s ə n	 s 'ə s ə n 
ciberespai	s i β ə ɾ ə s p 'a j	 s i β ə ɾ ə s p 'a i 
cilíndrica	s i l 'i n d ɾ i k ə	 s i l 'i n d ɾ 'i k ə 
ciment	s i m 'e n t	 s 'i m 'e n t 
cintura	s i n t 'u ɾ ə	 s 'i n t 'u ɾ ə 
cintures	s i n t 'u ɾ ə s	 s 'i n t 'u ɾ ə s 
circuit	s i ɾ k 'u j t	 s 'i ɾ k 'u j t 
circuits	s i ɾ k 'u j t s	 s 'i ɾ k 'u j t s 
circumcisió	s i ɾ k u n s i z i 'o	 s i ɾ k u t s i z i 'o 
ciutadà	s i w t ə ð 'a	 s 'i w t 'a ð 'a 
ciutadana	s i w t ə ð 'a n ə	 s 'i w t ə ð 'a n ə 
ciutadanes	s i w t ə ð 'a n ə s	 s 'i w t ə ð 'a n ə s 
ciutadania	s i w t ə ð ə n 'i ə	 s 'i w t ə ð ə n 'i ə 
ciutadans	s i w t ə ð 'a n s	 s 'i w t ə ð 'a n s 
ciutadella	s i w t ə ð 'e ʎ ə	 s 'i w t ə ð 'e ʎ ə 
Ciutadella	s i w t ə ð 'e ʎ ə	 s 'i w t ə ð 'e ʎ ə 
clavicèmbal	k l ə v i s 'ɛ m b ə l	 k l ə v i s 'ə m b ə l 
clona	k l 'ɔ n ə	 k l 'o n ə 
clones	k l 'ɔ n ə s	 k l 'o n ə s 
cloni	k l 'ɔ n i	 k l 'o n i 
clonin	k l 'ɔ n i n	 k l 'o n i n 
clonis	k l 'ɔ n i s	 k l 'o n i s 
clono	k l 'ɔ n o	 k l 'o n o 
clora	k l 'ɔ ɾ ə	 k l 'o ɾ ə 
clores	k l 'ɔ ɾ ə s	 k l 'o ɾ ə s 
closes	k l 'ɔ z ə s	 k l 'o z ə s 
cobles	k 'o b b l ə s	 k 'ɔ b b l ə s 
coco	k 'o k o	 k 'ɔ k o 
cofoi	k o f 'ɔ j	 k o f 'o i 
cogoma	k o ɣ 'ɔ m ə	 k o ɣ 'o m ə 
cogombre	k o ɣ 'o m b ɾ ə	 k o ɣ 'ɔ m b ɾ ə 
colesteatoma	k o l ə s t e ə t 'ɔ m ə	 k o l ə s t ə ə t 'o m ə 
colesteatomes	k o l ə s t e ə t 'ɔ m ə s	 k o l ə s t ə ə t 'o m ə s 
colibrí	k o l i β ɾ 'i	 k o l 'i β ɾ 'i 
colonialisme	k o l o n i ə l 'i z m ə	 k o l o n 'i ə l 'i z m ə 
colonialista	k o l o n i ə l 'i s t ə	 k o l o n 'i ə l 'i s t ə 
colossos	k o l 'o s o s	 k o l 'ɔ s o s 
colze	k 'o l z ə	 k 'ɔ l z ə 
com	k 'ɔ m	 k 'o m 
comandament	k o m ə n d ə m 'e n t	 k o m 'a n d ə m 'e n t 
comandaments	k o m ə n d ə m 'e n s	 k o m ə n d ə m 'e n t s 
comandants	k o m ə n d 'a n s	 k o m ə n d 'a n t s 
comboi	k o m b 'ɔ j	 k o m b 'o i 
començament	k o m ə n s ə m 'e n t	 k o m 'ɛ n s ə m 'e n t 
compartiment	k o m p ə ɾ t i m 'e n t	 k o m p 'a ɾ t i m 'e n t 
complement	k o m p l ə m 'e n t	 k 'ɔ m p l ə m 'e n t 
complerts	k o m p l 'ɛ ɾ s	 k o m p l 'ɛ ɾ t s 
còmplices	k 'ɔ m p l i s ə s	 k 'ɔ m p l 'i s ə s 
compliment	k o m p l i m 'e n t	 k 'ɔ m p l i m 'e n t 
comportament	k o m p o ɾ t ə m 'e n t	 k o m p 'ɔ ɾ t ə m 'e n t 
compra	k 'o m p ɾ ə	 k 'ɔ m p ɾ ə 
compren	k 'o m p ɾ ə n	 k 'ɔ m p ɾ ə n 
compres	k 'o m p ɾ ə s	 k 'ɔ m p ɾ ə s 
compro	k 'o m p ɾ o	 k 'ɔ m p ɾ o 
compta	k 'o m t ə	 k 'ɔ m 'ə t ə 
comptables	k o m t 'a b b l ə s	 k o m ə t 'a b b l ə s 
comptada	k o m t 'a ð ə	 k o m ə t 'a ð ə 
comptades	k o m t 'a ð ə s	 k o m ə t 'a ð ə s 
compte	k 'o m t ə	 k 'ɔ m t ə 
compten	k 'o m t ə n	 k 'ɔ m i t ə n 
comptes	k 'o m t ə s	 k 'ɔ m t ə s 
comtat	k o n t 'a t	 k o m t 'a t 
comtats	k o n t 'a t s	 k o m t 'a t s 
comte	k 'o n t ə	 k 'ɔ n t ə 
comtes	k 'o n t ə s	 k 'ɔ n t ə s 
conca	k 'o ŋ k ə	 k 'ɔ ŋ k ə 
concepte	k o n s 'ɛ t t ə	 k o n s 'ə t t ə 
concloses	k o ŋ k l 'ɔ z ə s	 k o ŋ k l 'o z ə s 
concursant	k o ŋ k u ɾ s 'a n t	 k o ŋ k 'u ɾ s 'a n t 
concursos	k o ŋ k 'u ɾ s o s	 k 'o ŋ k 'u ɾ s o s 
condicionament	k o n d i s i o n ə m 'e n t	 k o n d i s i 'ɔ n ə m 'e n t 
coneixement	k o n ə ʃ ə m 'e n t	 k o n 'ə ʃ ə m 'e n t 
cònjuge	k 'ɔ n ʒ u ʒ ə	 k 'ɔ n ʒ 'u ʒ ə 
conjuntiva	k o n ʒ u n t 'i v ə	 k o n ʒ 'u n t 'i v ə 
conjuntives	k o n ʒ u n t 'i v ə s	 k o n ʒ 'u n t 'i v ə s 
conjuntura	k o n ʒ u n t 'u ɾ ə	 k o n ʒ 'u n t 'u ɾ ə 
conopeu	k o n o p 'ɛ w	 k o n o p 'ə w 
conques	k 'o ŋ k ə s	 k 'ɔ ŋ k ə s 
conquesta	k o ŋ k 'e s t ə	 k o ŋ k 'ə s t ə 
conscient	k o n t s i 'e n t	 k o n s i 'e n t 
consell	k o n s 'ə ʎ	 k o n s 'e ʎ 
consens	k o n s 'ə n s	 k o n s 'e n s 
consentiment	k o n s ə n t i m 'e n t	 k o n s 'ɛ n t i m 'e n t 
consonants	k o n s o n 'a n s	 k o n s o n 'a n t s 
consta	k 'o n s t ə	 k 'ɔ n s t ə 
constants	k o n s t 'a n s	 k o n s t 'a n t s 
conte	k 'o n t ə	 k 'ɔ n t ə 
conten	k 'o n t ə n	 k 'ɔ n t ə n 
contes	k 'o n t ə s	 k 'ɔ n t ə s 
contigu	k o n t 'i ɣ u	 k o n t 'i ɣ 
contingents	k o n t i n ʒ 'e n s	 k o n t 'i ŋ g 'e n s 
continguda	k o n t i ŋ g 'u ð ə	 k o n t 'i ŋ g 'u ð ə 
contingudes	k o n t i ŋ g 'u ð ə s	 k o n t 'i ŋ g 'u ð ə s 
contingut	k o n t i ŋ g 'u t	 k o n t 'i ŋ g 'u t 
continguts	k o n t i ŋ g 'u t s	 k o n t 'i ŋ g 'u t s 
contra	k 'o n t ɾ ə	 k 'ɔ n t ɾ ə 
contraatacada	k o n t ɾ ə ə t ə k 'a ð ə	 k o n t ɾ 'a ə t ə k 'a ð ə 
contraatacades	k o n t ɾ ə ə t ə k 'a ð ə s	 k o n t ɾ 'a ə t ə k 'a ð ə s 
contraatacat	k o n t ɾ ə ə t ə k 'a t	 k o n t ɾ 'a ə t ə k 'a t 
contraatacats	k o n t ɾ ə ə t ə k 'a t s	 k o n t ɾ 'a ə t ə k 'a t s 
contrarestades	k o n t ɾ ə ɾ ə s t 'a ð ə s	 k o n t ɾ 'a ɾ ə s t 'a ð ə s 
contrarestats	k o n t ɾ ə ɾ ə s t 'a t s	 k o n t ɾ 'a ɾ ə s t 'a t s 
contravinguda	k o n t ɾ ə v i ŋ g 'u ð ə	 k o n t ɾ ə v 'i ŋ g 'u ð ə 
contravingudes	k o n t ɾ ə v i ŋ g 'u ð ə s	 k o n t ɾ ə v 'i ŋ g 'u ð ə s 
contravingut	k o n t ɾ ə v i ŋ g 'u t	 k o n t ɾ ə v 'i ŋ g 'u t 
contravinguts	k o n t ɾ ə v i ŋ g 'u t s	 k o n t ɾ ə v 'i ŋ g 'u t s 
contundent	k o n t u n d 'e n t	 k o n t 'u n d 'e n t 
copa	k 'o p ə	 k 'ɔ p ə 
copes	k 'o p ə s	 k 'ɔ p ə s 
copiarà	k o p i ə ɾ 'a	 k o p i 'a ɾ 'a 
copiaria	k o p i ə ɾ 'i ə	 k o p 'i ə ɾ 'i ə 
copisteria	k o p i s t ə ɾ 'i ə	 k o p 'i s t ə ɾ 'i ə 
copsa	k 'o t s ə	 k 'ɔ t s ə 
copsada	k o p s 'a ð ə	 k o t s 'a ð ə 
copsades	k o p s 'a ð ə s	 k o t s 'a ð ə s 
coquessa	k o k 'ə s ə	 k o k 'e s ə 
cora	k 'ɔ ɾ ə	 k 'o ɾ ə 
corbatí	k o ɾ β ə t 'i	 k o ɾ β 'a t 'i 
coreans	k o ɾ e 'a n s	 k o ɾ 'ə 'a n s 
córner	k 'o ɾ n ə	 k 'o ɾ n 'e  
cornubianita	k o ɾ n u β i ə n 'i t ə	 k o ɾ n u β 'i ə n 'i t ə 
corre	k 'o r ə	 k 'ɔ r ə 
corren	k 'o r ə n	 k 'ɔ r ə n 
corrents	k o r 'e n s	 k o r 'e n t s 
corro	k 'o r o	 k 'ɔ r o 
corrompre	k o r 'o m p ɾ ə	 k o r 'ɔ m p ɾ ə 
corrompuda	k o r o m p 'u ð ə	 k o r 'o m p 'u ð ə 
corrompudes	k o r o m p 'u ð ə s	 k o r 'o m p 'u ð ə s 
corromput	k o r o m p 'u t	 k o r 'o m p 'u t 
corromputs	k o r o m p 'u t s	 k o r 'o m p 'u t s 
corroure	k o r 'ɔ w ɾ ə	 k o r 'ɔ 'u ɾ ə 
corruptible	k o r u t t 'i b b l ə	 k o r 'u t t 'i b b l ə 
corruptibles	k o r u t t 'i b b l ə s	 k o r 'u t t 'i b b l ə s 
corsa	k 'o ɾ s ə	 k 'ɔ ɾ s ə 
corses	k 'o ɾ s ə s	 k 'ɔ ɾ s ə s 
cosa	k 'ɔ z ə	 k 'o z ə 
coses	k 'ɔ z ə s	 k 'o z ə s 
cosmos	k 'o z m o s	 k 'ɔ z m o s 
cotxe	k 'o t ʃ o	 k 'ɔ t ʃ ə 
cotxes	k 'o t ʃ ə s	 k 'ɔ t ʃ ə s 
courenc	k o w ɾ 'ə ŋ k	 k o u ɾ 'ə ŋ k 
covard	k o v 'a ɾ t	 k o v 'a ɾ ə 
creador	k ɾ e ə ð 'o	 k ɾ ə ə ð 'o 
creen	k ɾ 'e ə n	 k ɾ 'ɛ ə n 
creient	k ɾ ə j 'e n t	 k ɾ ə i 'e n t 
creixement	k ɾ ə ʃ ə m 'e n t	 k ɾ 'ɛ ʃ ə m 'e n t 
creixen	k ɾ 'e ʃ ə n	 k ɾ 'ɛ ʃ ə n 
créixer	k ɾ 'e ʃ ə	 k ɾ 'e ʃ 'e  
crema	k ɾ 'e m ə	 k ɾ 'ə m ə 
cremen	k ɾ 'e m ə n	 k ɾ 'ə m ə n 
cremes	k ɾ 'e m ə s	 k ɾ 'ə m ə s 
creure	k ɾ 'ə w ɾ ə	 k ɾ 'ɛ w ɾ ə 
creus	k ɾ 'ɛ w s	 k ɾ 'ə w s 
criatura	k ɾ i ə t 'u ɾ ə	 k ɾ 'i ə t 'u ɾ ə 
criatures	k ɾ i ə t 'u ɾ ə s	 k ɾ 'i ə t 'u ɾ ə s 
cristianismes	k ɾ i s t i ə n 'i z m ə s	 k ɾ i s t 'i ə n 'i z m ə s 
Cristina	k ɾ i s t 'i n ə	 k ɾ 'i s t 'i n ə 
cristina	k ɾ i s t 'i n ə	 k ɾ 'i s t 'i n ə 
cuaample	k u ə 'a m p l ə	 k u 'a 'a m p l ə 
cuguços	k u ɣ 'u s o s	 k 'u ɣ 'u s o s 
cuidada	k u j ð 'a ð ə	 k u i ð 'a ð ə 
cuidades	k u j ð 'a ð ə s	 k u i ð 'a ð ə s 
cuidar	k u j ð 'a	 k u i ð 'a 
cuidares	k u j ð 'a ɾ ə s	 k u i ð 'a ɾ ə s 
cuidava	k u j ð 'a v ə	 k u i ð 'a v ə 
cuinada	k u j n 'a ð ə	 k u i n 'a ð ə 
cuinades	k u j n 'a ð ə s	 k u i n 'a ð ə s 
cuinar	k u j n 'a	 k u i n 'a 
cuiner	k u j n 'e	 k u i n 'e 
cuitada	k u j t 'a ð ə	 k u i t 'a ð ə 
cuitades	k u j t 'a ð ə s	 k u i t 'a ð ə s 
cuitar	k u j t 'a	 k u i t 'a 
culblanc	k u l β l 'a ŋ k	 k u l ə l 'a ŋ k 
cullera	k u ʎ 'e ɾ ə	 k 'u ʎ 'e ɾ ə 
Cullera	k u ʎ 'e ɾ ə	 k 'u ʎ 'e ɾ ə 
cultura	k u l t 'u ɾ ə	 k 'u l t 'u ɾ ə 
cultures	k u l t 'u ɾ ə s	 k 'u l t 'u ɾ ə s 
cursada	k u ɾ s 'a ð ə	 k 'u ə s 'a ð ə 
cursades	k u ɾ s 'a ð ə s	 k 'u ə s 'a ð ə s 
cursat	k u ɾ s 'a t	 k 'u ə s 'a t 
cursats	k u ɾ s 'a t s	 k 'u ə s 'a t s 
cursiu	k u ɾ s 'i w	 k 'u ɾ s 'i w 
cursiva	k u ɾ s 'i v ə	 k 'u ɾ s 'i v ə 
cursives	k u ɾ s 'i v ə s	 k 'u ɾ s 'i v ə s 
curts	k 'u ɾ s	 k 'u ɾ t s 
cuscuta	k u s k 'u t ə	 k 'u s k 'u t ə 
dard	d 'a ɾ t	 d 'a ɾ ə 
darmstadti	d ə ɾ n s t 'a t t i	 d 'a ɾ n s t 'a t t i 
darrere	d ə r 'e ɾ ə	 d ə r 'ɛ ɾ ə 
de	d 'ə	 d ə 
dèbil	d 'ə β i l	 d 'ɛ β i l 
dèbit	d 'ə β i t	 d 'ɛ β i t 
dècada	d 'ə k ə ð ə	 d 'ɛ k ə ð ə 
dècade	d 'ə k ə ð ə	 d 'ɛ k 'a ð ə 
dècima	d 'ə s i m ə	 d 'ɛ s i m ə 
decréixer	d ə k ɾ 'e ʃ ə	 d ə k ɾ 'e ʃ 'e  
defalliment	d ə f ə ʎ i m 'e n t	 d ə f 'a ʎ i m 'e n t 
defora	d ə f 'ɔ ɾ ə	 d ə f 'o ɾ ə 
deguin	d 'ə ɣ i n	 d 'ɛ ɣ i n 
deguis	d 'ə ɣ i s	 d 'ɛ ɣ i s 
deis	d 'ə j s	 d 'ə i s 
deixeble	d ə ʃ 'e b b l ə	 d ə ʃ 'ə b b l ə 
delictiu	d ə l i t t 'i w	 d ə l 'i t t 'i w 
delictius	d ə l i t t 'i w s	 d ə l 'i t t 'i w s 
delictiva	d ə l i t t 'i v ə	 d ə l 'i t t 'i v ə 
delictives	d ə l i t t 'i v ə s	 d ə l 'i t t 'i v ə s 
dempeus	d ə m p 'ɛ w s	 d ə m p 'ə w s 
Dénia	d 'e n i ə	 d 'e n 'i ə 
dens	d 'ə n s	 d 'e n s 
departament	d ə p ə ɾ t ə m 'e n t	 d ə p 'a ɾ t ə m 'e n t 
desafiament	d ə z ə f i ə m 'e n t	 d ə z ə f 'i ə m 'e n t 
desarmament	d ə z ə ɾ m ə m 'e n t	 d ə z 'a ɾ m ə m 'e n t 
desarreglada	d ə z ə r ə g g l 'a ð ə	 d ə z ə r ə ɣ l 'a ð ə 
desarreglades	d ə z ə r ə g g l 'a ð ə s	 d ə z ə r ə ɣ l 'a ð ə s 
desarreglar	d ə z ə r ə g g l 'a	 d ə z ə r ə ɣ l 'a 
desarreglat	d ə z ə r ə g g l 'a t	 d ə z ə r ə ɣ l 'a t 
desarreglats	d ə z ə r ə g g l 'a t s	 d ə z ə r ə ɣ l 'a t s 
desatendre	d ə z ə t 'e n d ɾ ə	 d ə z ə t 'ə n d ɾ ə 
descarrilament	d ə s k ə r i l ə m 'e n t	 d ə s k ə r 'i l ə m 'e n t 
descobriment	d ə s k o β ɾ i m 'e n t	 d ə s k 'ɔ β ɾ i m 'e n t 
descompte	d ə s k 'o m t ə	 d ə s k 'ɔ m t ə 
descontentament	d ə s k o n t ə n t ə m 'e n t	 d ə s k o n t 'ə n t ə m 'e n t 
descriptiu	d ə s k ɾ i t t 'i w	 d ə s k ɾ 'i t t 'i w 
descriptiva	d ə s k ɾ i t t 'i v ə	 d ə s k ɾ 'i t t 'i v ə 
desembarcament	d ə z ə m b ə ɾ k ə m 'e n t	 d ə z ə m b 'a ɾ k ə m 'e n t 
desembeinar	d ə z ə m b ə j n 'a	 d ə z ə m b ə i n 'a 
desembre	d ə z 'e m b ɾ ə	 d ə z 'ə m b ɾ ə 
desfet	d ə s f 'e t	 d ə s f 'ə t 
desfeta	d ə s f 'e t ə	 d ə s f 'ə t ə 
desforestar	d ə s f o ɾ ə s t 'a	 d ə s f 'o ɾ ə s t 'a 
desguàs	d ə z ɣ w 'a s	 d ə z ɣ 'a s 
deshidratar	d ə s i ð ɾ ə t 'a	 d ə z i ð ɾ ə t 'a 
desig	d ə z 'i t ʃ	 d ə z 'i 
designada	d ə z i n n 'a ð ə	 d ə z i ə n 'a ð ə 
designades	d ə z i n n 'a ð ə s	 d ə z i ə n 'a ð ə s 
designat	d ə z i n n 'a t	 d ə z i ə n 'a t 
designats	d ə z i n n 'a t s	 d ə z i ə n 'a t s 
desigs	d ə z 'i t ʃ s	 d ə z 'i n s 
desintegrada	d ə z i n t ə ɣ ɾ 'a ð ə	 d ə z 'i n t ə ɣ ɾ 'a ð ə 
desintegrar	d ə z i n t ə ɣ ɾ 'a	 d ə z 'i n t ə ɣ ɾ 'a 
desintegrarem	d ə z i n t ə ɣ ɾ ə ɾ 'ə m	 d ə z 'i n t ə ɣ ɾ ə ɾ 'ə m 
desintegrares	d ə z i n t ə ɣ ɾ 'a ɾ ə s	 d ə z 'i n t ə ɣ ɾ 'a ɾ ə s 
desintegraria	d ə z i n t ə ɣ ɾ ə ɾ 'i ə	 d ə z 'i n t ə ɣ ɾ ə ɾ 'i ə 
desintegrava	d ə z i n t ə ɣ ɾ 'a v ə	 d ə z 'i n t ə ɣ ɾ 'a v ə 
desintegrem	d ə z i n t ə ɣ ɾ 'ə m	 d ə z 'i n t ə ɣ ɾ 'ə m 
desinterès	d ə z i n t ə ɾ 'ə s	 d ə z 'i n t ə ɾ 'ə s 
desistida	d ə z i s t 'i ð ə	 d ə z 'i s t 'i ð ə 
desistides	d ə z i s t 'i ð ə s	 d ə z 'i s t 'i ð ə s 
desistit	d ə z i s t 'i t	 d ə z 'i s t 'i t 
desistits	d ə z i s t 'i t s	 d ə z 'i s t 'i t s 
desnonament	d ə z n o n ə m 'e n t	 d ə z n 'ɔ n ə m 'e n t 
deso	d 'e z o	 d 'ə z o 
desobeïts	d ə z o β ə 'i t s	 d ə z o β ə 'i s 
desordre	d ə z 'o ɾ ð ɾ ə	 d ə z 'ɔ ɾ ð ɾ ə 
desplaçament	d ə s p l ə s ə m 'e n t	 d ə s p l 'a s ə m 'e n t 
desplegament	d ə s p l ə ɣ ə m 'e n t	 d ə s p l 'ə ɣ ə m 'e n t 
despreniment	d ə s p ɾ ə n i m 'e n t	 d ə s p ɾ 'ɛ n i m 'e n t 
Despuig	d ə s p 'u t ʃ	 d ə s p 'u ʃ 
despuis	d ə s p 'u j s	 d ə s p 'u i s 
destacament	d ə s t ə k ə m 'e n t	 d ə s t 'a k ə m 'e n t 
desterrament	d ə s t ə r ə m 'e n t	 d ə s t 'ɛ r ə m 'e n t 
destre	d 'ə s t ɾ ə	 d 'e s t ɾ ə 
desuetud	d ə z u ə t 'u t	 d ə z 'u ə t 'u t 
desvergonyiment	d ə z v ə ɾ ɣ o ɲ i m 'e n t	 d ə z v ə ɾ ɣ 'ɔ ɲ i m 'e n t 
desvetlament	d ə z v ə l l ə m 'e n t	 d ə z v 'ə ʎ l ə m 'e n t 
desvetllament	d ə z v ə ʎ ʎ ə m 'e n t	 d ə z v 'ə ʎ ʎ ə m 'e n t 
desviament	d ə z v i ə m 'e n t	 d ə z v 'i ə m 'e n t 
deteriorament	d ə t ə ɾ i o ɾ ə m 'e n t	 d ə t ə ɾ i 'ɔ ɾ ə m 'e n t 
detestable	d ə t ə s t 'a b b l ə	 d 'ə t ə s t 'a b b l ə 
detestables	d ə t ə s t 'a b b l ə s	 d 'ə t ə s t 'a b b l ə s 
detestar	d ə t ə s t 'a	 d 'ə t ə s t 'a 
detinguda	d ə t i ŋ g 'u ð ə	 d ə t 'i ŋ g 'u ð ə 
detingudes	d ə t i ŋ g 'u ð ə s	 d ə t 'i ŋ g 'u ð ə s 
detingut	d ə t i ŋ g 'u t	 d ə t 'i ŋ g 'u t 
detona	d ə t 'ɔ n ə	 d ə t 'o n ə 
detones	d ə t 'ɔ n ə s	 d ə t 'o n ə s 
detono	d ə t 'ɔ n o	 d ə t 'o n o 
detriment	d ə t ɾ i m 'e n t	 d 'ɛ t ɾ i m 'e n t 
deure	d 'ə w ɾ ə	 d 'ɛ w ɾ ə 
diàfans	d i 'a f ə n s	 d i 'a f 'a n s 
diamants	d i ə m 'a n s	 d i ə m 'a n t s 
diapasó	d i ə p ə z 'o	 d i 'a p ə z 'o 
diarquia	d i ə ɾ k 'i ə	 d i 'a ɾ k 'i ə 
diarrea	d i ə r 'ɛ ə	 d i ə r 'e ə 
diatomea	d i ə t o m 'ɛ ə	 d i ə t o m 'e ə 
difondre	d i f 'o n d ɾ ə	 d i f 'ɔ n d ɾ ə 
digestió	d i ʒ ə s t i 'o	 d 'i ʒ ə s t i 'o 
digestiu	d i ʒ ə s t 'i w	 d 'i ʒ ə s t 'i w 
digestius	d i ʒ ə s t 'i w s	 d 'i ʒ ə s t 'i w s 
digestiva	d i ʒ ə s t 'i v ə	 d 'i ʒ ə s t 'i v ə 
digestives	d i ʒ ə s t 'i v ə s	 d 'i ʒ ə s t 'i v ə s 
dijous	d i ʒ 'ɔ w s	 d i ʒ 'o 'u s 
dimecres	d i m 'e k ɾ ə s	 d i m 'ɛ k ɾ ə s 
dírham	d 'i ɾ ə m	 d 'i ɾ e m 
dismenorrea	d i z m ə n o r 'ɛ ə	 d 'i z m ə n o r 'e ə 
disposes	d i s p 'ɔ z ə s	 d i s p 'o z ə s 
dissort	d i s 'ɔ ɾ t	 d i s 'o ɾ t 
distanciament	d i s t ə n s i ə m 'e n t	 d i s t ə n s 'i ə m 'e n t 
distendre	d i s t 'e n d ɾ ə	 d i s t 'ɛ n d ɾ ə 
distintiva	d i s t i n t 'i v ə	 d i s t 'i n t 'i v ə 
distintives	d i s t i n t 'i v ə s	 d i s t 'i n t 'i v ə s 
distreta	d i s t ɾ 'e t ə	 d i s t ɾ 'ə t ə 
distreure	d i s t ɾ 'ə w ɾ ə	 d i s t ɾ 'ɛ w ɾ ə 
disturbi	d i s t 'u ɾ β i	 d 'i s t 'u ɾ β i 
dividend	d i v i ð 'e n t	 d i v i ð 'ə n d 
Djibouti	d ʒ i β 'ɔ w t i	 d ʒ i β 'ɔ 'u t i 
doble	d 'o b b l ə	 d 'ɔ b b l ə 
dobles	d 'o b b l ə s	 d 'ɔ b b l ə s 
document	d o k u m 'e n t	 d 'ɔ k u m 'e n t 
dogma	d 'o m m ə	 d 'ɔ m m ə 
dogmes	d 'o m m ə s	 d 'ɔ m m ə s 
dòlar	d 'ɔ l ə	 d 'ɔ l 'a 
dolça	d 'o l s ə	 d 'ɔ l s ə 
dolces	d 'o l s ə s	 d 'ɔ l s ə s 
dolços	d 'o l s o s	 d 'ɔ l s o s 
doler	d o l 'ə	 d o l 'e 
dolguda	d o l ɣ 'u ð ə	 d 'ɔ l ɣ 'u ð ə 
dolgudes	d o l ɣ 'u ð ə s	 d 'ɔ l ɣ 'u ð ə s 
dolgut	d o l ɣ 'u t	 d 'ɔ l ɣ 'u t 
dolguts	d o l ɣ 'u t s	 d 'ɔ l ɣ 'u t s 
domestica	d o m ə s t 'i k ə	 d 'o m ə s t 'i k ə 
domesticació	d o m ə s t i k ə s i 'o	 d 'o m ə s t i k ə s i 'o 
domesticar	d o m ə s t i k 'a	 d 'o m ə s t i k 'a 
domesticitat	d o m ə s t i s i t 'a t	 d 'o m ə s t i s i t 'a t 
domestiques	d o m ə s t 'i k ə s	 d 'o m ə s t 'i k ə s 
domestiqués	d o m ə s t i k 'e s	 d 'o m ə s t i k 'e s 
domtà	d o n t 'a	 d o m t 'a 
donen	d 'o n ə n	 d 'ɔ n ə n 
donzella	d o n z 'e ʎ ə	 d 'o n z 'e ʎ ə 
dopa	d 'o p ə	 d 'ɔ p ə 
dotze	d 'o d z ə	 d 'ɔ d z ə 
dreces	d ɾ 'ə s ə s	 d ɾ 'e s ə s 
dutxada	d u t ʃ 'a ð ə	 d 'u t ʃ 'a ð ə 
dutxades	d u t ʃ 'a ð ə s	 d 'u t ʃ 'a ð ə s 
dutxar	d u t ʃ 'a	 d 'u t ʃ 'a 
ebenisteria	ə β ə n i s t ə ɾ 'i ə	 ə β ə n 'i s t ə ɾ 'i ə 
Ebre	'e β ɾ ə	 'ə β ɾ ə 
ebri	'ɛ β ɾ i	 'ə β ɾ i 
eclèctic	ə k l 'ə t t i k	 ə k l 'ɛ t t i k 
eclipsa	ə k l 'i t s ə	 ə k l 'i s ə 
ecosistema	ə k o s i s t 'e m ə	 ə k o z i s t 'ə m ə 
Edimburg	ə ð i m b 'u ɾ k	 ə ð 'i m b 'u ɾ k 
Eduard	ə ð u 'a ɾ t	 ə ð u 'a ɾ ə 
efervescent	ə f ə ɾ v ə t s 'e n t	 ə f ə ɾ v ə s k 'e n t 
ègida	'ə ʒ i ð ə	 'ɛ ʒ i ð ə 
ego	'e ɣ o	 'ə ɣ o 
Eivissa	ə j v 'i s ə	 ə i v 'i s ə 
eixe	'e ʃ ə	 'ə ʃ ə 
eixugaparabrises	ə ʃ u ɣ ə p ə ɾ ə β ɾ 'i z ə s	 ə ʃ 'u ɣ ə p ə ɾ ə β ɾ 'i z ə s 
eland	ə l 'a n t	 ə l 'a n d 
ele	'ɛ l ə	 'ə l ə 
elèctrica	ə l 'ə t t ɾ i k ə	 ə l 'ə t t ɾ 'i k ə 
elèctrics	ə l 'ə t t ɾ i t s	 ə l 'ə t t ɾ 'i t s 
elèctrode	ə l 'ə t t ɾ o ð ə	 ə l 'ə t t ɾ 'ɔ ð ə 
element	ə l ə m 'e n t	 'ə l ə m 'e n t 
eles	'ɛ l ə s	 'ə l ə s 
Eloi	ə l 'ɔ j	 ə l 'o i 
eloqüent	ə l o k w 'e n t	 ə l o ə w 'e n t 
em	'ə m	 ə m 
emasculada	ə m ə s k u l 'a ð ə	 'ə m ə s k u l 'a ð ə 
emasculades	ə m ə s k u l 'a ð ə s	 'ə m ə s k u l 'a ð ə s 
emascular	ə m ə s k u l 'a	 'ə m ə s k u l 'a 
emasculat	ə m ə s k u l 'a t	 'ə m ə s k u l 'a t 
emasculats	ə m ə s k u l 'a t s	 'ə m ə s k u l 'a t s 
embassament	ə m b ə s ə m 'e n t	 ə m b 'a s ə m 'e n t 
emblema	ə m b l 'ɛ m ə	 ə m b l 'ə m ə 
emboirar	ə m b o j ɾ 'a	 ə m b o i ɾ 'a 
emborratxar	ə m b o r ə t ʃ 'a	 ə m b o r 'a t ʃ 'a 
emfisema	ə m f i z 'ɛ m ə	 ə m f i z 'ə m ə 
empaitar	ə m p ə j t 'a	 ə m p ə i t 'a 
empiema	ə m p i 'ɛ m ə	 ə m p i 'ə m ə 
emplaçament	ə m p l ə s ə m 'e n t	 ə m p l 'a s ə m 'e n t 
empleat	ə m p l e 'a t	 ə m p l 'e 'a t 
empra	'e m p ɾ ə	 'ə m p ɾ ə 
empremta	ə m p ɾ 'e n t ə	 ə m p ɾ 'ə m t ə 
empren	'e m p ɾ ə n	 'ə m p ɾ ə n 
empresonament	ə m p ɾ ə z o n ə m 'e n t	 ə m p ɾ ə z 'ɔ n ə m 'e n t 
ena	'e n ə	 'ə n ə 
encapçalament	ə ŋ k ə p s ə l ə m 'e n t	 ə ŋ k ə p s 'a l ə m 'e n t 
encaputxar	ə ŋ k ə p u t ʃ 'a	 ə ŋ k ə p 'u t ʃ 'a 
encaputxat	ə ŋ k ə p u t ʃ 'a t	 ə ŋ k ə p 'u t ʃ 'a t 
encendre	ə n s 'e n d ɾ ə	 ə n s 'ə n d ɾ ə 
enclavament	ə ŋ k l ə v ə m 'e n t	 ə ŋ k l 'a v ə m 'e n t 
encreuament	ə ŋ k ɾ ə w ə m 'e n t	 ə ŋ k ɾ 'ə w ə m 'e n t 
endarrere	ə n d ə r 'e ɾ ə	 ə n d ə r 'ɛ ɾ ə 
endarreriment	ə n d ə r ə ɾ i m 'e n t	 ə n d ə r 'ɛ ɾ i m 'e n t 
endèmies	ə n d 'ɛ m i ə s	 ə n d 'ə m i ə s 
endeutament	ə n d ə w t ə m 'e n t	 ə n d 'ɛ w t ə m 'e n t 
endillunsat	ə n d i ʎ u n s 'a t	 ə n d i ʎ 'u n s 'a t 
enduriment	ə n d u ɾ i m 'e n t	 ə n d 'u ɾ i m 'e n t 
ene	'e n ə	 'ə n ə 
Engiadina	ə n ʒ i ə ð 'i n ə	 ə n ʒ 'i ə ð 'i n ə 
enginyer	ə n ʒ i ɲ 'e	 ə n ʒ 'i ɲ 'e 
enginyeria	ə n ʒ i ɲ ə ɾ 'i ə	 ə n ʒ 'i ɲ ə ɾ 'i ə 
enlairament	ə n l ə j ɾ ə m 'e n t	 ə n l 'a j ɾ ə m 'e n t 
enmig	ə m m 'i t ʃ	 ə n m 'i k 
enorme	ə n 'o ɾ m ə	 ə n 'ɔ ɾ m ə 
enormes	ə n 'o ɾ m ə s	 ə n 'ɔ ɾ m ə s 
enquesta	ə ŋ k 'e s t ə	 ə ŋ k 'ə s t ə 
ensems	ə n s 'ɛ n s	 ə n s 'ə n s 
ensenyament	ə n s ə ɲ ə m 'e n t	 ə n s 'ə ɲ ə m 'e n t 
entelèquia	ə n t ə l 'ə k i ə	 ə n t ə l 'ɛ k i ə 
entendre	ə n t 'e n d ɾ ə	 ə n t 'ə n d ɾ ə 
enteniment	ə n t ə n i m 'e n t	 ə n t 'ɛ n i m 'e n t 
enterrament	ə n t ə r ə m 'e n t	 ə n t 'ɛ r ə m 'e n t 
èntesi	'ɛ n t ə z i	 'ə n t ə z i 
entremaliadura	ə n t ɾ ə m ə l i ə ð 'u ɾ ə	 ə n t ɾ ə m ə l 'i ə ð 'u ɾ ə 
entrenament	ə n t ɾ ə n ə m 'e n t	 ə n t ɾ 'ə n ə m 'e n t 
entreteniment	ə n t ɾ ə t ə n i m 'e n t	 ə n t ɾ ə t 'ɛ n i m 'e n t 
entretinguda	ə n t ɾ ə t i ŋ g 'u ð ə	 ə n t ɾ ə t 'i ŋ g 'u ð ə 
entretingudes	ə n t ɾ ə t i ŋ g 'u ð ə s	 ə n t ɾ ə t 'i ŋ g 'u ð ə s 
entretingut	ə n t ɾ ə t i ŋ g 'u t	 ə n t ɾ ə t 'i ŋ g 'u t 
entretinguts	ə n t ɾ ə t i ŋ g 'u t s	 ə n t ɾ ə t 'i ŋ g 'u t s 
entusiasmada	ə n t u z i ə z m 'a ð ə	 ə n t u z i 'a z m 'a ð ə 
entusiasmades	ə n t u z i ə z m 'a ð ə s	 ə n t u z i 'a z m 'a ð ə s 
entusiasmadís	ə n t u z i ə z m ə ð 'i s	 ə n t u z i 'a z m ə ð 'i s 
entusiasmat	ə n t u z i ə z m 'a t	 ə n t u z i 'a z m 'a t 
entusiasmats	ə n t u z i ə z m 'a t s	 ə n t u z i 'a z m 'a t s 
enuig	ə n 'u t ʃ	 ə n 'u ʃ 
epèntesi	ə p 'ɛ n t ə z i	 ə p 'ə n t ə z i 
epicens	ə p i s 'ə n s	 ə p i s 'e n s 
epifonema	ə p i f o n 'ɛ m ə	 ə p i f o n 'ə m ə 
epistemologia	ə p i s t ə m o l o ʒ 'i ə	 ə p 'i s t ə m o l o ʒ 'i ə 
èpsilon	'ə t s i l o n	 'ə t s i l 'o n 
equidistant	ə k i ð i s t 'a n t	 ə k 'i ð i s t 'a n t 
equilibrista	ə k i l i β ɾ 'i s t ə	 ə k i l 'i β ɾ 'i s t ə 
equipament	ə k i p ə m 'e n t	 ə k 'i p ə m 'e n t 
equivaler	ə k i v ə l 'ə	 ə k i v ə l 'e 
equivoco	ə k i v 'o k o	 ə k i v 'ɔ k o 
erèctil	ə ɾ 'ə t t i l	 ə ɾ 'ɛ t t i l 
eren	'e ɾ ə n	 'ɛ ɾ ə n 
errabund	ə r ə β 'u n t	 ə r ə β 'u n d 
erroni	ə r 'ɔ n i	 ə r 'o n i 
Esaú	ə z ə 'u	 ə z 'a 
esbiaixada	ə z β i ə ʃ 'a ð ə	 ə z β i 'a ʃ 'a ð ə 
esbiaixar	ə z β i ə ʃ 'a	 ə z β i 'a ʃ 'a 
esbufegar	ə z β u f ə ɣ 'a	 ə z β 'u f ə ɣ 'a 
escaig	ə s k 'a t ʃ	 ə s k 'a ʃ 
escairada	ə s k ə j ɾ 'a ð ə	 ə s k ə i ɾ 'a ð ə 
escairades	ə s k ə j ɾ 'a ð ə s	 ə s k ə i ɾ 'a ð ə s 
escairar	ə s k ə j ɾ 'a	 ə s k ə i ɾ 'a 
escairat	ə s k ə j ɾ 'a t	 ə s k ə i ɾ 'a t 
escairats	ə s k ə j ɾ 'a t s	 ə s k ə i ɾ 'a t s 
escalens	ə s k ə l 'ə n s	 ə s k ə l 'e n s 
escalfament	ə s k ə l f ə m 'e n t	 ə s k 'a l f ə m 'e n t 
escàner	ə s k 'a n ə	 ə s k 'a n e  
escapament	ə s k ə p ə m 'e n t	 ə s k 'a p ə m 'e n t 
escèptic	ə t s 'ə t t i k	 ə t s 'ɛ t t i k 
escèptica	ə t s 'ə t t i k ə	 ə t s 'ɛ t t i k ə 
escèptics	ə t s 'ə t t i t s	 ə t s 'ɛ t t i t s 
escèptiques	ə t s 'ə t t i k ə s	 ə t s 'ɛ t t i k ə s 
escletxa	ə s k l 'e t ʃ ə	 ə s k l 'ə t ʃ ə 
escolta	ə s k 'o l t ə	 ə s k 'ɔ l t ə 
escombra	ə s k 'o m b ɾ ə	 ə s k 'ɔ m b ɾ ə 
escridassar	ə s k ɾ i ð ə s 'a	 ə s k ɾ 'i ð ə s 'a 
escriptura	ə s k ɾ i t t 'u ɾ ə	 ə s k ɾ 'i t t 'u ɾ ə 
escrot	ə s k ɾ 'o t	 ə s k ɾ 'ɔ t 
escullera	ə s k u ʎ 'e ɾ ə	 ə s k 'u ʎ 'e ɾ ə 
escultura	ə s k u l t 'u ɾ ə	 ə s k 'u l t 'u ɾ ə 
esdeveniment	ə z ð ə v ə n i m 'e n t	 ə z ð ə v 'ɛ n i m 'e n t 
esdevinguda	ə z ð ə v i ŋ g 'u ð ə	 ə z ð ə v 'i ŋ g 'u ð ə 
esdevingudes	ə z ð ə v i ŋ g 'u ð ə s	 ə z ð ə v 'i ŋ g 'u ð ə s 
esdevingut	ə z ð ə v i ŋ g 'u t	 ə z ð ə v 'i ŋ g 'u t 
esdevinguts	ə z ð ə v i ŋ g 'u t s	 ə z ð ə v 'i ŋ g 'u t s 
esfilagarsada	ə s f i l ə ɣ ə ɾ s 'a ð ə	 ə s f i l ə ɣ 'a s 'a ð ə 
esfilagarsades	ə s f i l ə ɣ ə ɾ s 'a ð ə s	 ə s f i l ə ɣ 'a s 'a ð ə s 
esfilagarsar	ə s f i l ə ɣ ə ɾ s 'a	 ə s f i l ə ɣ 'a s 'a 
esfilagarsat	ə s f i l ə ɣ ə ɾ s 'a t	 ə s f i l ə ɣ 'a s 'a t 
esfilagarsats	ə s f i l ə ɣ ə ɾ s 'a t s	 ə s f i l ə ɣ 'a s 'a t s 
esfondrament	ə s f o n d ɾ ə m 'e n t	 ə s f 'ɔ n d ɾ ə m 'e n t 
esgotament	ə z ɣ o t ə m 'e n t	 ə z ɣ 'ɔ t ə m 'e n t 
esgüellar	ə z g w ə ʎ 'a	 ə z ɣ e ə ʎ 'a 
esguerro	ə z ɣ 'ɛ r o	 ə z ɣ u 'ɛ r o 
esment	ə z m 'e n t	 'e z m 'e n t 
esmorteïts	ə z m o ɾ t ə 'i t s	 ə z m o ɾ t ə 'i s 
espadatxí	ə s p ə ð ə t ʃ 'i	 ə s p ə ð 'a t ʃ 'i 
espagueti	ə s p ə ɣ 'ɛ t i	 ə s p ə ɣ 'ə t i 
espai	ə s p 'a j	 ə s p 'a i 
espatles	ə s p 'a l l ə s	 ə s p 'a b b l ə s 
espatlut	ə s p ə l l 'u t	 ə s p 'a l l 'u t 
espècia	ə s p 'ə s i ə	 ə s p 'ɛ s i ə 
espectre	ə s p 'e t t ɾ ə	 ə s p 'ɛ t t ɾ ə 
espicassar	ə s p i k ə s 'a	 ə s p 'i k ə s 'a 
espinavessa	ə s p i n ə v 'ə s ə	 ə s p i n ə v 'e s ə 
esplèndid	ə s p l 'ə n d i t	 ə s p l 'ɛ n d i t 
esplèndida	ə s p l 'ə n d i ð ə	 ə s p l 'ɛ n d i ð ə 
esplèndides	ə s p l 'ə n d i ð ə s	 ə s p l 'ɛ n d i ð ə s 
esplèndids	ə s p l 'ə n d i t s	 ə s p l 'ɛ n d i t s 
espona	ə s p 'ɔ n ə	 ə s p 'o n ə 
espondilodiscitis	ə s p o n d i l o ð i t s 'i t i s	 ə s p o n d i l 'ɔ ð i t s 'i t i s 
espontaneïtat	ə s p o n t ə n ə i t 'a t	 ə s p o n t 'a n ə i t 'a t 
esprémer	ə s p ɾ 'e m ə	 ə s p ɾ 'e m 'e  
esquarterar	ə s k w ə ɾ t ə ɾ 'a	 ə s k w 'a ɾ t ə ɾ 'a 
esquela	ə s k 'ɛ l ə	 ə s k 'ə l ə 
esquetx	ə s k 'e t ʃ	 ə s k 'ə t ʃ 
essa	'ə s ə	 'e s ə 
esser	ə s 'ə	 ə s 'e 
esta	'e s t ə	 'ə s t ə 
estai	ə s t 'a j	 ə s t 'a i 
estament	ə s t ə m 'e n t	 'ə s t ə m 'e n t 
estancament	ə s t ə ŋ k ə m 'e n t	 ə s t 'a ŋ k ə m 'e n t 
estendre	ə s t 'e n d ɾ ə	 ə s t 'ə n d ɾ ə 
estèpic	ə s t 'ə p i k	 ə s t 'ɛ p i k 
estèpica	ə s t 'ə p i k ə	 ə s t 'ɛ p i k ə 
estèpics	ə s t 'ə p i t s	 ə s t 'ɛ p i t s 
estèpiques	ə s t 'ə p i k ə s	 ə s t 'ɛ p i k ə s 
estetoscopi	ə s t ə t o s k 'ɔ p i	 ə s t 'ə t o s k 'ɔ p i 
estimulants	ə s t i m u l 'a n s	 ə s t i m u l 'a n t s 
estirament	ə s t i ɾ ə m 'e n t	 ə s t 'i ɾ ə m 'e n t 
estiregassada	ə s t i ɾ ə ɣ ə s 'a ð ə	 ə s t i ɾ 'ə ɣ ə s 'a ð ə 
estiregassar	ə s t i ɾ ə ɣ ə s 'a	 ə s t i ɾ 'ə ɣ ə s 'a 
estiuejada	ə s t i w ə ʒ 'a ð ə	 ə s t 'i w ə ʒ 'a ð ə 
estiuejades	ə s t i w ə ʒ 'a ð ə s	 ə s t 'i w ə ʒ 'a ð ə s 
estiuejar	ə s t i w ə ʒ 'a	 ə s t 'i w ə ʒ 'a 
estiuejat	ə s t i w ə ʒ 'a t	 ə s t 'i w ə ʒ 'a t 
estiuejats	ə s t i w ə ʒ 'a t s	 ə s t 'i w ə ʒ 'a t s 
estofa	ə s t 'o f ə	 ə s t 'ɔ f ə 
estoig	ə s t 'ɔ t ʃ	 ə s t 'ɔ 'i ə 
estómac	ə s t 'o m ə k	 ə s t 'o m 'a k 
estramoni	ə s t ɾ ə m 'ɔ n i	 ə s t ɾ ə m 'o n i 
estratagema	ə s t ɾ ə t ə ʒ 'ɛ m ə	 ə s t ɾ ə t ə ʒ 'ə m ə 
estrateg	ə s t ɾ ə t 'e k	 ə s t ɾ ə t 'ə ʒ 
estratègia	ə s t ɾ ə t 'ə ʒ i ə	 ə s t ɾ ə t 'ɛ ʒ i ə 
estructura	ə s t ɾ u t t 'u ɾ ə	 ə s t ɾ 'u t t 'u ɾ ə 
estudiantil	ə s t u ð i ə n t 'i l	 ə s t u ð i 'a n t 'i l 
estúrnid	ə s t 'u ɾ n i t	 ə s t 'u ɾ n i ð 
esverament	ə z v ə ɾ ə m 'e n t	 ə z v 'ɛ ɾ ə m 'e n t 
ètnia	'ə n n i ə	 'ɛ n n i ə 
eucaliptus	ə w k ə l 'i t t u s	 ə w k ə l 'i t t 'u s 
eufoni	ə w f 'ɔ n i	 ə w f 'o n i 
evangelitzar	ə v ə n ʒ ə l i d z 'a	 ə v 'a n ʒ ə l i d z 'a 
evolucionis	ə v o l u s i 'ɔ n i s	 ə v o l u s i 'o n i s 
excitotoxicitat	ə t s i t o t o t s i s i t 'a t	 ə t s i t 'ɔ t o t s i s i t 'a t 
Fàbregas	f 'a β ɾ ə ɣ ə s	 f 'a β ɾ ə ɣ 'a s 
fagosoma	f ə ɣ o z 'ɔ m ə	 f ə ɣ o z 'o m ə 
farciment	f ə ɾ s i m 'e n t	 f 'a ɾ s i m 'e n t 
farmacèutic	f ə ɾ m ə s 'ə w t i k	 f ə ɾ m ə s 'ɛ w t i k 
farmacèutica	f ə ɾ m ə s 'ə w t i k ə	 f ə ɾ m ə s 'ɛ w t i k ə 
farmacèutics	f ə ɾ m ə s 'ə w t i t s	 f ə ɾ m ə s 'ɛ w t i t s 
farmacèutiques	f ə ɾ m ə s 'ə w t i k ə s	 f ə ɾ m ə s 'ɛ w t i k ə s 
farts	f 'a ɾ s	 f 'a ɾ t s 
fascinants	f ə t s i n 'a n s	 f ə t s i n 'a n t s 
fauna	f 'a w n ə	 f 'a 'u n ə 
faune	f 'a w n ə	 f 'a 'u n ə 
feble	f 'e b b l ə	 f 'ə b b l ə 
febles	f 'e b b l ə s	 f 'ə b b l ə s 
febre	f 'e β ɾ ə	 f 'ə β ɾ ə 
febres	f 'e β ɾ ə s	 f 'ə β ɾ ə s 
fecund	f ə k 'u n t	 f ə k 'u n d 
feinada	f ə j n 'a ð ə	 f ə i n 'a ð ə 
feinejar	f ə j n ə ʒ 'a	  f e i n ə ʒ 'a 
feiner	f ə j n 'e	 f ə i n 'e 
feldspat	f ə l s p 'a t	 f 'ɛ l s p 'a t 
fen	f 'e n	 f 'ə n 
fendre	f 'ə n d ɾ ə	 f 'ɛ n d ɾ ə 
fens	f 'ə n s	 f 'e n s 
feren	f 'e ɾ ə n	 f 'ɛ ɾ ə n 
Fes	f 'e s	 f 'ə s 
festa	f 'e s t ə	 f 'ə s t ə 
festes	f 'e s t ə s	 f 'ə s t ə s 
feta	f 'e t ə	 f 'ə t ə 
fetes	f 'e t ə s	 f 'ə t ə s 
fetge	f 'e d ʒ ə	 f 'ə d ʒ ə 
feyen	f 'ə j ə n	 f ɲ ə n 
fímbria	f 'i m b ɾ i ə	 f 'i m b ɾ 'i ə 
finançament	f i n ə n s ə m 'e n t	 f i n 'a n s ə m 'e n t 
firmament	f i ɾ m ə m 'e n t	 f 'i ɾ m ə m 'e n t 
flairar	f l ə j ɾ 'a	 f l ə i ɾ 'a 
flairat	f l ə j ɾ 'a t	 f l ə i ɾ 'a t 
flairats	f l ə j ɾ 'a t s	 f l ə i ɾ 'a t s 
fleca	f l 'ɛ k ə	 f l 'ə k ə 
fletxa	f l 'e t ʃ ə	 f l 'ə t ʃ ə 
fletxes	f l 'e t ʃ ə s	 f l 'ə t ʃ ə s 
flirtejada	f l i ɾ t ə ʒ 'a ð ə	 f l 'i ɾ t ə ʒ 'a ð ə 
flirtejades	f l i ɾ t ə ʒ 'a ð ə s	 f l 'i ɾ t ə ʒ 'a ð ə s 
flirtejar	f l i ɾ t ə ʒ 'a	 f l 'i ɾ t ə ʒ 'a 
flirtejat	f l i ɾ t ə ʒ 'a t	 f l 'i ɾ t ə ʒ 'a t 
flirtejats	f l i ɾ t ə ʒ 'a t s	 f l 'i ɾ t ə ʒ 'a t s 
floristeria	f l o ɾ i s t ə ɾ 'i ə	 f l o ɾ 'i s t ə ɾ 'i ə 
fluorescència	f l u o ɾ ə t s 'ɛ n s i ə	 f l u 'o ɾ ə t s 'ɛ n s i ə 
fluorescents	f l u o ɾ ə t s 'e n s	 f l u 'o ɾ ə s k 'e n t s 
fluorur	f l u o ɾ 'u	 f l 'u o ɾ 'u 
foca	f 'o k ə	 f 'ɔ k ə 
folla	f 'o ʎ ə	 f 'ɔ ʎ ə 
folles	f 'o ʎ ə s	 f 'ɔ ʎ ə s 
foment	f o m 'e n t	 f 'ɔ m 'e n t 
fonament	f o n ə m 'e n t	 f 'ɔ n ə m 'e n t 
fonda	f 'o n d ə	 f 'ɔ n d ə 
fondes	f 'o n d ə s	 f 'ɔ n d ə s 
fondo	f 'o n d o	 f 'ɔ n d o 
fondos	f 'o n d o s	 f 'ɔ n d o s 
fondre	f 'o n d ɾ ə	 f 'ɔ n d ɾ ə 
fonema	f o n 'ɛ m ə	 f o n 'ə m ə 
fonen	f 'o n ə n	 f 'ɔ n ə n 
foques	f 'o k ə s	 f 'ɔ k ə s 
foraster	f o ɾ ə s t 'e	 f 'o ɾ ə s t 'e 
forca	f 'o ɾ k ə	 f 'ɔ ɾ k ə 
foren	f 'o ɾ ə n	 f 'ɔ ɾ ə n 
forma	f 'o ɾ m ə	 f 'ɔ ɾ m ə 
formatgeria	f o ɾ m ə d ʒ ə ɾ 'i ə	 f o ɾ m 'a d ʒ ə ɾ 'i ə 
formatget	f o ɾ m ə d ʒ 'ə t	 f o ɾ m 'a d ʒ 'ə t 
formen	f 'o ɾ m ə n	 f 'ɔ ɾ m ə n 
formes	f 'o ɾ m ə s	 f 'ɔ ɾ m ə s 
formo	f 'o ɾ m o	 f 'ɔ ɾ m o 
formula	f o ɾ m 'u l ə	 f 'o ɾ m 'u l ə 
forques	f 'o ɾ k ə s	 f 'ɔ ɾ k ə s 
fort	f 'ɔ ɾ t	 f 'o ɾ t 
fortuna	f o ɾ t 'u n ə	 f 'o ɾ t 'u n ə 
fortunes	f o ɾ t 'u n ə s	 f 'o ɾ t 'u n ə s 
fosca	f 'o s k ə	 f 'ɔ s k ə 
foscos	f 'o s k o s	 f 'ɔ s k o s 
foscúria	f o s k 'u ɾ i ə	 f 'o s k 'u ɾ i ə 
fosques	f 'o s k ə s	 f 'ɔ s k ə s 
foten	f 'o t ə n	 f 'ɔ t ə n 
foto	f 'o t o	 f 'ɔ t o 
fotos	f 'o t o s	 f 'ɔ t o s 
fotre	f 'o t ɾ ə	 f 'ɔ t ɾ ə 
fragment	f ɾ ə m m 'e n t	 f ɾ 'a m m 'e n t 
franctirador	f ɾ ə ŋ t t i ɾ ə ð 'o	 f ɾ ə n s t i ɾ ə ð 'o 
frecs	f ɾ 'ɛ t s	 f ɾ 'ə t s 
fregapeus	f ɾ ə ɣ ə p 'ɛ w s	 f ɾ ə ɣ ə p 'ə 'u s 
frenen	f ɾ 'e n ə n	 f ɾ 'ə n ə n 
frens	f ɾ 'ə n s	 f ɾ 'e n s 
fresi	f ɾ 'ɛ z i	 f ɾ 'ə z i 
fresis	f ɾ 'ɛ z i s	 f ɾ 'ə z i s 
fuet	f u 'ə t	 f 'u 'ə t 
fúmer	f 'u m ə	 f 'u m 'e  
funcionament	f u n s i o n ə m 'e n t	 f u n s i 'ɔ n ə m 'e n t 
furibund	f u ɾ i β 'u n t	 f u ɾ i β 'u n d 
furtiu	f u ɾ t 'i w	 f 'u ɾ t 'i w 
furtius	f u ɾ t 'i w s	 f 'u ɾ t 'i w s 
furtiva	f u ɾ t 'i v ə	 f 'u ɾ t 'i v ə 
furtives	f u ɾ t 'i v ə s	 f 'u ɾ t 'i v ə s 
fuster	f u s t 'e	 f 'u s t 'e 
fusterianisme	f u s t ə ɾ i ə n 'i z m ə	 f u s t ə ɾ 'i ə n 'i z m ə 
gagaús	g ə ɣ ə 'u s	 g ə ɣ 'a 'u s 
gaiata	g ə j 'a t ə	 g ə i 'a t ə 
gaiato	g ə j 'a t o	 g ə i 'a t o 
gaiter	g ə j t 'e	 g ə i t 'e 
galilea	g ə l i l 'ɛ ə	 g ə l i l 'e ə 
Galileu	g ə l i l 'ɛ w	 g ə l i l 'ə w 
gasela	g ə z 'ɛ l ə	 g ə z 'ə l ə 
gasoil	g ə z 'ɔ j l	 g ə z 'o 'i l 
gaussià	g ə w s i 'a	 g 'a w s i 'a 
gelosia	ʒ ə l o z 'i ə	 ʒ 'ɛ l o z 'i ə 
gemec	ʒ ə m 'e k	 ʒ ə m 'ɛ k 
gemma	ʒ 'e m m ə	 ʒ 'ə m m ə 
Gemma	ʒ 'e m m ə	 ʒ 'ə m m ə 
gemmes	ʒ 'ɛ m m ə s	 ʒ 'ə m m ə s 
gènere	ʒ 'ɛ n ə ɾ ə	 ʒ 'ə n ə ɾ ə 
Gènesi	ʒ 'ɛ n ə z i	 ʒ 'ə n ə z i 
gènesi	ʒ 'ɛ n ə z i	 ʒ 'ə n ə z i 
genísser	ʒ ə n 'i s ə	 ʒ ə n 'i s 'e  
geniüt	ʒ ə n i 'u t	 ʒ ə n 'i 'u t 
geniüts	ʒ ə n i 'u t s	 ʒ ə n 'i 'u t s 
Gènova	ʒ 'ə n o v ə	 ʒ 'ɛ n o v ə 
gespa	ʒ 'e s p ə	 ʒ 'ə s p ə 
gest	ʒ 'e s t	 ʒ 'ə s t 
gesta	ʒ 'e s t ə	 ʒ 'ə s t ə 
gestes	ʒ 'e s t ə s	 ʒ 'ə s t ə s 
gesto	ʒ 'ə s t o	 ʒ 'ɛ s t o 
gestos	ʒ 'e s t o s	 ʒ 'ɛ s t o s 
gimcana	ʒ i ŋ k 'a n ə	 ʒ i m k 'a n ə 
ginebra	ʒ i n 'e β ɾ ə	 ʒ i n 'ə β ɾ ə 
Ginebra	ʒ i n 'e β ɾ ə	 ʒ i n 'ə β ɾ ə 
ginesta	ʒ i n 'e s t ə	 ʒ i n 'ə s t ə 
ginestó	ʒ i n ə s t 'o	 ʒ 'i n ə s t 'o 
ginestola	ʒ i n ə s t 'ɔ l ə	 ʒ 'i n ə s t 'ɔ l ə 
girientorn	ʒ i ɾ i ə n t 'o n	 ʒ i ɾ i ə n t 'o ɾ n 
gland	g l 'a n t	 g l 'a n d 
glosa	g l 'ɔ z ə	 g l 'o z ə 
gloses	g l 'ɔ z ə s	 g l 'o z ə s 
gódua	g 'o ð u ə	 g 'o ð 'u ə 
goècia	g o 'ə s i ə	 g o t s i ə 
golfa	g 'o l f ə	 g 'ɔ l f ə 
golfes	g 'o l f ə s	 g 'ɔ l f ə s 
gorg	g 'o ɾ k	 g 'ɔ ɾ ə 
gorjut	g o ɾ ʒ 'u t	 g 'o ɾ ʒ 'u t 
gorrejar	g o r ə ʒ 'a	 g 'o r ə ʒ 'a 
gossa	g 'o s ə	 g 'ɔ s ə 
gossos	g 'o s o s	 g 'ɔ s o s 
gota	g 'o t ə	 g 'ɔ t ə 
gotes	g 'o t ə s	 g 'ɔ t ə s 
grandiosa	g ɾ ə n d i 'o z ə	 g ɾ ə n d i 'o s ə 
granuloma	g ɾ ə n u l 'ɔ m ə	 g ɾ ə n u l 'o m ə 
Grècia	g ɾ 'ə s i ə	 g ɾ 'ɛ s i ə 
greuge	g ɾ 'e w ʒ ə	 g ɾ 'ɛ w ʒ ə 
gronxa	g ɾ 'o n ʃ ə	 g ɾ 'ɔ n ʃ ə 
gruixut	g ɾ u ʃ 'u t	 g ɾ 'u ʃ 'u t 
guaitar	g w ə j t 'a	 g w ə i t 'a 
guaitat	g w ə j t 'a t	 g w ə i t 'a t 
guardiamarina	g w ə ɾ ð i ə m ə ɾ 'i n ə	 g w ə ɾ ð 'i ə m ə ɾ 'i n ə 
guatla	g w 'a l l ə	 g w 'a t l ə 
guerriller	g ə r i ʎ 'e	 g ə r 'i ʎ 'e 
guerrillera	g ə r i ʎ 'e ɾ ə	 g ə r 'i ʎ 'e ɾ ə 
guerrilleres	g ə r i ʎ 'e ɾ ə s	 g ə r 'i ʎ 'e ɾ ə s 
guilla	g 'i ʎ ə	 g u 'i ʎ ə 
guinda	g 'i n d ə	 g w 'i n d ə 
Guissona	g i s 'ɔ n ə	 g i s 'o n ə 
guitza	g 'i d z ə	 g w 'i d z ə 
guspira	g u s p 'i ɾ ə	 g 'u s p 'i ɾ ə 
gustatiu	g u s t ə t 'i w	 g 'u s t ə t 'i w 
gustatori	g u s t ə t 'ɔ ɾ i	 g 'u s t ə t 'ɔ ɾ i 
hàbil	'a β i l	 ə β i l 
hàbit	'a β i t	 ə β i t 
hàbitat	'a β i t ə t	 ə β i t 'a t 
hàbitats	'a β i t ə t s	 ə β i t 'a t s 
Hades	'a ð ə s	 i 'a ð ə s 
hagi	'a ʒ i	 ə ʒ i 
hàgim	'a ʒ i m	 ə ʒ i m 
hàgiu	'a ʒ i w	 ə ʒ i w 
Haia	'a j ə	 ə 'i ə 
Hainan	ə j n 'a n	 ə i n 'a n 
Hainaut	ə j n 'a w t	 ə i n 'a 'u t 
Haití	ə j t 'i	 ə i t 'i 
halitosi	ə l i t 'ɔ z i	 ə l 'i t 'ɔ z i 
haver	ə v 'ə	 ə v 'e 
hec	'ɛ k	 'a k 
Hècate	'ə k ə t ə	 ə k 'a t ə 
hegui	'ɛ ɣ i	 ə ɣ i 
heguin	'ɛ ɣ i n	 ə ɣ i n 
heguis	'ɛ ɣ i s	 ə ɣ i s 
helicotrema	ə l i k o t ɾ 'ɛ m ə	 ə l i k o t ɾ 'ə m ə 
hemangioma	ə m ə n ʒ i 'ɔ m ə	 ə m ə n ʒ i 'o m ə 
Hèmera	'ɛ m ə ɾ ə	 ə m ə ɾ ə 
Hèrcules	'ɛ ɾ k u l ə s	 ə ɾ k u l ə s 
hermenéutica	ə ɾ m ə n 'e w t i k ə	 ə ɾ m ə n 'e u t i k ə 
hèrnia	'ɛ ɾ n i ə	 ə ɾ n i ə 
heroi	ə ɾ 'ɔ j	 ə ɾ 'o i 
heroic	ə ɾ 'ɔ j k	 ə ɾ 'o 'i k 
hèrptil	'ɛ ɾ t t i l	 ə ɾ t t 'i l 
heura	'ɛ w ɾ ə	 ə 'u ɾ ə 
heure	'ə w ɾ ə	 ə 'u ɾ ə 
heus	'ɛ w s	 'ɛ 'u s 
hevea	ə v 'ɛ ə	 ə v 'e ə 
híbrid	'i β ɾ i t	 ə β ɾ i t 
hidroelèctrica	i ð ɾ o ə l 'ə t t ɾ i k ə	 i ð ɾ o ə l 'ə t t ɾ 'i k ə 
hidroelèctrics	i ð ɾ o ə l 'ə t t ɾ i t s	 i ð ɾ o ə l 'ə t t ɾ 'i t s 
hidroxinaftalè	i ð ɾ o t s i n ə f t ə l 'ə	 i ð ɾ o t s i n ə f t 'a l 'ə 
hieràtic	j ə ɾ 'a t i k	 i ə ɾ 'a t i k 
hieràtics	j ə ɾ 'a t i t s	 i ə ɾ 'a t i t s 
higiene	i ʒ i 'e n ə	 i ʒ i 'ə n ə 
himen	'i m ə n	 ə m ə n 
hipèrbaton	i p 'ɛ ɾ β ə t o n	 i p 'ɛ ɾ β ə t 'o n 
hiperespai	i p ə ɾ ə s p 'a j	 i p ə ɾ ə s p 'a i 
hola	'ɔ l ə	 ə l ə 
home	'ɔ m o	 ə m ə 
homes	'ɔ m ə s	 ə 'o m ə s 
hora	'ɔ ɾ ə	 ə ɾ ə 
hores	'ɔ ɾ ə s	 ə 'o ə s 
hort	'ɔ ɾ t	 ə 'o t 
horta	'ɔ ɾ t ə	 ə ɾ t ə 
hòstia	'ɔ s t i ə	 ə s t i ə 
hòsties	'ɔ s t i ə s	 ə s t i ə s 
i	'i	 i 
iaia	j 'a j ə	 i 'a j ə 
iaies	j 'a j ə s	 i 'a j ə s 
iaio	j 'a j o	 i 'a j o 
iarda	j 'a ɾ ð ə	 i 'a ɾ ð ə 
idea	i ð 'ɛ ə	 i ð 'e ə 
idealisme	i ð e ə l 'i z m ə	 i ð ə ə l 'i z m ə 
idealista	i ð e ə l 'i s t ə	 i ð ə ə l 'i s t ə 
iemenita	j ə m ə n 'i t ə	 i ə m ə n 'i t ə 
immens	i m m 'ə n s	 i m m 'e n s 
imparell	i m p ə ɾ 'ə ʎ	 i m p ə ɾ 'e ʎ 
ímpetu	'i m p ə t u	 'i m p ə t 'u 
imposes	i m p 'ɔ z ə s	 i m p 'o z ə s 
inadequat	i n ə ð ə k w 'a t	 i n 'a ð ə k w 'a t 
incomptable	i ŋ k o m t 'a b b l ə	 i ŋ k o m ə t 'a b b l ə 
increment	i ŋ k ɾ ə m 'e n t	 'i ŋ k ɾ ə m 'e n t 
incultura	i ŋ k u l t 'u ɾ ə	 i ŋ k 'u l t 'u ɾ ə 
indigestió	i n d i ʒ ə s t i 'o	 i n d 'i ʒ ə s t i 'o 
indignada	i n d i n n 'a ð ə	 i n d i ə n 'a ð ə 
indignades	i n d i n n 'a ð ə s	 i n d i ə n 'a ð ə s 
indústria	i n d 'u s t ɾ i ə	 i n d 'u s t ɾ 'i ə 
inerts	i n 'ɛ ɾ s	 i n 'ɛ ɾ t s 
ingent	i n ʒ 'e n t	 i ŋ g 'e n t 
iniciarà	i n i s i ə ɾ 'a	 i n i s i 'a ɾ 'a 
ininterromput	i n i n t ə r o m p 'u t	 i n 'i n t ə r 'o m p 'u t 
inquietud	i ŋ k i ə t 'u t	 i ŋ k 'i ə t 'u t 
insatisfactori	i n s ə t i s f ə t t 'ɔ ɾ i	 i n s 'a t i s f ə t t 'ɔ ɾ i 
instintiva	i n s t i n t 'i v ə	 i n s t 'i n t 'i v ə 
instintives	i n s t i n t 'i v ə s	 i n s t 'i n t 'i v ə s 
instrument	i n s t ɾ u m 'e n t	 'i n s t ɾ u m 'e n t 
insulinoma	i n s u l i n 'ɔ m ə	 i n s u l i n 'o m ə 
insurgents	i n s u ɾ ʒ 'e n s	 i n s 'u ɾ ʒ 'e n s 
intens	i n t 'ə n s	 i n t 'e n s 
intèrpret	i n t 'ɛ ɾ p ɾ ə t	 i n t 'ɛ ɾ p ɾ 'ə t 
interrompre	i n t ə r 'o m p ɾ ə	 i n t ə r 'ɔ m p ɾ ə 
interrompuda	i n t ə r o m p 'u ð ə	 i n t ə r 'o m p 'u ð ə 
interrompudes	i n t ə r o m p 'u ð ə s	 i n t ə r 'o m p 'u ð ə s 
interromput	i n t ə r o m p 'u t	 i n t ə r 'o m p 'u t 
interromputs	i n t ə r o m p 'u t s	 i n t ə r 'o m p 'u t s 
iònica	j 'ɔ n i k ə	 i 'ɔ n i k ə 
irremeiable	i r ə m ə j 'a b b l ə	 i r ə m ə i 'a b b l ə 
irresistible	i r ə z i s t 'i b b l ə	 i r ə z 'i s t 'i b b l ə 
isòbar	i z 'ɔ β ə	 i z 'ɔ β 'a 
Ístria	'i s t ɾ i ə	 'i s t ɾ 'i ə 
Iugoslàvia	j u ɣ o z l 'a v i ə	 i w ɣ o z l 'a v i ə 
jaciment	ʒ ə s i m 'e n t	 ʒ 'a s i m 'e n t 
Jaén	ʒ ə 'e n	 ʒ 'a 'e n 
jazz	ʒ 'a s	 ʒ 'a z ə 
jersei	ʒ ə ɾ s 'ə j	 ʒ ə ɾ s 'ə i 
jeure	ʒ 'ə w ɾ ə	 ʒ 'ɛ w ɾ ə 
joiós	ʒ o j 'o s	 ʒ o i 'o s 
jou	ʒ 'ɔ w	 ʒ 'o 
jove	ʒ 'o v ə	 ʒ 'ɔ v ə 
jóvens	ʒ 'o v ə n s	 ʒ 'o v 'e n s 
judaïtzada	ʒ u ð ə i d z 'a ð ə	 ʒ 'u ð ə i d z 'a ð ə 
judaïtzades	ʒ u ð ə i d z 'a ð ə s	 ʒ 'u ð ə i d z 'a ð ə s 
judaïtzar	ʒ u ð ə i d z 'a	 ʒ 'u ð ə i d z 'a 
judaïtzat	ʒ u ð ə i d z 'a t	 ʒ 'u ð ə i d z 'a t 
judaïtzats	ʒ u ð ə i d z 'a t s	 ʒ 'u ð ə i d z 'a t s 
jueu	ʒ u 'e w	 ʒ u 'ɛ w 
juntura	ʒ u n t 'u ɾ ə	 ʒ 'u n t 'u ɾ ə 
júnyer	ʒ 'u ɲ ə	 ʒ 'u ɲ 'e  
jurament	ʒ u ɾ ə m 'e n t	 ʒ 'u ɾ ə m 'e n t 
jurisdicció	ʒ u ɾ i z ð i t s i 'o	 ʒ u ɾ 'i z ð i t s i 'o 
kàiser	k 'a j z ə	 k 'a i z ə 
kazakh	k ə z 'a k	 k ə z 'a k ə 
la	l 'ə	 l ə 
laberints	l ə β ə ɾ 'i n s	 l ə β ə ɾ 'i n t s 
lacrosse	l ə k ɾ 'o s ə	 l ə k ɾ 'ɔ s ə 
lampisteria	l ə m p i s t ə ɾ 'i ə	 l ə m p 'i s t ə ɾ 'i ə 
lepra	l 'e p ɾ ə	 l 'ə p ɾ ə 
les	l 'ə s	 l ə s 
Lesotho	l ə z 'ɔ t o	 l ə z 'ɔ t i o 
leu	l 'ɛ w	 l 'ə w 
líber	l 'i β ə	 l 'i β e  
líder	l 'i ð ə	 l 'i ð e  
linear	l i n e 'a	 l i n 'ə 'a 
liquidàmbar	l i k i ð 'a m b ə	 l i k i ð 'a m b 'a 
lisosoma	l i z o z 'ɔ m ə	 l 'i z o z 'o m ə 
lisosòmic	l i z o z 'ɔ m i k	 l 'i z o z 'ɔ m i k 
lisosòmica	l i z o z 'ɔ m i k ə	 l 'i z o z 'ɔ m i k ə 
lisosòmics	l i z o z 'ɔ m i t s	 l 'i z o z 'ɔ m i t s 
lisosòmiques	l i z o z 'ɔ m i k ə s	 l 'i z o z 'ɔ m i k ə s 
llagosta	ʎ ə ɣ 'o s t ə	 ʎ ə ɣ 'ɔ s t ə 
llançament	ʎ ə n s ə m 'e n t	 ʎ 'a n s ə m 'e n t 
llarg	ʎ 'a ɾ k	 ʎ 'a ɾ ə 
llauna	ʎ 'a w n ə	 ʎ 'a 'u n ə 
llaüt	ʎ ə 'u t	 ʎ 'a 'u t 
llebre	ʎ 'e β ɾ ə	 ʎ 'ə β ɾ ə 
llega	ʎ 'e ɣ ə	 ʎ 'ə ɣ ə 
llegenda	ʎ ə ʒ 'e n d ə	 ʎ ə ʒ 'ɛ n d ə 
llegendes	ʎ ə ʒ 'e n d ə s	 ʎ ə ʒ 'ə n d ə s 
Lleida	ʎ 'e j ð ə	 ʎ 'ə j ð ə 
lleixa	ʎ 'e ʃ ə	 ʎ 'ə ʃ ə 
Llemosí	ʎ ə m o z 'i	 ʎ 'ə m o z 'i 
llenços	ʎ 'e n s o s	 ʎ 'ɛ n s o s 
llenya	ʎ 'e ɲ ə	 ʎ 'ə ɲ ə 
llepa	ʎ 'e p ə	 ʎ 'ə p ə 
llepen	ʎ 'e p ə n	 ʎ 'ə p ə n 
llépol	ʎ 'e p o l	 ʎ 'e p 'ɔ l 
llesta	ʎ 'e s t ə	 ʎ 'ə s t ə 
llestes	ʎ 'e s t ə s	 ʎ 'ə s t ə s 
llestos	ʎ 'e s t o s	 ʎ 'ə s t o s 
lletges	ʎ 'e d ʒ ə s	 ʎ 'ə d ʒ ə s 
lletja	ʎ 'e d ʒ ə	 ʎ 'ə d ʒ ə 
lletjos	ʎ 'e d ʒ o s	 ʎ 'ə d ʒ o s 
lletrejada	ʎ ə t ɾ ə ʒ 'a ð ə	 ʎ 'ə t ɾ ə ʒ 'a ð ə 
lletrejades	ʎ ə t ɾ ə ʒ 'a ð ə s	 ʎ 'ə t ɾ ə ʒ 'a ð ə s 
lletrejar	ʎ ə t ɾ ə ʒ 'a	 ʎ 'ə t ɾ ə ʒ 'a 
lletrejat	ʎ ə t ɾ ə ʒ 'a t	 ʎ 'ə t ɾ ə ʒ 'a t 
lletrejats	ʎ ə t ɾ ə ʒ 'a t s	 ʎ 'ə t ɾ ə ʒ 'a t s 
lleva	ʎ 'e v ə	 ʎ 'ə v ə 
lleves	ʎ 'e v ə s	 ʎ 'ə v ə s 
llevo	ʎ 'e v o	 ʎ 'ə v o 
llicenciatura	ʎ i s ə n s i ə t 'u ɾ ə	 ʎ i s ə n s 'i ə t 'u ɾ ə 
lligament	ʎ i ɣ ə m 'e n t	 ʎ 'i ɣ ə m 'e n t 
lliurament	ʎ i w ɾ ə m 'e n t	 ʎ 'i w ɾ ə m 'e n t 
lloa	ʎ 'o ə	 ʎ 'ɔ ə 
lloat	ʎ o 'a t	 ʎ 'ɔ 'a t 
lloba	ʎ 'o β ə	 ʎ 'ɔ β ə 
Llorach	ʎ o ɾ 'a k	 ʎ o ɾ 'a k ə 
lluïment	ʎ u i m 'e n t	 ʎ 'u i m 'e n t 
lluïssor	ʎ u i s 'o	 ʎ u 'i s 'o 
lluitada	ʎ u j t 'a ð ə	 ʎ u i t 'a ð ə 
lluitades	ʎ u j t 'a ð ə s	 ʎ u i t 'a ð ə s 
lluitant	ʎ u j t 'a n t	 ʎ u i t 'a n t 
lluitar	ʎ u j t 'a	 ʎ u i t 'a 
Londres	l 'o n d ɾ ə s	 l 'ɔ n d ɾ ə s 
luminescència	l u m i n ə t s 'ɛ n s i ə	 l u m 'i n ə t s 'ɛ n s i ə 
ma	m 'ə	 m ə 
macedoni	m ə s ə ð 'ɔ n i	 m ə s ə ð 'o n i 
maduixer	m ə ð u ʃ 'e	 m ə ð 'u ʃ 'e 
Mahoma	m ə 'ɔ m ə	 m ə m m ə 
mainada	m ə j n 'a ð ə	 m ə i n 'a ð ə 
majestuosa	m ə ʒ ə s t u 'o z ə	 m ə ʒ ə s t u 'o s ə 
Malawi	m ə l 'a β i	 m ə l 'a i 
maleïts	m ə l ə 'i t s	 m ə l ə 'i s 
malestar	m ə l ə s t 'a	 m 'a l ə s t 'a 
maliciosa	m ə l i s i 'o z ə	 m ə l i s i 'o s ə 
malicioses	m ə l i s i 'o z ə s	 m ə l i s i 'o s ə s 
maliciosos	m ə l i s i 'o z o s	 m ə l i s i 'o s o s 
mallerenga	m ə ʎ ə ɾ 'ə ŋ g ə	  m e ʎ ə ɾ 'ə ŋ g ə 
malvendre	m ə l v 'e n d ɾ ə	 m ə l v 'ə n d ɾ ə 
manament	m ə n ə m 'e n t	 m 'a n ə m 'e n t 
manifest	m ə n i f 'e s t	 m ə n i f 'ə s t 
manlleuta	m ə n ʎ 'ɛ w t ə	 m ə n ʎ 'ə 'u t ə 
manteniment	m ə n t ə n i m 'e n t	 m ə n t 'ɛ n i m 'e n t 
mantinguda	m ə n t i ŋ g 'u ð ə	 m ə n t 'i ŋ g 'u ð ə 
mantingudes	m ə n t i ŋ g 'u ð ə s	 m ə n t 'i ŋ g 'u ð ə s 
mantingueu	m ə n t i ŋ g 'ɛ w	 m ə n t i ŋ g 'ə w 
mantingut	m ə n t i ŋ g 'u t	 m ə n t 'i ŋ g 'u t 
mantinguts	m ə n t i ŋ g 'u t s	 m ə n t 'i ŋ g 'u t s 
Manuel	m ə n u 'ɛ l	 m ə n 'u 'ɛ l 
manxiula	m ə n ʃ 'i w l ə	 m ə n ʃ 'i u l ə 
maresmenc	m ə ɾ ə z m 'ə ŋ k	 m 'a ɾ ə z m 'ə ŋ k 
marianista	m ə ɾ i ə n 'i s t ə	 m ə ɾ 'i ə n 'i s t ə 
màrqueting	m 'a ɾ k ə t i ŋ k	 m 'a ɾ k ə t 'i ŋ k 
màser	m 'a z ə	 m 'a z e  
mastegaparaules	m ə s t ə ɣ ə p ə ɾ 'a w l ə s	 m ə s t ə ɣ ə p ə ɾ 'a 'u l ə s 
materialisme	m ə t ə ɾ i ə l 'i z m ə	 m ə t ə ɾ 'i ə l 'i z m ə 
Mateu	m ə t 'e w	 m ə t 'ɛ w 
matusser	m ə t u s 'e	 m ə t 'u s 'e 
mausoleu	m ə w z o l 'ɛ w	 m ə w z o l 'ə w 
me	m 'ə	 m ə 
medicament	m ə ð i k ə m 'e n t	 m ə ð 'i k ə m 'e n t 
meitat	m ə j t 'a t	 m ə i t 'a t 
melanesi	m ə l ə n 'ɛ z i	 m ə l ə n 'ə z i 
membre	m 'e m b ɾ ə	 m 'ə m b ɾ ə 
membres	m 'e m b ɾ ə s	 m 'ə m b ɾ ə s 
mencionis	m ə n s i 'ɔ n i s	 m ə n s i 'o n i s 
mengen	m 'e n ʒ ə n	 m 'ɛ n ʒ ə n 
menges	m 'e n ʒ ə s	 m 'ɛ n ʒ ə s 
menja	m 'e n ʒ ə	 m 'ə n ʒ ə 
menjo	m 'e n ʒ o	 m 'ɛ n ʒ o 
mènsula	m 'ɛ n s u l ə	 m 'ə n s u l ə 
mènsules	m 'ɛ n s u l ə s	 m 'ə n s u l ə s 
mesurament	m ə z u ɾ ə m 'e n t	 m ə z 'u ɾ ə m 'e n t 
metastatitzada	m ə t ə s t ə t i d z 'a ð ə	 m 'ə t ə s t ə t i d z 'a ð ə 
metastatitzades	m ə t ə s t ə t i d z 'a ð ə s	 m 'ə t ə s t ə t i d z 'a ð ə s 
metastatitzar	m ə t ə s t ə t i d z 'a	 m 'ə t ə s t ə t i d z 'a 
metastatitzat	m ə t ə s t ə t i d z 'a t	 m 'ə t ə s t ə t i d z 'a t 
metastatitzats	m ə t ə s t ə t i d z 'a t s	 m 'ə t ə s t ə t i d z 'a t s 
metge	m 'e d ʒ ə	 m 'ə d ʒ ə 
metges	m 'e d ʒ ə s	 m 'ə d ʒ ə s 
metxa	m 'e t ʃ ə	 m 'ɛ t ʃ ə 
meua	m 'e w ə	 m 'ə w ə 
meuca	m 'ɛ w k ə	 m 'ə 'u k ə 
meus	m 'e w s	 m 'ə w s 
meva	m 'e v ə	 m 'ə v ə 
meves	m 'e v ə s	 m 'ə v ə s 
migcampista	m i k k ə m p 'i s t ə	 m i ŋ k ə m p 'i s t ə 
millorament	m i ʎ o ɾ ə m 'e n t	 m i ʎ 'ɔ ɾ ə m 'e n t 
miniatura	m i n i ə t 'u ɾ ə	 m i n 'i ə t 'u ɾ ə 
miniaturització	m i n i ə t u ɾ i d z ə s i 'o	 m i n 'i ə t u ɾ i d z ə s i 'o 
miositis	m i o z 'i t i s	 m i o s 'i t i s 
mirament	m i ɾ ə m 'e n t	 m 'i ɾ ə m 'e n t 
misàndria	m i z 'a n d ɾ i ə	 m i z 'a n d ɾ 'i ə 
missatger	m i s ə d ʒ 'e	 m i s 'a d ʒ 'e 
moc	m 'o k	 m 'ɔ k 
Moisès	m o j z 'ə s	 m o i s 'ə s 
molècula	m o l 'ə k u l ə	 m o l 'ɛ k u l ə 
molsa	m 'o l s ə	 m 'ɔ l s ə 
molsuda	m o l s 'u ð ə	 m 'ɔ l s 'u ð ə 
molsudes	m o l s 'u ð ə s	 m 'ɔ l s 'u ð ə s 
molsut	m o l s 'u t	 m 'ɔ l s 'u t 
molsuts	m o l s 'u t s	 m 'ɔ l s 'u t s 
molts	m 'o l s	 m 'o l t s 
moment	m o m 'e n t	 m 'ɔ m 'e n t 
monarquia	m o n ə ɾ k 'i ə	 m o n 'a ɾ k 'i ə 
monàrquica	m o n 'a ɾ k i k ə	 m o n 'a ɾ k 'i k ə 
monàrquics	m o n 'a ɾ k i t s	 m o n 'a ɾ k 'i t s 
monocroma	m o n o k ɾ 'ɔ m ə	 m o n o k ɾ 'o m ə 
monocromes	m o n o k ɾ 'ɔ m ə s	 m o n o k ɾ 'o m ə s 
montrealès	m o n t ɾ e ə l 'ə s	 m o n t ɾ ə ə l 'ə s 
Montse	m 'o n s ə	 m 'ɔ n t s ə 
Montseny	m o n s 'ə ɲ	 m 'o n t s 'ə ɲ 
Montserrat	m o n s ə r 'a t	 m 'o n t s ə r 'a t 
monument	m o n u m 'e n t	 m 'ɔ n u m 'e n t 
monyeca	m o ɲ 'ɛ k ə	 m o ɲ 'ə k ə 
morro	m 'o r o	 m 'ɔ r o 
morros	m 'o r o s	 m 'ɔ r o s 
morruda	m o r 'u ð ə	 m 'o r 'u ð ə 
morrudes	m o r 'u ð ə s	 m 'o r 'u ð ə s 
morrut	m o r 'u t	 m 'o r 'u t 
morruts	m o r 'u t s	 m 'o r 'u t s 
mort	m 'ɔ ɾ t	 m 'o ɾ t 
mosca	m 'o s k ə	 m 'ɔ s k ə 
mosques	m 'o s k ə s	 m 'ɔ s k ə s 
mossegaire	m o s ə ɣ 'a j ɾ ə	 m o s ə ɣ 'a 'i ɾ ə 
mosso	m 'o s o	 m 'ɔ s o 
mostatxut	m o s t ə t ʃ 'u t	 m o s t 'a t ʃ 'u t 
mot	m 'o t	 m 'ɔ t 
motlura	m o ʎ ʎ 'u ɾ ə	 m 'ɔ l l 'u ɾ ə 
moto	m 'o t o	 m 'ɔ t o 
motos	m 'o t o s	 m 'ɔ t o s 
moviment	m o v i m 'e n t	 m 'ɔ v i m 'e n t 
mudèjar	m u ð 'ə ʒ ə	 m u ð 'ɛ ʒ 'a 
muntanyisme	m u n t ə ɲ 'i z m ə	 m u n t 'a ɲ 'i z m ə 
múrgola	m 'u ɾ ɣ o l ə	 m 'u ɾ ɣ 'ɔ l ə 
naftalè	n ə f t ə l 'ə	 n ə f t 'a l 'ə 
naixement	n ə ʃ ə m 'e n t	 n 'a ʃ ə m 'e n t 
natzarè	n ə d z ə ɾ 'ə	 n ə d z 'a ɾ 'ə 
nàufrag	n 'a w f ɾ ə k	 n 'a w f ɾ 'a ɣ 
nauseabund	n ə w z e ə β 'u n t	 n ə w z ə ə β 'u n d 
nauseabunda	n ə w z e ə β 'u n d ə	 n ə w z ə ə β 'u n d ə 
nauseabundes	n ə w z e ə β 'u n d ə s	 n ə w z ə ə β 'u n d ə s 
nauseabunds	n ə w z e ə β 'u n s	 n ə w z ə ə β 'u n s 
nàxer	n 'a t s ə	 n 'a ə 
neboda	n ə β 'o ð ə	 n ə β 'ɔ ð ə 
nebot	n ə β 'o t	 n ə β 'ɔ t 
nebulositat	n ə β u l o z i t 'a t	 n ə β 'u l o z i t 'a t 
neda	n 'e ð ə	 n 'ə ð ə 
neden	n 'e ð ə n	 n 'ə ð ə n 
nedes	n 'e ð ə s	 n 'ə ð ə s 
nega	n 'e ɣ ə	 n 'ə ɣ ə 
neguen	n 'e ɣ ə n	 n 'ə ɣ ə n 
negues	n 'e ɣ ə s	 n 'ə ɣ ə s 
néixer	n 'e ʃ ə	 n 'e ʃ 'e  
Nèmesi	n 'ɛ m ə z i	 n 'ə m ə z i 
nens	n 'ə n s	 n 'e n s 
neva	n 'e v ə	 n 'ə v ə 
nicens	n i s 'ə n s	 n i s 'e n s 
nihilisme	n i i l 'i z m ə	 n i 'a l 'i z m ə 
nimfea	n i m f 'ɛ ə	 n i m f 'e ə 
nodriment	n o ð ɾ i m 'e n t	 n 'ɔ ð ɾ i m 'e n t 
noieta	n o j 'ə t ə	 n o i 'ə t ə 
nombre	n 'o m b ɾ ə	 n 'ɔ m b ɾ ə 
nombres	n 'o m b ɾ ə s	 n 'ɔ m b ɾ ə s 
Nombres	n 'o m b ɾ ə s	 n 'ɔ m b ɾ ə s 
nomenament	n o m ə n ə m 'e n t	 n o m 'ə n ə m 'e n t 
nores	n 'ɔ ɾ ə s	 n 'o ɾ ə s 
noruec	n o ɾ u 'ɛ k	 n o ɾ 'u 'ɛ k 
noucentisme	n o w s ə n t 'i z m ə	 n o u s ə n t 'i z m ə 
nouguerola	n o w ɣ ə ɾ 'ɔ l ə	 n o u ɣ ə ɾ 'ɔ l ə 
novembre	n o v 'e m b ɾ ə	 n o v 'ə m b ɾ ə 
noya	n 'ɔ j ə	 n 'ɔ ə 
o	'ɔ	 'o 
oasi	o 'a z i	 o 'a s i 
obeïts	o β ə 'i t s	 o β ə 'i s 
obstacle	o p s t 'a k l ə	 o t s t 'a k l ə 
obstinació	o p s t i n ə s i 'o	 o t s t i n ə s i 'o 
obstruïda	o p s t ɾ u 'i ð ə	 o t s t ɾ u 'i ð ə 
obstruïdes	o p s t ɾ u 'i ð ə s	 o t s t ɾ u 'i ð ə s 
obtinguda	o t t i ŋ g 'u ð ə	 o t t 'i ŋ g 'u ð ə 
obtingudes	o t t i ŋ g 'u ð ə s	 o t t 'i ŋ g 'u ð ə s 
obtingut	o t t i ŋ g 'u t	 o t t 'i ŋ g 'u t 
obtinguts	o t t i ŋ g 'u t s	 o t t 'i ŋ g 'u t s 
odissea	o ð i s 'ɛ ə	 o ð i s 'e ə 
ofegament	o f ə ɣ ə m 'e n t	 o f 'ə ɣ ə m 'e n t 
ofegues	o f 'ə ɣ ə s	 o f 'ɛ ɣ ə s 
oferiment	o f ə ɾ i m 'e n t	 o f 'ɛ ɾ i m 'e n t 
oganessó	o ɣ ə n ə s 'o	 o ɣ 'a n ə s 'o 
oidà	o j ð 'a	 o i ð 'a 
oligarquia	o l i ɣ ə ɾ k 'i ə	 o l i ɣ 'a ɾ k 'i ə 
oligàrquica	o l i ɣ 'a ɾ k i k ə	 o l i ɣ 'a ɾ k 'i k ə 
oligàrquics	o l i ɣ 'a ɾ k i t s	 o l i ɣ 'a ɾ k 'i t s 
oligarquies	o l i ɣ ə ɾ k 'i ə s	 o l i ɣ 'a ɾ k 'i ə s 
oligosacàrid	o l i ɣ o z ə k 'a ɾ i t	 o l 'i ɣ o z ə k 'a ɾ i t 
oligosacàrids	o l i ɣ o z ə k 'a ɾ i t s	 o l 'i ɣ o z ə k 'a ɾ i t s 
ombra	'o m b ɾ ə	 'ɔ m b ɾ ə 
ombres	'o m b ɾ ə s	 'ɔ m b ɾ ə s 
omple	'o m p l ə	 'ɔ m p l ə 
omplen	'o m p l ə n	 'ɔ m p l ə n 
omples	'o m p l ə s	 'ɔ m p l ə s 
omplo	'o m p l o	 'ɔ m p l o 
oncle	'o ŋ k l ə	 'ɔ ŋ k l ə 
oncles	'o ŋ k l ə s	 'ɔ ŋ k l ə s 
onzes	'o n z ə s	 'ɔ n z ə s 
opta	'o t t ə	 'ɔ t t ə 
opten	'o t t ə n	 'ɔ t t ə n 
opto	'o t t o	 'ɔ t t o 
orca	'o ɾ k ə	 'ɔ ɾ k ə 
orde	'o ɾ ð ə	 'ɔ ɾ ð ə 
ordenament	o ɾ ð ə n ə m 'e n t	 o ɾ ð 'ə n ə m 'e n t 
ordes	'o ɾ ð ə s	 'ɔ ɾ ð ə s 
ordre	'o ɾ ð ɾ ə	 'ɔ ɾ ð ɾ ə 
ordres	'o ɾ ð ɾ ə s	 'ɔ ɾ ð ɾ ə s 
orella	o ɾ 'ə ʎ ə	 o ɾ 'e ʎ ə 
organolèptic	o ɾ ɣ ə n o l 'ə t t i k	 o ɾ ɣ ə n o l 'ɛ t t i k 
ornament	o ɾ n ə m 'e n t	 'ɔ ɾ n ə m 'e n t 
orques	'o ɾ k ə s	 'ɔ ɾ k ə s 
ortodoxa	o ɾ t o ð 'o t s ə	 o ɾ t o ð 'ɔ t s ə 
òstria	'ɔ s t ɾ i ə	 'ɔ s t ɾ 'i ə 
ou	'ɔ w	 'o 
ovella	o v 'ə ʎ ə	 o v 'e ʎ ə 
ovelles	o v 'ə ʎ ə s	 o v 'e ʎ ə s 
pagesia	p ə ʒ ə z 'i ə	 p 'a ʒ ə z 'i ə 
pagesívol	p ə ʒ ə z 'i v o l	 p 'a ʒ ə z 'i v o l 
pairal	p ə j ɾ 'a l	 p ə i ɾ 'a l 
paisatge	p ə j z 'a d ʒ ə	 p ə i z 'a d ʒ ə 
Pakistan	p ə k i s t 'a n	 p ə z i s t 'a n 
pakistanès	p ə k i s t ə n 'ə s	 p ə z i s t ə n 'ə s 
pakistanesa	p ə k i s t ə n 'ə z ə	 p ə z i s t ə n 'ə z ə 
pakistaneses	p ə k i s t ə n 'ə z ə s	 p ə z i s t ə n 'ə z ə s 
pakistanesos	p ə k i s t ə n 'ə z o s	 p ə z i s t ə n 'ə z o s 
palestí	p ə l ə s t 'i	 p 'a l ə s t 'i 
Palestina	p ə l ə s t 'i n ə	 p 'a l ə s t 'i n ə 
palestinenc	p ə l ə s t i n 'ə ŋ k	 p 'a l ə s t i n 'ə ŋ k 
pandèmies	p ə n d 'ɛ m i ə s	 p ə n d 'ə m i ə s 
pandemoni	p ə n d ə m 'ɔ n i	 p ə n d ə m 'o n i 
papagai	p ə p ə ɣ 'a j	 p ə p ə ɣ 'a i 
paracaigudes	p ə ɾ ə k ə j ɣ 'u ð ə s	 p ə ɾ ə k 'a j ɣ 'u ð ə s 
paracaigudisme	p ə ɾ ə k ə j ɣ u ð 'i z m ə	 p ə ɾ ə k ə j ɣ 'u ð 'i z m ə 
paracaigudista	p ə ɾ ə k ə j ɣ u ð 'i s t ə	 p ə ɾ ə k ə j ɣ 'u ð 'i s t ə 
paradisíac	p ə ɾ ə ð i z 'i ə k	 p ə ɾ 'a ð i z 'i ə k 
paradoxal	p ə ɾ ə ð o t s 'a l	 p ə ɾ 'a ð o t s 'a l 
paranoic	p ə ɾ ə n 'ɔ j k	 p ə ɾ ə n 'o 'i k 
paraula	p ə ɾ 'a w l ə	 p ə ɾ 'a 'u l ə 
parell	p ə ɾ 'ə ʎ	 p ə ɾ 'e ʎ 
parella	p ə ɾ 'ə ʎ ə	 p ə ɾ 'e ʎ ə 
parèmies	p ə ɾ 'ɛ m i ə s	 p ə ɾ 'ə m i ə s 
parènquima	p ə ɾ 'ə ŋ k i m ə	 p ə ɾ 'ə ŋ k 'i m ə 
parentela	p ə ɾ ə n t 'ɛ l ə	 p ə ɾ ə n t 'ə l ə 
parèntesi	p ə ɾ 'ɛ n t ə z i	 p ə ɾ 'ə n t ə z i 
parer	p ə ɾ 'ə	 p ə ɾ 'e 
parlament	p ə ɾ l ə m 'e n t	 p 'a ɾ l ə m 'e n t 
parlessin	p ə ɾ l 'e s i n	 p ə ɾ l 'ə s i n 
parleu	p ə ɾ l 'ɛ w	 p ə ɾ l 'ə w 
pàrquing	p 'a ɾ k i ŋ k	 p 'a ɾ k 'i ŋ k 
pasqüeta	p ə s k w 'ə t ə	 p 'a z ə w 'ə t ə 
passaforadí	p ə s ə f o ɾ ə ð 'i	 p ə s ə f o ɾ 'a ð 'i 
passaport	p ə s ə p 'ɔ ɾ t	 p ə s ə p 'o ɾ t 
passaports	p ə s ə p 'ɔ ɾ s	 p ə s ə p 'o ɾ t s 
passatger	p ə s ə d ʒ 'e	 p ə s 'a d ʒ 'e 
patatxap	p ə t ə t ʃ 'a p	 p ə t 'a t ʃ 'a p 
patiment	p ə t i m 'e n t	 p 'a t i m 'e n t 
patrimoni	p ə t ɾ i m 'ɔ n i	 p ə t ɾ i m 'o n i 
patuès	p ə t u 'ə s	 p ə t 'u 'ə s 
pauta	p 'a w t ə	 p 'a 'u t ə 
paviment	p ə v i m 'e n t	 p 'a v i m 'e n t 
peatge	p e 'a d ʒ ə	 p ə 'a d ʒ ə 
pedra	p 'e ð ɾ ə	 p 'ə ð ɾ ə 
pedres	p 'e ð ɾ ə s	 p 'ə ð ɾ ə s 
pego	p 'e ɣ o	 p 'ə ɣ o 
peguen	p 'e ɣ ə n	 p 'ə ɣ ə n 
péixer	p 'e ʃ ə	 p 'e ʃ 'e  
peixos	p 'e ʃ o s	 p 'ɛ ʃ o s 
pèl	p 'ə l	 p 'ɛ l 
pèlag	p 'ɛ l ə k	 p 'ə l ə k 
pendeloc	p ə n d ə l 'o k	 p ə n d ə l 'ɔ k 
penediment	p ə n ə ð i m 'e n t	 p ə n 'ɛ ð i m 'e n t 
penetra	p ə n 'e t ɾ ə	 p ə n 'ə t ɾ ə 
pengen	p 'e n ʒ ə n	 p 'ɛ n ʒ ə n 
penges	p 'e n ʒ ə s	 p 'ɛ n ʒ ə s 
penja	p 'e n ʒ ə	 p 'ə n ʒ ə 
penombra	p ə n 'o m b ɾ ə	 p ə n 'ɔ m b ɾ ə 
pens	p 'ə n s	 p 'e n s 
pensament	p ə n s ə m 'e n t	 p 'ə n s ə m 'e n t 
pentatleta	p ə n t ə l l 'ə t ə	 p ə n t 'a l l 'ə t ə 
pequen	p 'e k ə n	 p 'ɛ k ə n 
pèr	p 'ɛ	 p 'ə 
pera	p 'ə ɾ ə	 p 'e ɾ ə 
Pere	p 'e ɾ ə	 p 'ɛ ɾ ə 
perenne	p ə ɾ 'e n n ə	 p ə ɾ 'ə n n ə 
peres	p 'ə ɾ ə s	 p 'e ɾ ə s 
perfeccionament	p ə ɾ f ə t s i o n ə m 'e n t	 p ə ɾ f ə t s i 'ɔ n ə m 'e n t 
Perigús	p ə ɾ i ɣ 'u s	 p ə ɾ 'i ɣ 'u s 
peritoneals	p ə ɾ i t o n e 'a l s	 p ə ɾ i t o n 'e 'a l s 
peritoneus	p ə ɾ i t o n 'ɛ w s	 p ə ɾ i t o n 'ə 'u s 
perpetu	p ə ɾ p 'ɛ t u	 p ə ɾ p 'ə t u 
perruquer	p ə r u k 'e	 p ə r 'u k 'e 
persignada	p ə ɾ s i n n 'a ð ə	 p ə ɾ s i ə n 'a ð ə 
persignades	p ə ɾ s i n n 'a ð ə s	 p ə ɾ s i ə n 'a ð ə s 
persuasiu	p ə ɾ s u ə z 'i w	 p ə ɾ s u ə s 'i w 
pertanguda	p ə ɾ t ə ŋ g 'u ð ə	 p ə ɾ t 'a ŋ g 'u ð ə 
pertangudes	p ə ɾ t ə ŋ g 'u ð ə s	 p ə ɾ t 'a ŋ g 'u ð ə s 
pertangut	p ə ɾ t ə ŋ g 'u t	 p ə ɾ t 'a ŋ g 'u t 
pertanguts	p ə ɾ t ə ŋ g 'u t s	 p ə ɾ t 'a ŋ g 'u t s 
pertànyer	p ə ɾ t 'a ɲ ə	 p ə ɾ t 'a ɲ e  
pesa	p 'e z ə	 p 'ə z ə 
pesen	p 'e z ə n	 p 'ə z ə n 
peses	p 'e z ə s	 p 'ə z ə s 
pessebre	p ə s 'e β ɾ ə	 p ə s 'ə β ɾ ə 
petges	p 'e d ʒ ə s	 p 'ə d ʒ ə s 
peti	p 'ɛ t i	 p 'ə t i 
petis	p 'ɛ t i s	 p 'ə t i s 
petja	p 'e d ʒ ə	 p 'ə d ʒ ə 
peüc	p ə 'u k	 p 'ə 'u k 
pigarg	p i ɣ 'a ɾ k	 p i ɣ 'a ɾ ə 
pigment	p i m m 'e n t	 p 'i ə m 'e n t 
pintura	p i n t 'u ɾ ə	 p 'i n t 'u ɾ ə 
Pitiüses	p i t i 'u z ə s	 p 'i t i 'u s ə s 
pixaví	p i ʃ ə v 'i	 p i ʃ 'a v 'i 
plaer	p l ə 'ə	 p l 'a 'e 
plàncton	p l 'a ŋ t t o n	 p l 'a n t t 'o n 
plantejament	p l ə n t ə ʒ ə m 'e n t	 p l ə n t 'ɛ ʒ ə m 'e n t 
plànyer	p l 'a ɲ ə	 p l 'a ɲ e  
plens	p l 'ə n s	 p l 'e n s 
plomo	p l 'o m o	 p l 'ɔ m o 
plores	p l 'ɔ ɾ ə s	 p l 'o ɾ ə s 
ploriquejar	p l o ɾ i k ə ʒ 'a	 p l o ɾ 'i k ə ʒ 'a 
pneumàtic	n ə w m 'a t i k	 p n ə w m 'a t i k 
pneumàtica	n ə w m 'a t i k ə	 p n ə w m 'a t i k ə 
pneumàtics	n ə w m 'a t i t s	 p n ə w m 'a t i t s 
pneumònia	n ə w m 'ɔ n i ə	 p n ə w m 'ɔ n i ə 
poesia	p o ə z 'i ə	 p o ə s 'i ə 
polinesi	p o l i n 'ɛ z i	 p o l i n 'ə z i 
polipèptid	p o l i p 'ə t t i t	 p o l i p 'ɛ t t i t 
polisacàrid	p o l i z ə k 'a ɾ i t	 p 'ɔ l i z ə k 'a ɾ i t 
polisacàrids	p o l i z ə k 'a ɾ i t s	 p 'ɔ l i z ə k 'a ɾ i t s 
polissó	p o l i s 'o	 p 'ɔ l i s 'o 
politeisme	p o l i t ə 'i z m ə	 p o l 'i t ə 'i z m ə 
politeista	p o l i t ə 'i s t ə	 p o l 'i t ə 'i s t ə 
politoxicòman	p o l i t o t s i k 'ɔ m ə n	 p o l 'i t o t s i k 'ɔ m ə n 
polla	p 'o ʎ ə	 p 'ɔ ʎ ə 
poloni	p o l 'ɔ n i	 p o l 'o n i 
polpa	p 'o l p ə	 p 'ɔ l p ə 
poltre	p 'o l t ɾ ə	 p 'ɔ l t ɾ ə 
polze	p 'o l z ə	 p 'ɔ l z ə 
Pompeu	p o m p 'ɛ w	 p o m p 'ə w 
porpra	p 'o ɾ p ɾ ə	 p 'ɔ ɾ p ɾ ə 
porro	p 'o r o	 p 'ɔ r o 
porros	p 'o r o s	 p 'ɔ r o s 
port	p 'ɔ ɾ t	 p 'o ɾ t 
posseïts	p o s ə 'i t s	 p o s ə 'i s 
precepte	p ɾ ə s 'ɛ t t ə	 p ɾ ə s 'ə t t ə 
precursor	p ɾ ə k u ɾ s 'o	 p ɾ ə k 'u s 'o 
precursora	p ɾ ə k u ɾ s 'o ɾ ə	 p ɾ ə k 'u s 'o ɾ ə 
precursores	p ɾ ə k u ɾ s 'o ɾ ə s	 p ɾ ə k 'u s 'o ɾ ə s 
predictible	p ɾ ə ð i t t 'i b b l ə	 p ɾ ə ð 'i t t 'i b b l ə 
prega	p ɾ 'e ɣ ə	 p ɾ 'ə ɣ ə 
pregestacionals	p ɾ ə ʒ ə s t ə s i o n 'a l s	 p ɾ 'ə ʒ ə s t ə s i o n 'a l s 
prego	p ɾ 'e ɣ o	 p ɾ 'ə ɣ o 
preguntada	p ɾ ə ɣ u n t 'a ð ə	 p ɾ ə ɣ 'u n t 'a ð ə 
preguntades	p ɾ ə ɣ u n t 'a ð ə s	 p ɾ ə ɣ 'u n t 'a ð ə s 
preguntar	p ɾ ə ɣ u n t 'a	 p ɾ ə ɣ 'u n t 'a 
preguntat	p ɾ ə ɣ u n t 'a t	 p ɾ ə ɣ 'u n t 'a t 
preguntats	p ɾ ə ɣ u n t 'a t s	 p ɾ ə ɣ 'u n t 'a t s 
preguntéssiu	p ɾ ə ɣ u n t 'e s i w	 p ɾ ə ɣ 'u n t 'e s i w 
pregunteta	p ɾ ə ɣ u n t 'ə t ə	 p ɾ ə ɣ 'u n t 'ə t ə 
prémer	p ɾ 'e m ə	 p ɾ 'e m 'e  
premi	p ɾ 'ɛ m i	 p ɾ 'ə m i 
premiaria	p ɾ ə m i ə ɾ 'i ə	 p ɾ ə m 'i ə ɾ 'i ə 
premsa	p ɾ 'e n s ə	 p ɾ 'ə m z ə 
prens	p ɾ 'ə n s	 p ɾ 'e n s 
pressentiment	p ɾ ə s ə n t i m 'e n t	 p ɾ ə s 'ɛ n t i m 'e n t 
presta	p ɾ 'e s t ə	 p ɾ 'ə s t ə 
prestatgeria	p ɾ ə s t ə d ʒ ə ɾ 'i ə	 p ɾ ə s t 'a d ʒ ə ɾ 'i ə 
presten	p ɾ 'e s t ə n	 p ɾ 'ə s t ə n 
prestes	p ɾ 'e s t ə s	 p ɾ 'ə s t ə s 
presto	p ɾ 'e s t o	 p ɾ 'ə s t o 
presumpció	p ɾ ə z u m s i 'o	 p ɾ ə z u m p s i 'o 
presumpta	p ɾ ə z 'u m t ə	 p ɾ ə z 'u m 'ə t ə 
presumptiu	p ɾ ə z u m t 'i w	 p ɾ ə z u m ə t 'i w 
pretendre	p ɾ ə t 'e n d ɾ ə	 p ɾ ə t 'ə n d ɾ ə 
preveure	p ɾ ə v 'ə w ɾ ə	 p ɾ ə v 'ə 'u ɾ ə 
previnguda	p ɾ ə v i ŋ g 'u ð ə	 p ɾ ə v 'i ŋ g 'u ð ə 
previngudes	p ɾ ə v i ŋ g 'u ð ə s	 p ɾ ə v 'i ŋ g 'u ð ə s 
previngut	p ɾ ə v i ŋ g 'u t	 p ɾ ə v 'i ŋ g 'u t 
previnguts	p ɾ ə v i ŋ g 'u t s	 p ɾ ə v 'i ŋ g 'u t s 
prínceps	p ɾ 'i n s ə t s	 p ɾ 'i n s 'ə t s 
prioratí	p ɾ i o ɾ ə t 'i	 p ɾ i o ɾ 'a t 'i 
proa	p ɾ 'o ə	 p ɾ 'ɔ ə 
problema	p ɾ o β l 'ɛ m ə	 p ɾ o β l 'ə m ə 
procediment	p ɾ o s ə ð i m 'e n t	 p ɾ o s 'ɛ ð i m 'e n t 
processament	p ɾ o s ə s ə m 'e n t	 p ɾ o s 'ə s ə m 'e n t 
profund	p ɾ o f 'u n t	 p ɾ o f 'u n d 
prohom	p ɾ o 'o m	 p ɾ o 'a m 
prolixa	p ɾ o l 'i ʃ ə	 p ɾ o l 'i t s ə 
prona	p ɾ 'ɔ n ə	 p ɾ 'o n ə 
prones	p ɾ 'ɔ n ə s	 p ɾ 'o n ə s 
protactini	p ɾ o t ə t t 'i n i	 p ɾ o t 'a t t 'i n i 
proteic	p ɾ o t 'ə j k	 p ɾ o t 'ə 'i k 
protesta	p ɾ o t 'e s t ə	 p ɾ o t 'ə s t ə 
proveïment	p ɾ o v ə i m 'e n t	 p ɾ o v 'ɛ i m 'e n t 
proveïts	p ɾ o v ə 'i t s	 p ɾ o v ə 'i s 
provinguda	p ɾ o v i ŋ g 'u ð ə	 p ɾ o v 'i ŋ g 'u ð ə 
provingudes	p ɾ o v i ŋ g 'u ð ə s	 p ɾ o v 'i ŋ g 'u ð ə s 
provingut	p ɾ o v i ŋ g 'u t	 p ɾ o v 'i ŋ g 'u t 
provinguts	p ɾ o v i ŋ g 'u t s	 p ɾ o v 'i ŋ g 'u t s 
psiquiatria	s i k i ə t ɾ 'i ə	 s i k i 'a t ɾ 'i ə 
pugnada	p u n n 'a ð ə	 p 'u ə n 'a ð ə 
pugnades	p u n n 'a ð ə s	 p 'u ə n 'a ð ə s 
pugnar	p u n n 'a	 p 'u ə n 'a 
púlsar	p 'u l s ə	 p 'u l s 'a 
punter	p u n t 'e	 p 'u n t 'e 
punxuda	p u n ʃ 'u ð ə	 p 'u n ʃ 'u ð ə 
punxudes	p u n ʃ 'u ð ə s	 p 'u n ʃ 'u ð ə s 
punxut	p u n ʃ 'u t	 p 'u n ʃ 'u t 
punxuts	p u n ʃ 'u t s	 p 'u n ʃ 'u t s 
putejar	p u t ə ʒ 'a	 p 'u t ə ʒ 'a 
qualssevol	k w ə l s ə v 'ɔ l	 k w 'a l s ə v 'ɔ l 
quaresmal	k w ə ɾ ə z m 'a l	 k w 'a ɾ ə z m 'a l 
quasianterior	k w ə z i ə n t ə ɾ i 'o	 k w ə z i 'a n t ə ɾ i 'o 
quasiposterior	k w ə z i p o s t ə ɾ i 'o	 k w ə z 'i p o s t ə ɾ i 'o 
queixa	k 'e ʃ ə	 k 'ɛ ʃ ə 
queixo	k 'e ʃ o	 k 'ɛ ʃ o 
quimioteràpia	k i m i o t ə ɾ 'a p i ə	 k i m 'i o t ə ɾ 'a p i ə 
Rafael	r ə f ə 'ɛ l	 r ə f 'a 'ɛ l 
raonament	r ə o n ə m 'e n t	 r ə 'ɔ n ə m 'e n t 
Raül	r ə 'u l	 r 'a 'u l 
re	r 'ə	 r ə 
reaparegut	r e ə p ə ɾ ə ɣ 'u t	 r ə ə p ə ɾ ə ɣ 'u t 
reapareguts	r e ə p ə ɾ ə ɣ 'u t s	 r ə ə p ə ɾ ə ɣ 'u t s 
reaparèixer	r e ə p ə ɾ 'ə ʃ ə	 r ə ə p ə ɾ 'ə ʃ ə 
rebi	r 'ɛ β i	 r 'ə β i 
rebuig	r ə β 'u t ʃ	 r ə β 'u ʃ 
reca	r 'e k ə	 r 'ə k ə 
recaiguda	r ə k ə j ɣ 'u ð ə	 r ə k 'a j ɣ 'u ð ə 
recaigudes	r ə k ə j ɣ 'u ð ə s	 r ə k 'a j ɣ 'u ð ə s 
recepta	r ə s 'ɛ t t ə	 r ə s 'ə t t ə 
reclutament	r ə k l u t ə m 'e n t	 r ə k l 'u t ə m 'e n t 
recobriment	r ə k o β ɾ i m 'e n t	 r ə k 'ɔ β ɾ i m 'e n t 
recolzament	r ə k o l z ə m 'e n t	 r ə k 'ɔ l z ə m 'e n t 
recomptada	r ə k o m t 'a ð ə	 r ə k o m ə t 'a ð ə 
recomptades	r ə k o m t 'a ð ə s	 r ə k o m ə t 'a ð ə s 
recomptat	r ə k o m t 'a t	 r ə k o m ə t 'a t 
recomptats	r ə k o m t 'a t s	 r ə k o m ə t 'a t s 
recompte	r ə k 'o m t ə	 r ə k 'ɔ m t ə 
reconeixement	r ə k o n ə ʃ ə m 'e n t	 r ə k o n 'ə ʃ ə m 'e n t 
rècord	r 'ə k o ɾ t	 r 'ɛ k o ɾ t 
recorre	r ə k 'o r ə	 r ə k 'ɔ r ə 
recreatiu	r ə k ɾ e ə t 'i w	 r ə k ɾ ə ə t 'i w 
redempció	r ə ð ə m s i 'o	 r ə ð ə m p s i 'o 
rees	r 'ɛ ə s	 r 'e ə s 
refet	r ə f 'e t	 r ə f 'ə t 
refeta	r ə f 'e t ə	 r ə f 'ə t ə 
reforma	r ə f 'o ɾ m ə	 r ə f 'ɔ ɾ m ə 
refredament	r ə f ɾ ə ð ə m 'e n t	 r ə f ɾ 'ə ð ə m 'e n t 
reg	r 'ɛ k	 r 'ə ʒ 
règies	r 'ə ʒ i ə s	 r 'ɛ ʒ i ə s 
règim	r 'ə ʒ i m	 r 'ɛ ʒ i m 
regiment	r ə ʒ i m 'e n t	 r 'ɛ ʒ i m 'e n t 
regla	r 'e g g l ə	 r 'ə ɣ l ə 
regles	r 'e g g l ə s	 r 'ə ɣ l ə s 
regna	r 'e n n ə	 r 'ə n n ə 
regne	r 'e n n ə	 r 'ə n n ə 
regnen	r 'e n n ə n	 r 'ə n n ə n 
regnes	r 'e n n ə s	 r 'ə n n ə s 
regulà	r ə ɣ u l 'a	 r ə ɣ 'u l 'a 
reialme	r ə j 'a l m ə	 r ə i 'a l m ə 
reiet	r ə j 'ə t	 r ə 'i 'ə t 
reietó	r ə j ə t 'o	 r ə i ə t 'o 
reintegració	r ə i n t ə ɣ ɾ ə s i 'o	 r ə 'i n t ə ɣ ɾ ə s i 'o 
reinterpretació	r ə i n t ə ɾ p ɾ ə t ə s i 'o	 r ə 'i n t ə ɾ p ɾ ə t ə s i 'o 
reixa	r 'e ʃ ə	 r 'ə ʃ ə 
rella	r 'ə ʎ ə	 r 'e ʎ ə 
relles	r 'ə ʎ ə s	 r 'e ʎ ə s 
relleu	r ə ʎ 'e w	 r ə ʎ 'ə w 
remo	r 'e m o	 r 'ə m o 
remordiment	r ə m o ɾ ð i m 'e n t	 r ə m 'ɔ ɾ ð i m 'e n t 
renaixement	r ə n ə ʃ ə m 'e n t	 r ə n 'a ʃ ə m 'e n t 
renaixentista	r ə n ə ʃ ə n t 'i s t ə	 r ə n 'a ʃ ə n t 'i s t ə 
renda	r 'e n d ə	 r 'ə n d ə 
rendes	r 'e n d ə s	 r 'ə n d ə s 
rendiment	r ə n d i m 'e n t	 r 'ɛ n d i m 'e n t 
renebot	r ə n ə β 'o t	 r ə n ə β 'ɔ t 
renec	r ə n 'e k	 r ə n 'ɛ k 
renou	r ə n 'ɔ w	 r ə n 'o 
renten	r 'e n t ə n	 r 'ə n t ə n 
repartiment	r ə p ə ɾ t i m 'e n t	 r ə p 'a ɾ t i m 'e n t 
reposapeus	r ə p o z ə p 'ɛ w s	 r ə p o z ə p 'ə 'u s 
repte	r 'ɛ t t ə	 r 'ə t t ə 
requeriment	r ə k ə ɾ i m 'e n t	 r ə k 'ɛ ɾ i m 'e n t 
rere	r 'e ɾ ə	 r 'ɛ ɾ ə 
resa	r 'e z ə	 r 'ə z ə 
resclosa	r ə s k l 'ɔ z ə	 r ə s k l 'o z ə 
resen	r 'e z ə n	 r 'ə z ə n 
resistí	r ə z i s t 'i	 r ə z 'i s t 'i 
resistida	r ə z i s t 'i ð ə	 r ə z 'i s t 'i ð ə 
resistides	r ə z i s t 'i ð ə s	 r ə z 'i s t 'i ð ə s 
resistir	r ə z i s t 'i	 r ə z 'i s t 'i 
resistit	r ə z i s t 'i t	 r ə z 'i s t 'i t 
resistits	r ə z i s t 'i t s	 r ə z 'i s t 'i t s 
reso	r 'e z o	 r 'ə z o 
respatler	r ə s p ə l l 'e	 r ə s p ə ʎ 'e 
ressorgiment	r ə s o ɾ ʒ i m 'e n t	 r ə s 'ɔ ɾ ʒ i m 'e n t 
resta	r 'e s t ə	 r 'ə s t ə 
resten	r 'e s t ə n	 r 'ə s t ə n 
restes	r 'e s t ə s	 r 'ə s t ə s 
retard	r ə t 'a ɾ t	 r ə t 'a ɾ ə 
retreure	r ə t ɾ 'ə w ɾ ə	 r ə t ɾ 'ɛ w ɾ ə 
retrobament	r ə t ɾ o β ə m 'e n t	 r ə t ɾ 'ɔ β ə m 'e n t 
retroperitoneals	r ə t ɾ o p ə ɾ i t o n e 'a l s	 r ə t ɾ o p ə ɾ i t o n 'e 'a l s 
reuní	r ə u n 'i	 r ə 'u n 'i 
reverend	r ə v ə ɾ 'e n t	 r ə v ə ɾ 'ə n d 
revestiment	r ə v ə s t i m 'e n t	 r ə v 'ɛ s t i m 'e n t 
revetlla	r ə v 'e ʎ ʎ ə	 r ə v 'ə ʎ ʎ ə 
revetla	r ə v 'e l l ə	 r ə v 'ə ʎ ə 
reveure	r ə v 'ə w ɾ ə	 r ə v 'ə 'u ɾ ə 
revingut	r ə v i ŋ g 'u t	 r ə v 'i ŋ g 'u t 
revinguts	r ə v i ŋ g 'u t s	 r ə v 'i ŋ g 'u t s 
rialler	r i ə ʎ 'e	 r i 'a ʎ 'e 
riallera	r i ə ʎ 'e ɾ ə	 r i 'a ʎ 'e ɾ ə 
Ribagorça	r i β ə ɣ 'o ɾ s ə	 r i β ə ɣ 'ɔ ɾ s ə 
Ricosind	r i k o z 'i n t	 r i k o z 'i n d 
rodapeu	r o ð ə p 'ɛ w	 r o ð ə p 'ə w 
Roland	r o l 'a n t	 r o l 'a n d 
rombe	r 'o m b ə	 r 'ɔ m b ə 
rombes	r 'o m b ə s	 r 'ɔ m b ə s 
rompre	r 'o m p ɾ ə	 r 'ɔ m p ɾ ə 
rompuda	r o m p 'u ð ə	 r 'o m p 'u ð ə 
rompudes	r o m p 'u ð ə s	 r 'o m p 'u ð ə s 
romput	r o m p 'u t	 r 'o m p 'u t 
romputs	r o m p 'u t s	 r 'o m p 'u t s 
ronca	r 'o ŋ k ə	 r 'ɔ ŋ k ə 
ronda	r 'o n d ə	 r 'ɔ n d ə 
rondes	r 'o n d ə s	 r 'ɔ n d ə s 
rorqual	r o ɾ k w 'a l	 r 'ɔ ɾ k w 'a l 
rosegaaltars	r o z ə ɣ ə ə l t 'a s	 r o z ə ɣ e ə l t 'a s 
rossos	r 'o s o s	 r 'ɔ s o s 
rotlada	r o l l 'a ð ə	 r o ə l 'a ð ə 
rotle	r 'ɔ l l ə	 r 'ɔ t l ə 
rotles	r 'ɔ l l ə s	 r 'ɔ t l ə s 
rotonda	r o t 'o n d ə	 r o t 'ɔ n d ə 
rotund	r o t 'u n t	 r o t 'u n d 
roure	r 'o w ɾ ə	 r 'ɔ 'u ɾ ə 
roureda	r o w ɾ 'ə ð ə	 r o u ɾ 'ə ð ə 
rovell	r o v 'ə ʎ	 r o v 'e ʎ 
ruixat	r u ʃ 'a t	 r i ʃ 'a t 
ruixats	r u ʃ 'a t s	 r i ʃ 'a t s 
ruixim	r u ʃ 'i m	 r 'u ʃ 'i m 
ruptura	r u t t 'u ɾ ə	 r 'u t t 'u ɾ ə 
rutè	r u t 'ə	 r 'u t 'ə 
sa	s 'ə	 s ə 
saber	s ə β 'ə	 s ə β 'e 
saciarà	s ə s i ə ɾ 'a	 s ə s i 'a ɾ 'a 
sagrament	s ə ɣ ɾ ə m 'e n t	 s 'a ɣ ɾ ə m 'e n t 
sagristia	s ə ɣ ɾ i s t 'i ə	 s ə ɣ ɾ 'i s t 'i ə 
saharià	s ə ə ɾ i 'a	 s ə p ə ɾ i 'a 
sahrauí	s ə ɾ ə w 'i	 s ə ɲ ə w 'i 
sainet	s ə j n 'ə t	 s ə i n 'ə t 
sancionin	s ə n s i 'ɔ n i n	 s ə n s i 'o n 'i n 
sanejament	s ə n ə ʒ ə m 'e n t	 s ə n d ʒ ə m 'e n t 
sanglot	s ə ŋ g l 'o t	 s ə ŋ g l 'ɔ t 
sarg	s 'a ɾ k	 s 'a ɾ ə 
sastressa	s ə s t ɾ 'ə s ə	 s ə s t ɾ 'e s ə 
saturní	s ə t u ɾ n 'i	 s ə t 'u ɾ n 'i 
saüc	s ə 'u k	 s 'a 'u k 
sauna	s 'a w n ə	 s 'a 'u n ə 
seaborgi	s e ə β 'ɔ ɾ ʒ i	 s ə ə β 'ɔ ɾ ʒ i 
sega	s 'e ɣ ə	 s 'ə ɣ ə 
segment	s ə m m 'e n t	 s 'e m m 'e n t 
segrest	s ə ɣ ɾ 'e s t	 s ə ɣ ɾ 'ə s t 
seguici	s ə ɣ 'i s i	 s ə ɣ u 'i s i 
seient	s ə j 'e n t	 s ə i 'e n t 
seitó	s ə j t 'o	 s ə i t 'o 
sembra	s 'e m b ɾ ə	 s 'ə m b ɾ ə 
semiautònoma	s ə m i ə w t 'ɔ n o m ə	 s ə m i 'a w t 'ɔ n o m ə 
semiautònomes	s ə m i ə w t 'ɔ n o m ə s	 s ə m i 'a w t 'ɔ n o m ə s 
seminoma	s ə m i n 'ɔ m ə	 s ə m i n 'o m ə 
seminomes	s ə m i n 'ɔ m ə s	 s ə m i n 'o m ə s 
sempre	s 'e m p ɾ ə	 s 'ə m p ɾ ə 
senda	s 'e n d ə	 s 'ɛ n d ə 
sénia	s 'e n i ə	 s 'e n 'i ə 
sens	s 'ə n s	 s 'e n s 
sense	s 'e n s ə	 s 'ə n s ə 
senten	s 'e n t ə n	 s 'ə n t ə n 
sentiment	s ə n t i m 'e n t	 s 'ɛ n t i m 'e n t 
sento	s 'e n t o	 s 'ɛ n t o 
sèpsia	s 'ə t s i ə	 s 'ə p s i ə 
sepultura	s ə p u l t 'u ɾ ə	 s ə p 'u l t 'u ɾ ə 
sequoia	s ə k w 'ɔ j ə	 s ə k 'ɔ j ə 
setembre	s ə t 'e m b ɾ ə	 s ə t 'ə m b ɾ ə 
setge	s 'e d ʒ ə	 s 'ə d ʒ ə 
setges	s 'e d ʒ ə s	 s 'ə d ʒ ə s 
seua	s 'e w ə	 s 'ə w ə 
seure	s 'ə w ɾ ə	 s 'ɛ w ɾ ə 
seva	s 'e v ə	 s 'ə v ə 
sèver	s 'ə v ə	 s v 'e  
seves	s 'e v ə s	 s 'ə v ə s 
siboc	s i β 'o k	 s i β 'ɔ k 
signada	s i n n 'a ð ə	 s i ə n 'a ð ə 
signades	s i n n 'a ð ə s	 s i ə n 'a ð ə s 
Silèsia	s i l 'ɛ z i ə	 s i l 'ə z i ə 
simultaneïtat	s i m u l t ə n ə i t 'a t	 s i m u l t 'a n ə i t 'a t 
sinagoga	s i n ə ɣ 'o ɣ ə	 s i n ə ɣ 'ɔ ɣ ə 
síndria	s 'i n d ɾ i ə	 s 'i n d ɾ 'i ə 
síndrome	s 'i n d ɾ o m ə	 s 'i n d ɾ 'ɔ m ə 
singapurès	s i ŋ g ə p u ɾ 'ə s	 s i ŋ g ə p 'u ɾ 'ə s 
sisè	s i z 'ə	 s i s 'ə 
sistema	s i s t 'e m ə	 s i s t 'ə m ə 
sitiet	s i t i 'ə t	 s i t 'i 'ə t 
sobre	s 'o β ɾ ə	 s 'ɔ β ɾ ə 
sobta	s 'o t t ə	 s 'ɔ t t ə 
soferts	s o f 'ɛ ɾ s	 s o f 'ɛ ɾ t s 
sofre	s 'o f ɾ ə	 s 'ɔ f ɾ ə 
sofriment	s o f ɾ i m 'e n t	 s 'ɔ f ɾ i m 'e n t 
solell	s o l 'ə ʎ	 s o l 'e ʎ 
solquen	s 'o l k ə n	 s 'ɔ l k ə n 
solter	s o l t 'e	 s 'ɔ l t 'e 
sonda	s 'o n d ə	 s 'ɔ n d ə 
sondes	s 'o n d ə s	 s 'ɔ n d ə s 
sones	s 'ɔ n ə s	 s 'o n ə s 
sopa	s 'o p ə	 s 'ɔ p ə 
sopen	s 'o p ə n	 s 'ɔ p ə n 
sopes	s 'o p ə s	 s 'ɔ p ə s 
sorda	s 'o ɾ ð ə	 s 'ɔ ɾ ð ə 
sordes	s 'o ɾ ð ə s	 s 'ɔ ɾ ð ə s 
sorna	s 'o ɾ n ə	 s 'ɔ ɾ n ə 
sorrut	s o r 'u t	 s 'o r 'u t 
sostinguda	s o s t i ŋ g 'u ð ə	 s o s t 'i ŋ g 'u ð ə 
sostingudes	s o s t i ŋ g 'u ð ə s	 s o s t 'i ŋ g 'u ð ə s 
sostingut	s o s t i ŋ g 'u t	 s o s t 'i ŋ g 'u t 
sostinguts	s o s t i ŋ g 'u t s	 s o s t 'i ŋ g 'u t s 
sostre	s 'o s t ɾ ə	 s 'ɔ s t ɾ ə 
sostres	s 'o s t ɾ ə s	 s 'ɔ s t ɾ ə s 
sostreure	s o s t ɾ 'ə w ɾ ə	 s o s t ɾ 'ɛ w ɾ ə 
sota	s 'o t ə	 s 'ɔ t ə 
soterrament	s o t ə r ə m 'e n t	 s o t 'ɛ r ə m 'e n t 
sotmetiment	s o m m ə t i m 'e n t	 s o m m 'ɛ t i m 'e n t 
sous	s 'ɔ w s	 s 'o 'u s 
sovintejada	s o v i n t ə ʒ 'a ð ə	 s o v 'i n t ə ʒ 'a ð ə 
sovintejades	s o v i n t ə ʒ 'a ð ə s	 s o v 'i n t ə ʒ 'a ð ə s 
sovintejar	s o v i n t ə ʒ 'a	 s o v 'i n t ə ʒ 'a 
sovintejat	s o v i n t ə ʒ 'a t	 s o v 'i n t ə ʒ 'a t 
sovintejats	s o v i n t ə ʒ 'a t s	 s o v 'i n t ə ʒ 'a t s 
subhasta	s u β 'a s t ə	 s u β i 'a s t ə 
subratllades	s u β ɾ ə l ʎ ʎ 'a ð ə s	 s u β ɾ 'a ʎ ʎ 'a ð ə s 
subscriure	s u p s k ɾ 'i w ɾ ə	 s u t s k ɾ 'i w ɾ ə 
substància	s u p s t 'a n s i ə	 s u t s t 'a n s i ə 
sucursal	s u k u ɾ s 'a l	 s u k 'u s 'a l 
sucursals	s u k u ɾ s 'a l s	 s u k 'u s 'a l s 
Suècia	s u 'ə s i ə	 s u 'ɛ s i ə 
súper	s 'u p ə	 s 'u p 'e  
suplement	s u p l ə m 'e n t	 s 'u p l ə m 'e n t 
suport	s u p 'ɔ ɾ t	 s u p 'o ɾ t 
sutzura	s u d z 'u ɾ ə	 s 'u d z 'u ɾ ə 
tailandesa	t ə j l ə n d 'ə z ə	 t 'a j l ə n d 'ə z ə 
tailandeses	t ə j l ə n d 'ə z ə s	 t 'a j l ə n d 'ə z ə s 
Tailàndia	t ə j l 'a n d i ə	 t ə i l 'a n d i ə 
tàlveg	t 'a l v ə k	 t 'a l v ə ɣ 
tancament	t ə ŋ k ə m 'e n t	 t 'a ŋ k ə m 'e n t 
tangent	t ə n ʒ 'e n t	 t 'a ŋ g 'e n t 
tanoca	t ə n 'o k ə	 t ə n 'ɔ k ə 
tard	t 'a ɾ t	 t 'a ɾ ə 
tàtar	t 'a t ə	 t 'a t 'a 
tatxonar	t ə t ʃ o n 'a	 t 'a t ʃ o n 'a 
taüt	t ə 'u t	 t 'a 'u t 
tèbia	t 'ə β i ə	 t 'ɛ β i ə 
tecla	t 'e k l ə	 t 'ɛ k l ə 
tecles	t 'e k l ə s	 t 'ɛ k l ə s 
telèfons	t ə l 'ə f o n s	 t ə l 'ə f 'o n s 
tema	t 'e m ə	 t 'ə m ə 
temen	t 'e m ə n	 t 'ə m ə n 
témer	t 'e m ə	 t 'e m 'e  
temes	t 'e m ə s	 t 'ə m ə s 
temo	t 'e m o	 t 'ə m o 
temperament	t ə m p ə ɾ ə m 'e n t	 t ə m p 'ɛ ɾ ə m 'e n t 
tempesta	t ə m p 'e s t ə	 t ə m p 'ə s t ə 
templa	t 'e m p l ə	 t 'ə m p l ə 
temple	t 'e m p l ə	 t 'ə m p l ə 
temples	t 'e m p l ə s	 t 'ə m p l ə s 
temptada	t ə m t 'a ð ə	 t ə m ə t 'a ð ə 
temptades	t ə m t 'a ð ə s	 t ə m ə t 'a ð ə s 
temptat	t ə m t 'a t	 t ə m ə t 'a t 
temptats	t ə m t 'a t s	 t ə m ə t 'a t s 
tenda	t 'e n d ə	 t 'ɛ n d ə 
tendenciosa	t ə n d ə n s i 'o z ə	 t ə n d ə n s i 'o s ə 
tendencioses	t ə n d ə n s i 'o z ə s	 t ə n d ə n s i 'o s ə s 
tendenciosos	t ə n d ə n s i 'o z o s	 t ə n d ə n s i 'o s o s 
tendes	t 'e n d ə s	 t 'ə n d ə s 
tenebra	t ə n 'e β ɾ ə	 t ə n 'ə β ɾ ə 
tenebres	t ə n 'e β ɾ ə s	 t ə n 'ə β ɾ ə s 
tenen	t 'e n ə n	 t 'ə n ə n 
téntol	t 'e n t o l	 t 'e n t 'ɔ l 
terapèutic	t ə ɾ ə p 'ə w t i k	 t ə ɾ ə p 'ɛ w t i k 
terrestre	t ə r 'e s t ɾ ə	 t ə r 'ə s t ɾ ə 
terrestres	t ə r 'e s t ɾ ə s	 t ə r 'ə s t ɾ ə s 
Teseu	t ə z 'ɛ w	 t ə s 'ɛ w 
testament	t ə s t ə m 'e n t	 t 'ə s t ə m 'e n t 
testimoni	t ə s t i m 'ɔ n i	 t ə s t i m 'o n i 
tètanus	t 'ə t ə n u s	 t 'ə t ə n 'u s 
teuladí	t ə w l ə ð 'i	 t ə w l 'a ð 'i 
teva	t 'e v ə	 t 'ə v ə 
teves	t 'e v ə s	 t 'ə v ə s 
tinamú	t i n ə m 'u	 t i n 'a m 'u 
tinguda	t i ŋ g 'u ð ə	 t 'i ŋ g 'u ð ə 
tingudes	t i ŋ g 'u ð ə s	 t 'i ŋ g 'u ð ə s 
tinter	t i n t 'e	 t 'i n t 'e 
titlada	t i l l 'a ð ə	 t i ə l 'a ð ə 
titlades	t i l l 'a ð ə s	 t i ə l 'a ð ə s 
titlar	t i l l 'a	 t i ə l 'a 
titlat	t i l l 'a t	 t i ə l 'a t 
titlats	t i l l 'a t s	 t i ə l 'a t s 
tomba	t 'o m b ə	 t 'ɔ m b ə 
tomben	t 'o m b ə n	 t 'ɔ m b ə n 
tombes	t 'o m b ə s	 t 'ɔ m b ə s 
tonya	t 'ɔ ɲ ə	 t 'o ɲ ə 
topa	t 'o p ə	 t 'ɔ p ə 
topen	t 'o p ə n	 t 'ɔ p ə n 
topo	t 'o p o	 t 'ɔ p o 
torba	t 'o ɾ β ə	 t 'ɔ ɾ β ə 
torben	t 'o ɾ β ə n	 t 'ɔ ɾ β ə n 
torçuda	t o ɾ s 'u ð ə	 t 'o ɾ s 'u ð ə 
torçudes	t o ɾ s 'u ð ə s	 t 'o ɾ s 'u ð ə s 
torçut	t o ɾ s 'u t	 t 'o ɾ s 'u t 
torçuts	t o ɾ s 'u t s	 t 'o ɾ s 'u t s 
torna	t 'o ɾ n ə	 t 'ɔ ɾ n ə 
tornen	t 'o ɾ n ə n	 t 'ɔ ɾ n ə n 
tornes	t 'o ɾ n ə s	 t 'ɔ ɾ n ə s 
torno	t 'o ɾ n o	 t 'ɔ ɾ n o 
torra	t 'ɔ r ə	 t 'o r ə 
torre	t 'o r ə	 t 'ɔ r ə 
torrent	t o r 'e n t	 t 'o r 'e n t 
tort	t 'ɔ ɾ t	 t 'o ɾ t 
tortuga	t o ɾ t 'u ɣ ə	 t 'ɔ ɾ t 'u ɣ ə 
tortura	t o ɾ t 'u ɾ ə	 t 'ɔ ɾ t 'u ɾ ə 
tortures	t o ɾ t 'u ɾ ə s	 t 'ɔ ɾ t 'u ɾ ə s 
torturo	t o ɾ t 'u ɾ o	 t 'ɔ ɾ t 'u ɾ o 
tosca	t 'o s k ə	 t 'ɔ s k ə 
tossut	t o s 'u t	 t 'o s 'u t 
tota	t 'o t ə	 t 'ɔ t ə 
totes	t 'o t ə s	 t 'ɔ t ə s 
totxo	t 'o t ʃ o	 t 'ɔ t ʃ o 
tractament	t ɾ ə t t ə m 'e n t	 t ɾ 'a t t ə m 'e n t 
transsexual	t ɾ ə n s ə t s u 'a l	 t ɾ 'a n s ə t s u 'a l 
transsexualitat	t ɾ ə n s ə t s u ə l i t 'a t	 t ɾ 'a n s ə t s u ə l i t 'a t 
transsiberià	t ɾ ə n s i β ə ɾ i 'a	 t ɾ 'a n s i β ə ɾ i 'a 
Transsiberià	t ɾ ə n s i β ə ɾ i 'a	 t ɾ 'a n s i β ə ɾ i 'a 
trapezi	t ɾ ə p 'ɛ z i	 t ɾ ə p 'ə z i 
traqueal	t ɾ ə k e 'a l	 t ɾ ə k 'e 'a l 
traqueals	t ɾ ə k e 'a l s	 t ɾ ə k 'e 'a l s 
trasplantament	t ɾ ə s p l ə n t ə m 'e n t	 t ɾ ə s p l 'a n t ə m 'e n t 
travessada	t ɾ ə v ə s 'a ð ə	 t ɾ 'a v ə s 'a ð ə 
travessades	t ɾ ə v ə s 'a ð ə s	 t ɾ 'a v ə s 'a ð ə s 
travessar	t ɾ ə v ə s 'a	 t ɾ 'a v ə s 'a 
travessat	t ɾ ə v ə s 'a t	 t ɾ 'a v ə s 'a t 
travessats	t ɾ ə v ə s 'a t s	 t ɾ 'a v ə s 'a t s 
travessia	t ɾ ə v ə s 'i ə	 t ɾ 'a v ə s 'i ə 
travessies	t ɾ ə v ə s 'i ə s	 t ɾ 'a v ə s 'i ə s 
tremp	t ɾ 'e m p	 t ɾ 'ə m p 
Tremp	t ɾ 'e m p	 t ɾ 'ə m p 
trencament	t ɾ ə ŋ k ə m 'e n t	 t ɾ 'ə ŋ k ə m 'e n t 
trenqués	t ɾ ə ŋ k 'e s	 t ɾ 'ə ŋ k 'e s 
trenqui	t ɾ 'ɛ ŋ k i	 t ɾ 'ə ŋ k i 
trenquin	t ɾ 'ɛ ŋ k i n	 t ɾ 'ə ŋ k i n 
trenquis	t ɾ 'ɛ ŋ k i s	 t ɾ 'ə ŋ k i s 
trens	t ɾ 'ə n s	 t ɾ 'e n s 
trepa	t ɾ 'e p ə	 t ɾ 'ə p ə 
trepes	t ɾ 'e p ə s	 t ɾ 'ə p ə s 
trepig	t ɾ ə p 'i t ʃ	 t ɾ ə p 'i ə 
trepitjada	t ɾ ə p i d ʒ 'a ð ə	 t ɾ ə p 'i ə ʒ 'a ð ə 
trepitjades	t ɾ ə p i d ʒ 'a ð ə s	 t ɾ ə p 'i ə ʒ 'a ð ə s 
trepitjaneu	t ɾ ə p i d ʒ ə n 'ɛ w	 t ɾ ə p i d ʒ ə n 'ə w 
tret	t ɾ 'e t	 t ɾ 'ə t 
treta	t ɾ 'e t ə	 t ɾ 'ə t ə 
tretes	t ɾ 'e t ə s	 t ɾ 'ə t ə s 
trets	t ɾ 'e t s	 t ɾ 'ə t s 
tretze	t ɾ 'e d z ə	 t ɾ 'ə d z ə 
treure	t ɾ 'ə w ɾ ə	 t ɾ 'ɛ w ɾ ə 
treus	t ɾ 'ɛ w s	 t ɾ 'ə w s 
treva	t ɾ 'e v ə	 t ɾ 'ə v ə 
Trèveris	t ɾ 'ɛ v ə ɾ i s	 t ɾ 'ə v ə ɾ i s 
triangulars	t ɾ i ə ŋ g u l 'a s	 t ɾ i 'a ŋ g u l 'a s 
troià	t ɾ o j 'a	 t ɾ o i 'a 
tromba	t ɾ 'o m b ə	 t ɾ 'ɔ m b ə 
trompa	t ɾ 'o m p ə	 t ɾ 'ɔ m p ə 
trompes	t ɾ 'o m p ə s	 t ɾ 'ɔ m p ə s 
tropa	t ɾ 'o p ə	 t ɾ 'ɔ p ə 
tropes	t ɾ 'o p ə s	 t ɾ 'ɔ p ə s 
truncat	t ɾ u ŋ k 'a t	 t ɾ 'u ŋ k 'a t 
truncats	t ɾ u ŋ k 'a t s	 t ɾ 'u ŋ k 'a t s 
tsar	t s 'a	 ə z 'a 
tucà	t u k 'a	 t 'u k 'a 
tudó	t u ð 'o	 t 'u ð 'o 
tutú	t u t 'u	 t 'u t 'u 
uigur	u j ɣ 'u	 u i ɣ 'u 
ull	'u j	 'u ʎ 
vaig	v 'a t ʃ	 v 'a ʃ 
vailet	v ə j l 'ə t	 v ə i l 'ə t 
vainilla	v ə j n 'i ʎ ə	 v ə i n 'i ʎ ə 
vainilles	v ə j n 'i ʎ ə s	 v ə i n 'i ʎ ə s 
vairescut	v ə j ɾ ə s k 'u t	 v 'a j ɾ ə s k 'u t 
vaiverejar	v ə j v ə ɾ ə ʒ 'a	 v 'a j v ə ɾ ə ʒ 'a 
valer	v ə l 'ə	 v ə l 'e 
ve	v 'e	 v 'ə 
vegetarianisme	v ə ʒ ə t ə ɾ i ə n 'i z m ə	 v ə ʒ ə t ə ɾ 'i ə n 'i z m ə 
vehement	v ə ə m 'e n t	 v 'ə z ə m 'e n t 
venciment	v ə n s i m 'e n t	 v 'ɛ n s i m 'e n t 
Venècia	v ə n 'ə s i ə	 v ə n 'ɛ s i ə 
vènet	v 'ɛ  n ə t	 v 'ə n ə t 
vènia	v 'ɛ  n i ə	 v 'ɛ n i ə 
ventre	v 'e n t ɾ ə	 v 'ɛ n t ɾ ə 
ventrell	v ə n t ɾ 'ə ʎ	 v ə n t ɾ 'e ʎ 
Venus	v 'ɛ n u s	 v 'ə n u s 
vespa	v 'e s p ə	 v 'ə s p ə 
vespre	v 'e s p ɾ ə	 v 'ə s p ɾ ə 
vessament	v ə s ə m 'e n t	 v 'ə s ə m 'e n t 
vetlla	v 'e ʎ ʎ ə	 v 'ə ʎ ʎ ə 
vetla	v 'e l l ə	 v 'ə t l ə 
veure	v 'ə w ɾ ə	 v 'ɛ w ɾ ə 
viatger	v i ə d ʒ 'e	 v i 'a d ʒ 'e 
viatgera	v i ə d ʒ 'e ɾ ə	 v i 'a d ʒ 'e ɾ ə 
Vicent	v i s 'ɛ n t	 v i s 'e n t 
vicesecretari	v i s ə s ə k ɾ ə t 'a ɾ i	 v i s ə z ə k ɾ ə t 'a ɾ i 
vigència	v i ʒ 'ɛ  n s i ə	 v i ʒ 'ɛ n s i ə 
vigèsim	v i ʒ 'ɛ  z i m	 v i ʒ 'ɛ z i m 
vinguda	v i ŋ g 'u ð ə	 v 'i ŋ g 'u ð ə 
vingudes	v i ŋ g 'u ð ə s	 v 'i ŋ g 'u ð ə s 
vingut	v i ŋ g 'u t	 v 'i ŋ g 'u t 
vinguts	v i ŋ g 'u t s	 v 'i ŋ g 'u t s 
violència	v i o l 'ɛ  n s i ə	 v i o l 'ɛ n s i ə 
virtut	v i ɾ t 'u t	 v 'i ɾ t 'u t 
viticultura	v i t i k u l t 'u ɾ ə	 v i t i k 'u l t 'u ɾ ə 
viuda	v 'i w ð ə	 v 'i 'u ð ə 
voivoda	v o j v 'ɔ ð ə	 v o i v 'ɔ ð ə 
voler	v o l 'ə	 v o l 'e 
volguda	v o l ɣ 'u ð ə	 v 'ɔ l ɣ 'u ð ə 
volgudes	v o l ɣ 'u ð ə s	 v 'ɔ l ɣ 'u ð ə s 
volgut	v o l ɣ 'u t	 v 'ɔ l ɣ 'u t 
volguts	v o l ɣ 'u t s	 v 'ɔ l ɣ 'u t s 
volumètric	v o l u m 'ɛ t ɾ i k	 v o l u m 'ə t ɾ i k 
votants	v o t 'a n s	 v o t 'a n t s 
voto	v 'o t o	 v 'ɔ t o 
vuitada	v u j t 'a ð ə	 v u i t 'a ð ə 
vuitanta	v u j t 'a n t ə	 v u i t 'a n t ə 
wiki	b 'i k i	 ə 'i k i 
xafardejada	ʃ ə f ə ɾ ð ə ʒ 'a ð ə	 ʃ ə f 'a ɾ ð ə ʒ 'a ð ə 
xafardejades	ʃ ə f ə ɾ ð ə ʒ 'a ð ə s	 ʃ ə f 'a ɾ ð ə ʒ 'a ð ə s 
xafardejar	ʃ ə f ə ɾ ð ə ʒ 'a	 ʃ ə f 'a ɾ ð ə ʒ 'a 
xafardejat	ʃ ə f ə ɾ ð ə ʒ 'a t	 ʃ ə f 'a ɾ ð ə ʒ 'a t 
xafardejats	ʃ ə f ə ɾ ð ə ʒ 'a t s	 ʃ ə f 'a ɾ ð ə ʒ 'a t s 
xafarderia	ʃ ə f ə ɾ ð ə ɾ 'i ə	 ʃ ə f 'a ɾ ð ə ɾ 'i ə 
Xangai	ʃ ə ŋ g 'a j	 ʃ ə ŋ g 'a i 
xangainès	ʃ ə ŋ g ə j n 'ə s	 ʃ ə ŋ g ə i n 'ə s 
xativí	ʃ ə t i v 'i	 ʃ ə t 'i v 'i 
xecs	ʃ 'ɛ t s	 ʃ 'ə t s 
xeic	ʃ 'e j k	 ʃ 'ə j k 
xereca	ʃ ə ɾ 'ɛ k ə	 ʃ ə ɾ 'ə k ə 
xiïta	ʃ i 'i t ə	 ʃ 'i 'i t ə 
xíndria	ʃ 'i n d ɾ i ə	 ʃ 'i n d ɾ 'i ə 
xistorra	ʃ i s t 'ɔ r ə	 ʃ i s t 'o r ə 
xoriguer	ʃ o ɾ i ɣ 'e	 ʃ o ɾ 'i ɣ 'e 
xou	ʃ 'ɔ w	 ʃ 'o 
xous	ʃ 'ɔ w s	 ʃ 'o 'u s 
xucrut	ʃ u k ɾ 'u t	 ʃ 'u k ɾ 'u t 
Xúquer	ʃ 'u k ə	 ʃ 'u k 'e  
zebra	z 'e β ɾ ə	 z 'ə β ɾ ə 
zeugma	z 'ɛ w m m ə	 z 'ə u m m ə 
zirconi	z i ɾ k 'ɔ n i	 z i ɾ k 'o n i 
zoòleg	z o 'ɔ l ə k	 o 'ɔ 'ɔ l ə k 
de	d 'ə	 d ə 
que	k 'ə	 k ə 
la	l 'ə	 l ə 
i	'i	 i 
a	'ə	 ə 
el	'ə l	 ə l 
en	'ə n	 ə n 
les	l 'ə s	 l ə s 
els	'ə l s	 'ɛ l s 
del	d 'ə l	 d ə l 
amb	'ə m	 'a m b 
al	'ə l	 'a l 
es	'ə s	 ə s 
com	k 'ɔ m	 k 'o m 
El	'ə l	 ə l 
dels	d 'ə l s	 d 'ɛ l s 
hi	'i	 i 
La	l 'ə	 l ə 
o	'ɔ	 'o 
si	s 'i	 s i 
em	'ə m	 ə m 
li	l 'i	 l i 
tot	t 'o t	 t 'ɔ t 
seva	s 'e v ə	 s 'ə v ə 
ens	'ə n s	 ə n s 
Els	ə l s	 'ɛ l s 
A	'ə	 ə 
als	ə l s	 'a l s 
sobre	s 'o β ɾ ə	 s 'ɔ β ɾ ə 
vaig	v 'a t ʃ	 v 'a ʃ 
En	'ə n	 ə n 
Si	s 'i	 s i 
sense	s 'e n s ə	 s 'ə n s ə 
ho	'o	 o 
res	r 'ɛ s	 r 'ə s 
De	d 'ə	 d ə 
pel	p 'ə l	 p 'ɛ l 
tots	t 'o t s	 t 'ɔ t s 
meva	m 'e v ə	 m 'ə v ə 
sempre	s 'e m p ɾ ə	 s 'ə m p ɾ ə 
I	'i	 i 
he	'e	 'a 
hem	'ə m	 'a m 
cosa	k 'ɔ z ə	 k 'o z ə 
seves	s 'e v ə s	 s 'ə v ə s 
se	s 'ə	 s ə 
Les	l 'ə s	 l ə s 
sistema	s i s t 'e m ə	 s i s t 'ə m ə 
Em	'ə m	 ə m 
tota	t 'o t ə	 t 'ɔ t ə 
et	'ə t	 ə t 
moment	m o m 'e n t	 m 'ɔ m 'e n t 
Es	'ə s	 ə s 
poder	p o ð 'ə	 p o ð 'e 
Al	'ə l	 'a l 
hores	'ɔ ɾ ə s	 ə 'o ə s 
totes	t 'o t ə s	 t 'ɔ t ə s 
coses	k 'ɔ z ə s	 k 'o z ə s 
Hi	'i	 i 
Com	k 'ɔ m	 k 'o m 
dona	d 'ɔ n ə	 d 'o n ə 
diferents	d i f ə ɾ 'e n s	 d i f ə ɾ 'e n t s 
haver	ə v 'ə	 ə v 'e 
tenen	t 'e n ə n	 t 'ə n ə n 
ningú	n i ŋ g 'u	 n 'i ŋ g 'u 
Li	l 'i	 l i 
Amb	'ə m	 'a m b 
nens	n 'ə n s	 n 'e n s 
centre	s 'e n t ɾ ə	 s 'ɛ n t ɾ ə 
sota	s 'o t ə	 s 'ɔ t ə 
ben	b 'e n	 b 'ə n 
pels	p 'ə l s	 p 'ɛ l s 
molts	m 'o l s	 m 'o l t s 
contra	k 'o n t ɾ ə	 k 'ɔ n t ɾ ə 
saber	s ə β 'ə	 s ə β 'e 
mig	m 'i t ʃ	 m 'i k 
cotxe	k 'o t ʃ o	 k 'ɔ t ʃ ə 
Ho	'o	 o 
moltes	m 'o l t ə s	 m 'ɔ l t ə s 
mateixa	m ə t 'e ʃ ə	 m ə t 'ɛ ʃ ə 
eren	'e ɾ ə n	 'ɛ ɾ ə n 
mes	m 'e s	 m 'ə s 
Queden	k 'e ð ə n	 k 'ə ð ə n 
mort	m 'ɔ ɾ t	 m 'o ɾ t 
forma	f 'o ɾ m ə	 f 'ɔ ɾ m ə 
fora	f 'ɔ ɾ ə	 f 'o ɾ ə 
home	'ɔ m o	 ə m ə 
ve	v 'e	 v 'ə 
trenta	t ɾ 'ə n t ə	 t ɾ 'e n t ə 
sento	s 'e n t o	 s 'ɛ n t o 
He	'e	 'a 
hora	'ɔ ɾ ə	 ə ɾ ə 
Vaig	v 'a t ʃ	 v 'a ʃ 
problemes	p ɾ o β l 'ɛ m ə s	 p ɾ o β l 'ə m ə s 
Tot	t 'o t	 t 'ɔ t 
darrere	d ə r 'e ɾ ə	 d ə r 'ɛ ɾ ə 
teva	t 'e v ə	 t 'ə v ə 
tretze	t ɾ 'e d z ə	 t ɾ 'ə d z ə 
tema	t 'e m ə	 t 'ə m ə 
molta	m 'o l t ə	 m 'ɔ l t ə 
dotze	d 'o d z ə	 d 'ɔ d z ə 
dones	d 'ɔ n ə s	 d 'o n ə s 
queda	k 'e ð ə	 k 'ə ð ə 
noi	n 'ɔ j	 n 'o i 
fort	f 'ɔ ɾ t	 f 'o ɾ t 
Ens	'ə n s	 ə n s 
llengua	ʎ 'e ŋ g w ə	 ʎ 'ə ŋ g w ə 
tingut	t i ŋ g 'u t	 t 'i ŋ g 'u t 
tard	t 'a ɾ t	 t 'a ɾ ə 
segle	s 'e g g l ə	 s 'ə ɣ l ə 
Tots	t 'o t s	 t 'ɔ t s 
hagi	'a ʒ i	 ə ʒ i 
Que	k 'ə	 k ə 
jove	ʒ 'o v ə	 ʒ 'ɔ v ə 
catorze	k ə t 'o ɾ z ə	 k ə t 'ɔ ɾ z ə 
joves	ʒ 'o v ə s	 ʒ 'ɔ v ə s 
Sempre	s 'e m p ɾ ə	 s 'ə m p ɾ ə 
faig	f 'a t ʃ	 f 'a j ə 
meves	m 'e v ə s	 m 'ə v ə s 
Coneixement	k o n ə ʃ ə m 'e n t	 k o n 'ə ʃ ə m 'e n t 
llarg	ʎ 'a ɾ k	 ʎ 'a ɾ ə 
document	d o k u m 'e n t	 d 'ɔ k u m 'e n t 
contingut	k o n t i ŋ g 'u t	 k o n t 'i ŋ g 'u t 
boca	b 'o k ə	 b 'ɔ k ə 
temes	t 'e m ə s	 t 'ə m ə s 
tecla	t 'e k l ə	 t 'ɛ k l ə 
homes	'ɔ m ə s	 ə 'o m ə s 
centres	s 'e n t ɾ ə s	 s 'ɛ n t ɾ ə s 
Lleida	ʎ 'e j ð ə	 ʎ 'ə j ð ə 
tens	t 'ə n s	 t 'e n s 
maig	m 'a t ʃ	 m 'a ʃ 
trens	t ɾ 'ə n s	 t ɾ 'e n s 
importants	i m p o ɾ t 'a n s	 i m p o ɾ t 'a n t s 
aspectes	ə s p 'ɛ t t ə s	 ə s p 'ə t t ə s 
fes	f 'e s	 f 'ə s 
cultura	k u l t 'u ɾ ə	 k 'u l t 'u ɾ ə 
vuitanta	v u j t 'a n t ə	 v u i t 'a n t ə 
torna	t 'o ɾ n ə	 t 'ɔ ɾ n ə 
suport	s u p 'ɔ ɾ t	 s u p 'o ɾ t 
queden	k 'e ð ə n	 k 'ə ð ə n 
peixos	p 'e ʃ o s	 p 'ɛ ʃ o s 
haig	'a t ʃ	 ə 'i ə 
foto	f 'o t o	 f 'ɔ t o 
Pere	p 'e ɾ ə	 p 'ɛ ɾ ə 
O	'ɔ	 'o 
moviment	m o v i m 'e n t	 m 'ɔ v i m 'e n t 
instants	i n s t 'a n s	 i n s t 'a n t s 
etcètera	ə t s 'ɛ t ə ɾ ə	 ə t s 'ə t ə ɾ ə 
dòlars	d 'ɔ l ə s	 d 'ɔ l 'a s 
conte	k 'o n t ə	 k 'ɔ n t ə 
me'n	m ə n	 m 'ə n 
bossa	b 'o s ə	 b 'ɔ s ə 
Hem	'ə m	 'a m 
pedra	p 'e ð ɾ ə	 p 'ə ð ɾ ə 
passatgers	p ə s ə d ʒ 'e s	 p ə s 'a d ʒ 'e s 
paisatge	p ə j z 'a d ʒ ə	 p ə i z 'a d ʒ ə 
nois	n 'ɔ j s	 n 'o i s 
mètode	m 'ɛ t o ð ə	 m 'ə t o ð ə 
gens	ʒ 'ə n s	 g 'e n s 
formes	f 'o ɾ m ə s	 f 'ɔ ɾ m ə s 
espai	ə s p 'a j	 ə s p 'a i 
cotxes	k 'o t ʃ ə s	 k 'ɔ t ʃ ə s 
compra	k 'o m p ɾ ə	 k 'ɔ m p ɾ ə 
Reconeixement	r ə k o n ə ʃ ə m 'e n t	 r ə k o n 'ə ʃ ə m 'e n t 
Montse	m 'o n s ə	 m 'ɔ n t s ə 
vingut	v i ŋ g 'u t	 v 'i ŋ g 'u t 
respecte	r ə s p 'ɛ t t ə	 r ə s p 'ə t t ə 
parts	p 'a ɾ s	 p 'a ɾ t s 
me	m 'ə	 m ə 
mateixos	m ə t 'e ʃ o s	 m ə t 'ɛ ʃ o s 
gossos	g 'o s o s	 g 'ɔ s o s 
Pel	p 'ə l	 p 'ɛ l 
Et	'ə t	 ə t 
últims	'u l t i n s	 'u l t 'i n s 
volen	v 'o l ə n	 v 'ɔ l ə n 
plens	p l 'ə n s	 p l 'e n s 
funcionament	f u n s i o n ə m 'e n t	 f u n s i 'ɔ n ə m 'e n t 
dimecres	d i m 'e k ɾ ə s	 d i m 'ɛ k ɾ ə s 
deixen	d 'e ʃ ə n	 d 'ə ʃ ə n 
coneixement	k o n ə ʃ ə m 'e n t	 k o n 'ə ʃ ə m 'e n t 
cadascú	k ə ð ə s k 'u	 k 'a ð ə s k 'u 
Sense	s 'e n s ə	 s 'ə n s ə 
veuen	v 'ə w ə n	 v 'ɛ w ə n 
transport	t ɾ ə n s p 'ɔ ɾ t	 t ɾ ə n s p 'o ɾ t 
processos	p ɾ o s 'e s o s	 p ɾ o s 'ə s o s 
problema	p ɾ o β l 'ɛ m ə	 p ɾ o β l 'ə m ə 
pedres	p 'e ð ɾ ə s	 p 'ə ð ɾ ə s 
desig	d ə z 'i t ʃ	 d ə z 'i 
preguntar	p ɾ ə ɣ u n t 'a	 p ɾ ə ɣ 'u n t 'a 
pagament	p ə ɣ ə m 'e n t	 p 'a ɣ ə m 'e n t 
fosca	f 'o s k ə	 f 'ɔ s k ə 
fer-ho	f 'e ɾ o	 f 'ɛ ɾ o 
entendre	ə n t 'e n d ɾ ə	 ə n t 'ə n d ɾ ə 
dolça	d 'o l s ə	 d 'ɔ l s ə 
Vielha	v i 'ɛ l ə	 v i 'ɛ l 'a 
ves	v 'e s	 v 'ə s 
torno	t 'o ɾ n o	 t 'ɔ ɾ n o 
sistemes	s i s t 'e m ə s	 s i s t 'ə m ə s 
metges	m 'e d ʒ ə s	 m 'ə d ʒ ə s 
formen	f 'o ɾ m ə n	 f 'ɔ ɾ m ə n 
consum	k o n s 'u m	 k 'o n s 'u m 
boig	b 'ɔ t ʃ	 b 'ɔ 'i ə 
aspecte	ə s p 'ɛ t t ə	 ə s p 'ə t t ə 
Montserrat	m o n s ə r 'a t	 m 'o n t s ə r 'a t 
i	'i	 i 
vespre	v 'e s p ɾ ə	 v 'ə s p ɾ ə 
sabent	s ə β 'ɛ n t	 s ə β 'e n t 
representants	r ə p ɾ ə z ə n t 'a n s	 r ə p ɾ ə z ə n t 'a n t s 
reforma	r ə f 'o ɾ m ə	 r ə f 'ɔ ɾ m ə 
quedo	k 'e ð o	 k 'ə ð o 
néixer	n 'e ʃ ə	 n 'e ʃ 'e  
meitat	m ə j t 'a t	 m ə i t 'a t 
hagin	'a ʒ i n	 ə ʒ i n 
equips	ə k 'i t s	 ə k 'i p s 
doble	d 'o b b l ə	 d 'ɔ b b l ə 
disposen	d i s p 'o z ə n	 d i s p 'ɔ z ə n 
conscient	k o n t s i 'e n t	 k o n s i 'e n t 
Ningú	n i ŋ g 'u	 n 'i ŋ g 'u 
Moltes	m 'o l t ə s	 m 'ɔ l t ə s 
Als	'ə l s	 'a l s 
ésser	'e s ə	 'e s 'e  
època	'ɛ p o k ə	 'ə p o k ə 
A	'ə	 ə 
voler	v o l 'ə	 v o l 'e 
sentiment	s ə n t i m 'e n t	 s 'ɛ n t i m 'e n t 
interessants	i n t ə ɾ ə s 'a n s	 i n t ə ɾ ə s 'a n t s 
cintura	s i n t 'u ɾ ə	 s 'i n t 'u ɾ ə 
butxaca	b u t ʃ 'a k ə	 b 'u t ʃ 'a k ə 
bombes	b 'o m b ə s	 b 'ɔ m b ə s 
Soc	s 'o k	 s 'ɔ k 
Parlament	p ə ɾ l ə m 'e n t	 p 'a ɾ l ə m 'e n t 
èpoques	'ɛ p o k ə s	 'ə p o k ə s 
transports	t ɾ ə n s p 'ɔ ɾ s	 t ɾ ə n s p 'o ɾ t s 
teves	t 'e v ə s	 t 'ə v ə s 
quarts	k w 'a ɾ s	 k w 'a ɾ t s 
presenten	p ɾ ə z 'e n t ə n	 p ɾ ə z 'ə n t ə n 
pintura	p i n t 'u ɾ ə	 p 'i n t 'u ɾ ə 
perd	p 'ɛ ɾ t	 p 'ɛ ɾ i 
ordre	'o ɾ ð ɾ ə	 'ɔ ɾ ð ɾ ə 
fotos	f 'o t o s	 f 'ɔ t o s 
esport	ə s p 'ɔ ɾ t	 ə s p 'o ɾ t 
equipament	ə k i p ə m 'e n t	 ə k 'i p ə m 'e n t 
deixo	d 'e ʃ o	 d 'ɛ ʃ o 
cadascun	k ə ð ə s k 'u n	 k 'a ð ə s k 'u n 
Sento	s 'e n t o	 s 'ɛ n t o 
Faig	f 'a t ʃ	 f 'a j ə 
Departament	d ə p ə ɾ t ə m 'e n t	 d ə p 'a ɾ t ə m 'e n t 
Conca	k 'o ŋ k ə	 k 'ɔ ŋ k ə 
visitants	v i z i t 'a n s	 v i z i t 'a n t s 
tants	t 'a n s	 t 'a n t s 
sentin	s 'e n t i n	 s 'ɛ n t i n 
segles	s 'e g g l ə s	 s 'ə ɣ l ə s 
representen	r ə p ɾ ə z 'e n t ə n	 r ə p ɾ ə z 'ə n t ə n 
regles	r 'e g g l ə s	 r 'ə ɣ l ə s 
reconeixement	r ə k o n ə ʃ ə m 'e n t	 r ə k o n 'ə ʃ ə m 'e n t 
pèl	p 'ə l	 p 'ɛ l 
provoca	p ɾ o v 'o k ə	 p ɾ o v 'ɔ k ə 
premsa	p ɾ 'e n s ə	 p ɾ 'ə m z ə 
port	p 'ɔ ɾ t	 p 'o ɾ t 
metge	m 'e d ʒ ə	 m 'ə d ʒ ə 
lluitar	ʎ u j t 'a	 ʎ u i t 'a 
immens	i m m 'ə n s	 i m m 'e n s 
fragment	f ɾ ə m m 'e n t	 f ɾ 'a m m 'e n t 
estructures	ə s t ɾ u t t 'u ɾ ə s	 ə s t ɾ 'u t t 'u ɾ ə s 
enorme	ə n 'o ɾ m ə	 ə n 'ɔ ɾ m ə 
elfs	'ɛ l t s	 'ɛ l i s 
créixer	k ɾ 'e ʃ ə	 k ɾ 'e ʃ 'e  
continguts	k o n t i ŋ g 'u t s	 k o n t 'i ŋ g 'u t s 
conceptes	k o n s 'ɛ t t ə s	 k o n s 'ə t t ə s 
començament	k o m ə n s ə m 'e n t	 k o m 'ɛ n s ə m 'e n t 
caigut	k ə j ɣ 'u t	 k 'a j ɣ 'u t 
atendre	ə t 'e n d ɾ ə	 ə t 'ə n d ɾ ə 
Totes	t 'o t ə s	 t 'ɔ t ə s 
Boi	b 'ɔ j	 b 'o i 
Com	k 'ɔ m	 k 'o m 
volgut	v o l ɣ 'u t	 v 'ɔ l ɣ 'u t 
ull	'u j	 'u ʎ 
tornes	t 'o ɾ n ə s	 t 'ɔ ɾ n ə s 
tinguessin	t i ŋ g 'e s i n	 t i ŋ g 'ə s i n 
telèfons	t ə l 'ə f o n s	 t ə l 'ə f 'o n s 
sèries	s 	 s 'ɛ ɾ i ə s 
saps	s 'a t s	 s 'a p s 
pèls	p 'ə l s	 p 'ɛ l s 
passatger	p ə s ə d ʒ 'e	 p ə s 'a d ʒ 'e 
mots	m 'o t s	 m 'ɔ t s 
moto	m 'o t o	 m 'ɔ t o 
mot	m 'o t	 m 'ɔ t 
moribund	m o ɾ i β 'u n t	 m o ɾ i β 'u n d 
m'hi	m i	 m 'a 
llest	ʎ 'e s t	 ʎ 'ə s t 
llengües	ʎ 'e ŋ g w ə s	 ʎ 'ə ŋ g w ə s 
fixament	f i t s ə m 'e n t	 f 'i t s ə m 'e n t 
enmig	ə m m 'i t ʃ	 ə n m 'i k 
creixement	k ɾ ə ʃ ə m 'e n t	 k ɾ 'ɛ ʃ ə m 'e n t 
creador	k ɾ e ə ð 'o	 k ɾ ə ə ð 'o 
contes	k 'o n t ə s	 k 'ɔ n t ə s 
consultes	k o n s 'u l t ə s	 k 'o n s 'u l t ə s 
concepte	k o n s 'ɛ t t ə	 k o n s 'ə t t ə 
Tremp	t ɾ 'e m p	 t ɾ 'ə m p 
Pesa	p 'e z ə	 p 'ə z ə 
Molts	m 'o l s	 m 'o l t s 
Fes	f 'e s	 f 'ə s 
Cristina	k ɾ i s t 'i n ə	 k ɾ 'i s t 'i n ə 
éssers	'e s ə s	 'e s 'e s 
èxits	'ə t s i t s	  e t s i t s 
En	'ə n	 ə n 
sants	s 'a n s	 s 'a n t s 
realitzen	r e ə l 'i d z ə n	 r ə ə l 'i d z ə n 
raig	r 'a t ʃ	 r 'a 'i ə 
preguntava	p ɾ ə ɣ u n t 'a v ə	 p ɾ ə ɣ 'u n t 'a v ə 
plataforma	p l ə t ə f 'o ɾ m ə	 p l ə t ə f 'ɔ ɾ m ə 
plantejament	p l ə n t ə ʒ ə m 'e n t	 p l ə n t 'ɛ ʒ ə m 'e n t 
pensament	p ə n s ə m 'e n t	 p 'ə n s ə m 'e n t 
peatges	p e 'a d ʒ ə s	 p ə 'a d ʒ ə s 
morts	m 'ɔ ɾ s	 m 'o ɾ t s 
menja	m 'e n ʒ ə	 m 'ə n ʒ ə 
mateixes	m ə t 'e ʃ ə s	 m ə t 'ə ʃ ə s 
intento	i n t 'e n t o	 i n t 'ɛ n t o 
intenten	i n t 'e n t ə n	 i n t 'ə n t ə n 
iniciativa	i n i s i ə t 'i v ə	 i n i s 'i ə t 'i v ə 
fruits	f ɾ 'u j t s	 f ɾ 'u 'i t s 
enormes	ə n 'o ɾ m ə s	 ə n 'ɔ ɾ m ə s 
currículum	k u r 'i k u l u m	 k u r 'i k u l 'u m 
cultures	k u l t 'u ɾ ə s	 k 'u l t 'u ɾ ə s 
corre	k 'o r ə	 k 'ɔ r ə 
copes	k 'o p ə s	 k 'ɔ p ə s 
consulta	k o n s 'u l t ə	 k 'o n s 'u l t ə 
comportament	k o m p o ɾ t ə m 'e n t	 k o m p 'ɔ ɾ t ə m 'e n t 
cinturó	s i n t u ɾ 'o	 s i n t 'u ɾ 'o 
casament	k ə z ə m 'e n t	 k 'a z ə m 'e n t 
bombers	b o m b 'e s	 b 'o m b 'e s 
alcohol	ə l k o 'ɔ l	 ə l k o 'a l 
Torna	t 'o ɾ n ə	 t 'ɔ ɾ n ə 
Eren	'e ɾ ə n	 'ɛ ɾ ə n 
Antoni	ə n t 'ɔ n i	 ə n t 'o n i 
èxit	'ə t s i t	  e t s i t 
vivendes	v i v 'e n d ə s	 v i v 'ə n d ə s 
vivenda	v i v 'e n d ə	 v i v 'ə n d ə 
tornen	t 'o ɾ n ə n	 t 'ɔ ɾ n ə n 
tement	t ə m 'e n t	 t 'e m 'e n t 
suportar-ho	s u p o ɾ t 'a ɾ o	 s u p o ɾ t 'a ɾ i 
sisè	s i z 'ə	 s i s 'ə 
rèptil	r 'ə t t i l	 r 'ɛ t t i l 
resistit	r ə z i s t 'i t	 r ə z 'i s t 'i t 
repte	r 'ɛ t t ə	 r 'ə t t ə 
recents	r ə s 'e n s	 r ə s 'e n t s 
preguntem	p ɾ ə ɣ u n t 'ə m	 p ɾ ə ɣ 'u n t 'ə m 
preguntat	p ɾ ə ɣ u n t 'a t	 p ɾ ə ɣ 'u n t 'a t 
poesia	p o ə z 'i ə	 p o ə s 'i ə 
plàncton	p l 'a ŋ t t o n	 p l 'a n t t 'o n 
parlament	p ə ɾ l ə m 'e n t	 p 'a ɾ l ə m 'e n t 
neboda	n ə β 'o ð ə	 n ə β 'ɔ ð ə 
lo	l 'o	 l o 
llop	ʎ 'o p	 ʎ 'ɔ p 
llagosta	ʎ ə ɣ 'o s t ə	 ʎ ə ɣ 'ɔ s t ə 
jersei	ʒ ə ɾ s 'ə j	 ʒ ə ɾ s 'ə i 
intens	i n t 'ə n s	 i n t 'e n s 
herois	ə ɾ 'ɔ j s	 ə ɾ 'o i s 
gotes	g 'o t ə s	 g 'ɔ t ə s 
gota	g 'o t ə	 g 'ɔ t ə 
glop	g l 'o p	 g l 'ɔ p 
fuet	f u 'ə t	 f 'u 'ə t 
fosques	f 'o s k ə s	 f 'ɔ s k ə s 
fetge	f 'e d ʒ ə	 f 'ə d ʒ ə 
esports	ə s p 'ɔ ɾ s	 ə s p 'o ɾ t s 
esmorteïts	ə z m o ɾ t ə 'i t s	 ə z m o ɾ t ə 'i s 
escriptura	ə s k ɾ i t t 'u ɾ ə	 ə s k ɾ 'i t t 'u ɾ ə 
endarrere	ə n d ə r 'e ɾ ə	 ə n d ə r 'ɛ ɾ ə 
encreuament	ə ŋ k ɾ ə w ə m 'e n t	 ə ŋ k ɾ 'ə w ə m 'e n t 
encendre	ə n s 'e n d ɾ ə	 ə n s 'ə n d ɾ ə 
donen	d 'o n ə n	 d 'ɔ n ə n 
dimonis	d i m 'ɔ n i s	 d i m 'o n i s 
deuen	d 'ə w ə n	 d 'ɛ w ə n 
detingut	d ə t i ŋ g 'u t	 d ə t 'i ŋ g 'u t 
descens	d ə t s 'ə n s	 d ə s k 'e n s 
corbes	k 'o ɾ β ə s	 k 'ɔ ɾ β ə s 
concerts	k o n s 'ɛ ɾ s	 k o n s 'ɛ ɾ t s 
compro	k 'o m p ɾ o	 k 'ɔ m p ɾ o 
circuit	s i ɾ k 'u j t	 s 'i ɾ k 'u j t 
argument	ə ɾ ɣ u m 'e n t	 'a ɾ ɣ u m 'e n t 
aliment	ə l i m 'e n t	 'a l i m 'e n t 
agenda	ə ʒ 'e n d ə	 ə ʒ 'ɛ n d ə 
Sants	s 'a n s	 s 'a n t s 
Respecte	r ə s p 'ɛ t t ə	 r ə s p 'ə t t ə 
Res	r 'ɛ s	 r 'ə s 
Londres	l 'o n d ɾ ə s	 l 'ɔ n d ɾ ə s 
Jaén	ʒ ə 'e n	 ʒ 'a 'e n 
Intento	i n t 'e n t o	 i n t 'ɛ n t o 
Huelva	u 'ɛ l v ə	 ə 'ɛ l v ə 
Horts	'ɔ ɾ s	 ə ɾ t s 
Deixo	d 'e ʃ o	 d 'ɛ ʃ o 
o	'ɔ	 'o 
vianants	v i ə n 'a n s	 v i ə n 'a n t s 
urgent	u ɾ ʒ 'e n t	 'u ɾ ʒ 'e n t 
transparents	t ɾ ə n s p ə ɾ 'e n s	 t ɾ ə n s p ə ɾ 'e n t s 
testimonis	t ə s t i m 'ɔ n i s	 t ə s t i m 'o n i s 
te	t 'ə	 t ə 
sencera	s ə n s 'ə ɾ ə	 s ə n s 'e ɾ ə 
rècord	r 'ə k o ɾ t	 r 'ɛ k o ɾ t 
retrobo	r ə t ɾ 'o β o	 r ə t ɾ 'ɔ β o 
renda	r 'e n d ə	 r 'ə n d ə 
profund	p ɾ o f 'u n t	 p ɾ o f 'u n d 
patiment	p ə t i m 'e n t	 p 'a t i m 'e n t 
parer	p ə ɾ 'ə	 p ə ɾ 'e 
oberts	o β 'ɛ ɾ s	 o β 'ɛ ɾ t s 
missatgeria	m i s ə d ʒ ə ɾ 'i ə	 m i s 'a d ʒ ə ɾ 'i ə 
menjo	m 'e n ʒ o	 m 'ɛ n ʒ o 
mantenen	m ə n t 'e n ə n	 m ə n t 'ə n ə n 
malestar	m ə l ə s t 'a	 m 'a l ə s t 'a 
lleixa	ʎ 'e ʃ ə	 ʎ 'ə ʃ ə 
instrument	i n s t ɾ u m 'e n t	 'i n s t ɾ u m 'e n t 
gruixudes	g ɾ u ʃ 'u ð ə s	 g ɾ 'u ʃ 'u ð ə s 
goig	g 'ɔ t ʃ	 g 'ɔ 'i ə 
foscos	f 'o s k o s	 f 'ɔ s k o s 
forts	f 'ɔ ɾ s	 f 'o ɾ t s 
foren	f 'o ɾ ə n	 f 'ɔ ɾ ə n 
estrangers	ə s t ɾ ə n ʒ 'e s	 ə s t ɾ 'a ŋ g 'e s 
esperen	ə s p 'e ɾ ə n	 ə s p 'ɛ ɾ ə n 
enginyers	ə n ʒ i ɲ 'e s	 ə n ʒ 'i ɲ 'e s 
empleats	ə m p l e 'a t s	 ə m p l 'e 'a t s 
element	ə l ə m 'e n t	 'ə l ə m 'e n t 
dimoni	d i m 'ɔ n i	 d i m 'o n i 
descobriment	d ə s k o β ɾ i m 'e n t	 d ə s k 'ɔ β ɾ i m 'e n t 
departament	d ə p ə ɾ t ə m 'e n t	 d ə p 'a ɾ t ə m 'e n t 
corrents	k o r 'e n s	 k o r 'e n t s 
corren	k 'o r ə n	 k 'ɔ r ə n 
comparseros	k o m p ə ɾ s 'e ɾ o s	 k o m p ə ɾ s 'ɛ ɾ o s 
celebra	s ə l 'e β ɾ ə	 s ə l 'ə β ɾ ə 
caiguda	k ə j ɣ 'u ð ə	 k 'a j ɣ 'u ð ə 
cadascuna	k ə ð ə s k 'u n ə	 k 'a ð ə s k 'u n ə 
bàsquet	b 'a s k ə t	 b 'a s k 'ə t 
bàndols	b 'a n d o l s	 b 'a n d 'ɔ l s 
bateria	b ə t ə ɾ 'i ə	  b e t ə ɾ 'i ə 
adolescent	ə ð o l ə t s 'e n t	 ə ð o l ə s k 'e n t 
Volen	v 'o l ə n	 v 'ɔ l ə n 
Tens	t 'ə n s	 t 'e n s 
Sota	s 'o t ə	 s 'ɔ t ə 
Pontevedra	p o n t ə v 'e ð ɾ ə	 p o n t ə v 'ə ð ɾ ə 
Pels	p 'ə l s	 p 'ɛ l s 
Menjo	m 'e n ʒ o	 m 'ɛ n ʒ o 
Home	'ɔ m o	 ə m ə 
Centre	s 'e n t ɾ ə	 s 'ɛ n t ɾ ə 
voltants	v o l t 'a n s	 v o l t 'a n t s 
volent	v o l 'ɛ n t	 v o l 'e n t 
vehemència	v ə ə m 'ɛ n s i ə	 v e ə m 'ɛ n s i ə 
transforma	t ɾ ə n s f 'o ɾ m ə	 t ɾ ə n s f 'ɔ ɾ m ə 
tortugues	t o ɾ t 'u ɣ ə s	 t 'ɔ ɾ t 'u ɣ ə s 
tornant-se	t o ɾ n 'a n s ə	 t o ɾ n 'a n t s ə 
tonto	t 'o n t o	 t 'ɔ n t o 
testimoni	t ə s t i m 'ɔ n i	 t ə s t i m 'o n i 
tecles	t 'e k l ə s	 t 'ɛ k l ə s 
suplement	s u p l ə m 'e n t	 s 'u p l ə m 'e n t 
subproductes	s u p p ɾ o ð 'u t t ə s	 s u β p ɾ o ð 'u t t ə s 
sopars	s o p 'a s	 s o p 'a ɾ s 
sofre	s 'o f ɾ ə	 s 'ɔ f ɾ ə 
sistema	s i s t 'e m ə	 s i s t 'ə m ə 
sencer	s ə n s 'ə	 s ə n s 'e 
seguiment	s ə ɣ i m 'e n t	 s 'ɛ ɣ i m 'e n t 
ruptura	r u t t 'u ɾ ə	 r 'u t t 'u ɾ ə 
ronda	r 'o n d ə	 r 'ɔ n d ə 
ressona	r ə s 'ɔ n ə	 r ə s 'o n ə 
ressentiment	r ə s ə n t i m 'e n t	 r ə s 'ɛ n t i m 'e n t 
resistint	r ə z i s t 'i n t	 r ə z 'i s t 'i n t 
rere	r 'e ɾ ə	 r 'ɛ ɾ ə 
reformes	r ə f 'o ɾ m ə s	 r ə f 'ɔ ɾ m ə s 
recorre	r ə k 'o r ə	 r ə k 'ɔ r ə 
realitza	r e ə l 'i d z ə	 r ə ə l 'i d z ə 
raonament	r ə o n ə m 'e n t	 r ə 'ɔ n ə m 'e n t 
pàrquing	p 'a ɾ k i ŋ k	 p 'a ɾ k 'i ŋ k 
prèvia	p ɾ 'ə v i ə	 p ɾ 'ɛ v i ə 
prestatgeries	p ɾ ə s t ə d ʒ ə ɾ 'i ə s	 p ɾ ə s t 'a d ʒ ə ɾ 'i ə s 
presses	p ɾ 'e s ə s	 p ɾ 'ə s ə s 
presents	p ɾ ə z 'e n s	 p ɾ ə z 'e n t s 
presento	p ɾ ə z 'e n t o	 p ɾ ə z 'ɛ n t o 
preciosa	p ɾ ə s i 'o z ə	 p ɾ ə s i 'o s ə 
ports	p 'ɔ ɾ s	 p 'o ɾ t s 
poguessin	p o ɣ 'e s i n	 p o ɣ 'ə s i n 
penja	p 'e n ʒ ə	 p 'ə n ʒ ə 
pengen	p 'e n ʒ ə n	 p 'ɛ n ʒ ə n 
passaport	p ə s ə p 'ɔ ɾ t	 p ə s ə p 'o ɾ t 
ordres	'o ɾ ð ɾ ə s	 'ɔ ɾ ð ɾ ə s 
omple	'o m p l ə	 'ɔ m p l ə 
ombres	'o m b ɾ ə s	 'ɔ m b ɾ ə s 
obtinguts	o t t i ŋ g 'u t s	 o t t 'i ŋ g 'u t s 
obtingut	o t t i ŋ g 'u t	 o t t 'i ŋ g 'u t 
naixement	n ə ʃ ə m 'e n t	 n 'a ʃ ə m 'e n t 
mengen	m 'e n ʒ ə n	 m 'ɛ n ʒ ə n 
matrimoni	m ə t ɾ i m 'ɔ n i	 m ə t ɾ i m 'o n i 
lluitava	ʎ u j t 'a v ə	 ʎ u i t 'a v ə 
lletja	ʎ 'e d ʒ ə	 ʎ 'ə d ʒ ə 
lleig	ʎ 'e t ʃ	 ʎ 'ə 'i ə 
llançament	ʎ ə n s ə m 'e n t	 ʎ 'a n s ə m 'e n t 
kafkianes	k ə f k i 'a n ə s	 k ə f i i 'a n ə s 
integrants	i n t ə ɣ ɾ 'a n s	 i n t ə ɣ ɾ 'a n t s 
ideals	i ð e 'a l s	 i ð 'e 'a l s 
hàbits	'a β i t s	 ə β i t s 
grecs	g ɾ 'e t s	 g ɾ 'ə t s 
grec	g ɾ 'e k	 g ɾ 'ɛ k 
grandiosa	g ɾ ə n d i 'o z ə	 g ɾ ə n d i 'o s ə 
golfes	g 'o l f ə s	 g 'ɔ l f ə s 
gespa	ʒ 'e s p ə	 ʒ 'ə s p ə 
gasoil	g ə z 'ɔ j l	 g ə z 'o 'i l 
fronts	f ɾ 'o n s	 f ɾ 'o n t s 
fotre	f 'o t ɾ ə	 f 'ɔ t ɾ ə 
fissura	f i s 'u ɾ ə	 f 'i s 'u ɾ ə 
fem-ho	f 'ɛ m o	 f 'ə m o 
estructura	ə s t ɾ u t t 'u ɾ ə	 ə s t ɾ 'u t t 'u ɾ ə 
espongiformes	ə s p o n ʒ i f 'o ɾ m ə s	 ə s p o n ʒ i f 'ɔ ɾ m ə s 
esmorzen	ə z m 'o ɾ z ə n	 ə z m 'ɔ ɾ z ə n 
escultura	ə s k u l t 'u ɾ ə	 ə s k 'u l t 'u ɾ ə 
escolta	ə s k 'o l t ə	 ə s k 'ɔ l t ə 
escletxa	ə s k l 'e t ʃ ə	 ə s k l 'ə t ʃ ə 
empremtes	ə m p ɾ 'e n t ə s	 ə m p ɾ 'ə m t ə s 
elèctrics	ə l 'ə t t ɾ i t s	 ə l 'ə t t ɾ 'i t s 
dècada	d 'ə k ə ð ə	 d 'ɛ k ə ð ə 
dotant-les	d o t 'a n l ə s	 d o t 'a n d l ə s 
difondre	d i f 'o n d ɾ ə	 d i f 'ɔ n d ɾ ə 
desplaçament	d ə s p l ə s ə m 'e n t	 d ə s p l 'a s ə m 'e n t 
demandants	d ə m ə n d 'a n s	 d ə m ə n d 'a n t s 
curtcircuit	k u ɾ t s i ɾ k 'u j t	 k u ɾ t s 'i ɾ k 'u j t 
criatures	k ɾ i ə t 'u ɾ ə s	 k ɾ 'i ə t 'u ɾ ə s 
creixen	k ɾ 'e ʃ ə n	 k ɾ 'ɛ ʃ ə n 
conscients	k o n t s i 'e n s	 k o n s i 'e n s 
conca	k 'o ŋ k ə	 k 'ɔ ŋ k ə 
comte	k 'o n t ə	 k 'ɔ n t ə 
compren	k 'o m p ɾ ə n	 k 'ɔ m p ɾ ə n 
comissura	k o m i s 'u ɾ ə	 k o m 'i s 'u ɾ ə 
comenten	k o m 'e n t ə n	 k o m 'ə n t ə n 
colze	k 'o l z ə	 k 'ɔ l z ə 
certs	s 'ɛ ɾ s	 s 'ɛ ɾ t s 
ceptre	s 'e t t ɾ ə	 s 'ə t t ɾ ə 
bots	b 'o t s	 b 'ɔ t s 
bosses	b 'o s ə s	 b 'ɔ s ə s 
borsa	b 'o ɾ s ə	 b 'ɔ ɾ s ə 
borda	b 'o ɾ ð ə	 b 'ɔ ɾ ð ə 
bateries	b ə t ə ɾ 'i ə s	  b e t ə ɾ 'i ə s 
avingudes	ə v i ŋ g 'u ð ə s	 ə v 'i ŋ g 'u ð ə s 
assessorament	ə s ə s o ɾ ə m 'e n t	 ə s ə s 'ɔ ɾ ə m 'e n t 
arts	'a ɾ s	 'a ɾ t s 
arreglat	ə r ə g g l 'a t	 ə r ə ɣ l 'a t 
aliens	ə l i 'ə n s	 ə l i 'e n s 
aimara	ə j m 'a ɾ ə	 ə i m 'a ɾ ə 
agafant-me	ə ɣ ə f 'a m m ə	 ə ɣ ə f 'a n t m ə 
accepto	ə t s 'e t t o	 ə t s 'ɛ t t o 
Torre	t 'o r ə	 t 'ɔ r ə 
Tornes	t 'o ɾ n ə s	 t 'ɔ ɾ n ə s 
Tenen	t 'e n ə n	 t 'ə n ə n 
Sabent	s ə β 'ɛ n t	 s ə β 'e n t 
Ribagorça	r i β ə ɣ 'o ɾ s ə	 r i β ə ɣ 'ɔ ɾ s ə 
Regne	r 'e n n ə	 r 'ə n n ə 
Perdoni	p ə ɾ ð 'ɔ n i	 p ə ɾ ð 'o n i 
Mèxic	m 'ə t s i k	 m 'ɛ t s i k 
Mig	m 'i t ʃ	 m 'i k 
Me	m 'ə	 m ə 
Hola	'ɔ l ə	 ə l ə 
Formes	f 'o ɾ m ə s	 f 'ɔ ɾ m ə s 
Escolta	ə s k 'o l t ə	 ə s k 'ɔ l t ə 
Eivissa	ə j v 'i s ə	 ə i v 'i s ə 
Dones	d 'ɔ n ə s	 d 'o n ə s 
Dimecres	d i m 'e k ɾ ə s	 d i m 'ɛ k ɾ ə s 
Del	d 'ə l	 d ə l 
Cultura	k u l t 'u ɾ ə	 k 'u l t 'u ɾ ə 
Celoni	s ə l 'ɔ n i	 s ə l 'o n i 
Volen	v 'o l ə n	 v 'ɔ l ə n 
Hi	'i	 i 
De	d 'ə	 d ə 
xops	ʃ 'o t s	 ʃ 'ɔ t s 
vinguessis	v i ŋ g 'e s i s	 v i ŋ g 'ə s i s 
vents	v 'e n s	 v 'e n t s 
travessar	t ɾ ə v ə s 'a	 t ɾ 'a v ə s 'a 
transbordament	t ɾ ə n z β o ɾ ð ə m 'e n t	 t ɾ ə n z β 'ɔ ɾ ð ə m 'e n t 
tenda	t 'e n d ə	 t 'ɛ n d ə 
subsòl	s u t s 'ɔ l	 s 'u t s 'ɔ l 
sentint-se	s ə n t 'i n s ə	 s ə n t 'i n t s ə 
sens	s 'ə n s	 s 'e n s 
retorna	r ə t 'o ɾ n ə	 r ə t 'ɔ ɾ n ə 
resistir	r ə z i s t 'i	 r ə z 'i s t 'i 
repartiment	r ə p ə ɾ t i m 'e n t	 r ə p 'a ɾ t i m 'e n t 
relacioni	r ə l ə s i 'ɔ n i	 r ə l ə s i 'o n i 
recurrent	r ə k u r 'e n t	 r ə k 'u r 'e n t 
rebuig	r ə β 'u t ʃ	 r ə β 'u ʃ 
procediment	p ɾ o s ə ð i m 'e n t	 p ɾ o s 'ɛ ð i m 'e n t 
pop	p 'o p	 p 'ɔ p 
pesants	p ə z 'a n s	 p ə z 'a n t s 
paviment	p ə v i m 'e n t	 p 'a v i m 'e n t 
ombra	'o m b ɾ ə	 'ɔ m b ɾ ə 
oi	'ɔ j	 'o i 
nèctar	n 'ə t t ə	 n 'ɛ t t 'a 
nerviosisme	n ə ɾ v i o z 'i z m ə	 n ə ɾ v i o s 'i z m ə 
morro	m 'o r o	 m 'ɔ r o 
mirant-lo	m i ɾ 'a n l o	 m i ɾ 'a n d l o 
manifestants	m ə n i f ə s t 'a n s	 m ə n i f ə s t 'a n t s 
lleixes	ʎ 'e ʃ ə s	 ʎ 'ə ʃ ə s 
irrompre	i r 'o m p ɾ ə	 i r 'ɔ m p ɾ ə 
indústria	i n d 'u s t ɾ i ə	 i n d 'u s t ɾ 'i ə 
habitants	ə β i t 'a n s	 ə β i t 'a n t s 
gruixut	g ɾ u ʃ 'u t	 g ɾ 'u ʃ 'u t 
franctirador	f ɾ ə ŋ t t i ɾ ə ð 'o	 f ɾ ə n s t i ɾ ə ð 'o 
fortuna	f o ɾ t 'u n ə	 f 'o ɾ t 'u n ə 
forcés	f o ɾ s 'e s	 f 'o ɾ s 'e s 
fongs	f 'o ŋ s	 f 'o ŋ g s 
fonda	f 'o n d ə	 f 'ɔ n d ə 
fleca	f l 'ɛ k ə	 f l 'ə k ə 
feble	f 'e b b l ə	 f 'ə b b l ə 
estratègies	ə s t ɾ ə t 'ə ʒ i ə s	 ə s t ɾ ə t 'ɛ ʒ i ə s 
esglésies	ə z ɣ l 'e z i ə s	 ə z ɣ l 'e z 'i ə s 
elegants	ə l ə ɣ 'a n s	 ə l ə ɣ 'a n t s 
distendre	d i s t 'e n d ɾ ə	 d i s t 'ɛ n d ɾ ə 
deshidratades	d ə s i ð ɾ ə t 'a ð ə s	 d ə z i ð ɾ ə t 'a ð ə s 
desafiament	d ə z ə f i ə m 'e n t	 d ə z ə f 'i ə m 'e n t 
cuidar	k u j ð 'a	 k u i ð 'a 
criatura	k ɾ i ə t 'u ɾ ə	 k ɾ 'i ə t 'u ɾ ə 
creuen	k ɾ 'ə w ə n	 k ɾ 'ɛ w ə n 
corro	k 'o r o	 k 'ɔ r o 
copa	k 'o p ə	 k 'ɔ p ə 
concentren	k o n s 'e n t ɾ ə n	 k o n s 'ə n t ɾ ə n 
compres	k 'o m p ɾ ə s	 k 'ɔ m p ɾ ə s 
catorzè	k ə t o ɾ z 'ə	 k ə t 'o ɾ z 'ə 
arruinats	ə r u j n 'a t s	 ə r u i n 'a t s 
alineats	ə l i n e 'a t s	 ə l i n 'e 'a t s 
afronta	ə f ɾ 'o n t ə	 ə f ɾ 'ɔ n t ə 
adonant-se	ə ð o n 'a n s ə	 ə ð o n 'a n t s ə 
accepten	ə t s 'ɛ t t ə n	 ə t s 'ə t t ə n 
absort	ə t s 'ɔ ɾ t	 ə t s 'o ɾ t 
Ui	'u j	 'u i 
Tota	t 'o t ə	 t 'ɔ t ə 
Sistema	s i s t 'e m ə	 s i s t 'ə m ə 
Ronda	r 'o n d ə	 r 'ɔ n d ə 
Queda	k 'e ð ə	 k 'ə ð ə 
Port	p 'ɔ ɾ t	 p 'o ɾ t 
Grècia	g ɾ 'ə s i ə	 g ɾ 'ɛ s i ə 
Ginebra	ʒ i n 'e β ɾ ə	 ʒ i n 'ə β ɾ ə 
Foment	f o m 'e n t	 f 'ɔ m 'e n t 
ètniques	'ə n n i k ə s	 'ɛ n n i k ə s 
ètnica	'ə n n i k ə	 'ɛ n n i k ə 
ètnic	'ə n n i k	 'ɛ n n i k 
que	k 'ə	 k ə 
Que	k 'ə	 k ə 
La	l 'ə	 l ə 
En	'ə n	 ə n 
xopa	ʃ 'o p ə	 ʃ 'ɔ p ə 
xop	ʃ 'o p	 ʃ 'ɔ p 
xiïtes	ʃ i 'i t ə s	 ʃ 'i 'i t ə s 
xiïta	ʃ i 'i t ə	 ʃ 'i 'i t ə 
whiskys	b 'i s k i s	 ə 'i s j n s 
vuitens	v u j t 'ə n s	 v u i t 'e n s 
vuitena	v u j t 'ə n ə	 v u i t 'ə n ə 
vudú	v u ð 'u	 v 'u ð 'u 
virtuoses	v i ɾ t u 'o z ə s	 v i ɾ t u 'o s ə s 
vingueren	v i ŋ g 'e ɾ ə n	 v i ŋ g 'ɛ ɾ ə n 
viatgers	v i ə d ʒ 'e s	 v i 'a d ʒ 'e s 
vespres	v 'e s p ɾ ə s	 v 'ə s p ɾ ə s 
valoren	v ə l 'o ɾ ə n	 v ə l 'ɔ ɾ ə n 
vagabund	v ə ɣ ə β 'u n t	 v ə ɣ ə β 'u n d 
urgents	u ɾ ʒ 'e n s	 'u ɾ ʒ 'e n s 
uniforme	u n i f 'o ɾ m ə	 u n i f 'ɔ ɾ m ə 
tèbia	t 'ə β i ə	 t 'ɛ β i ə 
tèbia	t 'ə β i ə	 t 'ɛ β i ə 
txecs	t ʃ 'ɛ t s	 t ʃ 'ə t s 
turment	t u ɾ m 'e n t	 t 'u ɾ m 'e n t 
tsars	t s 'a s	 ə z 'a s 
tronxos	t ɾ 'o n ʃ o s	 t ɾ 'ɔ n ʃ o s 
treuen	t ɾ 'ə w ə n	 t ɾ 'ɛ w ə n 
trepitgés	t ɾ ə p i d ʒ 'e s	 t ɾ ə p 'i d ʒ 'e s 
trepig	t ɾ ə p 'i t ʃ	 t ɾ ə p 'i ə 
travessera	t ɾ ə v ə s 'e ɾ ə	 t ɾ 'a v ə s 'e ɾ ə 
travessem	t ɾ ə v ə s 'ə m	 t ɾ 'a v ə s 'ə m 
travessaves	t ɾ ə v ə s 'a v ə s	 t ɾ 'a v ə s 'a v ə s 
travessarem	t ɾ ə v ə s ə ɾ 'ə m	 t ɾ 'a v ə s ə ɾ 'ə m 
travessant	t ɾ ə v ə s 'a n t	 t ɾ 'a v ə s 'a n t 
trasplantessin	t ɾ ə s p l ə n t 'e s i n	 t ɾ ə s p l ə n t 'ə s i n 
transvasament	t ɾ ə n z v ə z ə m 'e n t	 t ɾ ə n z v 'a z ə m 'e n t 
transmetent-me	t ɾ ə n z m ə t 'e m m ə	 t ɾ ə n z m ə t 'ə n t m ə 
transcorre	t ɾ ə n s k 'o r ə	 t ɾ ə n s k 'ɔ r ə 
traficants	t ɾ ə f i k 'a n s	 t ɾ ə f i k 'a n t s 
tractament	t ɾ ə t t ə m 'e n t	 t ɾ 'a t t ə m 'e n t 
tova	t 'o v ə	 t 'ɔ v ə 
totxo	t 'o t ʃ o	 t 'ɔ t ʃ o 
totes	t 'o t ə s	 t 'ɔ t ə s 
tot	t 'o t	 t 'ɔ t 
tossut	t o s 'u t	 t 'o s 'u t 
tossuda	t o s 'u ð ə	 t 'o s 'u ð ə 
tortures	t o ɾ t 'u ɾ ə s	 t 'ɔ ɾ t 'u ɾ ə s 
tortuga	t o ɾ t 'u ɣ ə	 t 'ɔ ɾ t 'u ɣ ə 
torre	t 'o r ə	 t 'ɔ r ə 
torero	t o ɾ 'e ɾ o	 t o ɾ 'ɛ ɾ o 
torba	t 'o ɾ β ə	 t 'ɔ ɾ β ə 
topen	t 'o p ə n	 t 'ɔ p ə n 
tomba	t 'o m b ə	 t 'ɔ m b ə 
tinguent	t i ŋ g 'e n t	 t i ŋ g w 'e n t 
terrenys	t ə r 'ə j n s	 t ə r 'ə ɲ s 
terraqüi	t ə r 'a k w i	 t ə r 'a k i 
tenyint-lo	t ə ɲ 'i n l o	 t ə ɲ 'i n d l o 
tediosa	t ə ð i 'o z ə	 t ə ð i 'o s ə 
te'm	t ə m	 t 'ə m 
te'l	t ə l	 t 'ɛ l 
tartamudejant	t ə ɾ t ə m u ð ə ʒ 'a n t	 t ə ɾ t ə m 'u ð ə ʒ 'a n t 
tangents	t ə n ʒ 'e n s	 t 'a ŋ g 'e n s 
tancament	t ə ŋ k ə m 'e n t	 t 'a ŋ k ə m 'e n t 
súpers	s 'u p ə s	 s 'u p 'e s 
successos	s u t s 'e s o s	 s u t s 'ə s o s 
subsidi	s u t s 'i ð i	 s 'u ə s 'i ð i 
subhasta	s u β 'a s t ə	 s u β i 'a s t ə 
sostinguda	s o s t i ŋ g 'u ð ə	 s o s t 'i ŋ g 'u ð ə 
sosteniment	s o s t ə n i m 'e n t	 s o s t 'ɛ n i m 'e n t 
sospesen	s o s p 'e z ə n	 s o s p 'ə z ə n 
sorrut	s o r 'u t	 s 'o r 'u t 
sorna	s 'o ɾ n ə	 s 'ɔ ɾ n ə 
sopes	s 'o p ə s	 s 'ɔ p ə s 
sopen	s 'o p ə n	 s 'ɔ p ə n 
sopa	s 'o p ə	 s 'ɔ p ə 
solters	s o l t 'e s	 s 'ɔ l t 'e s 
sofriment	s o f ɾ i m 'e n t	 s 'ɔ f ɾ i m 'e n t 
silencioses	s i l ə n s i 'o z ə s	 s i l ə n s i 'o s ə s 
silenciosa	s i l ə n s i 'o z ə	 s i l ə n s i 'o s ə 
servents	s ə ɾ v 'e n s	 s ə ɾ v 'e n t s 
serens	s ə ɾ 'ə n s	 s ə ɾ 'e n s 
ser-ho	s 'e ɾ o	 s 'ɛ ɾ o 
ser-hi	s 'e ɾ i	 s 'ɛ ɾ i 
sents	s 'e n s	 s 'e n t s 
sentis	s 'e n t i s	 s 'ɛ n t i s 
sentint-me	s ə n t 'i m m ə	 s ə n t 'i n t m ə 
senten	s 'e n t ə n	 s 'ə n t ə n 
sempre	s 'e m p ɾ ə	 s 'ə m p ɾ ə 
semblessin	s ə m b l 'e s i n	 s ə m b l 'ə s i n 
seleccionar-ho	s ə l ə t s i o n 'a ɾ o	 s ə l ə t s i o n 'a ɾ i 
seitons	s ə j t 'o n s	 s ə i t 'o n s 
secs	s 'ɛ t s	 s 'ə t s 
sapiens	s ə p i 'ə n s	 s ə p i 'e n s 
salts	s 'a l s	 s 'a l t s 
salpebra	s ə l p 'e β ɾ ə	 s ə l p 'ə β ɾ ə 
sahrauí	s ə ɾ ə w 'i	 s ə ɲ ə w 'i 
rètols	r 'ɛ t o ls	 r 'ə t o l s 
règim	r 'ə ʒ i m	 r 'ɛ ʒ i m 
rugositat	r u ɣ o z i t 'a t	 r 'u ɣ o z i t 'a t 
rotonda	r o t 'o n d ə	 r o t 'ɔ n d ə 
rosses	r 'o s ə s	 r 'ɔ s ə s 
ronden	r 'o n d ə n	 r 'ɔ n d ə n 
ronca	r 'o ŋ k ə	 r 'ɔ ŋ k ə 
rodejant-ne	r o ð ə ʒ 'a n n ə	 r o ð ə ʒ 'a n n n ə 
retard	r ə t 'a ɾ t	 r ə t 'a ɾ ə 
respecto	r ə s p 'e t t o	 r ə s p 'ɛ t t o 
respectessin	r ə s p ə t t 'e s i n	 r ə s p ə t t 'ə s i n 
resistia	r ə z i s t 'i ə	 r ə z 'i s t 'i ə 
resen	r 'e z ə n	 r 'ə z ə n 
res	r 'ɛ s	 r 'ə s 
reptes	r 'ɛ t t ə s	 r 'ə t t ə s 
reproduint-la	r ə p ɾ o ð u 'i n l ə	 r ə p ɾ o ð 'u i n d l ə 
renoven	r ə n 'o v ə n	 r ə n 'ɔ v ə n 
renecs	r ə n 'e t s	 r ə n 'ə t s 
rendiment	r ə n d i m 'e n t	 r 'ɛ n d i m 'e n t 
rencontre	r ə ŋ k 'o n t ɾ ə	 r ə ŋ k 'ɔ n t ɾ ə 
renaixentistes	r ə n ə ʃ ə n t 'i s t ə s	 r ə n 'a ʃ ə n t 'i s t ə s 
religioses	r ə l i ʒ i 'o z ə s	 r ə l i ʒ i 'o s ə s 
reintegrament	r ə i n t ə ɣ ɾ ə m 'e n t	 r ə i n t 'ə ɣ ɾ ə m 'e n t 
reiniciarà	r ə i n i s i ə ɾ 'a	 r ə i n i s i 'a ɾ 'a 
regne	r 'e n n ə	 r 'ə n n ə 
regla	r 'e g g l ə	 r 'ə ɣ l ə 
refrescants	r ə f ɾ ə s k 'a n s	 r ə f ɾ ə s k 'a n t s 
refredament	r ə f ɾ ə ð ə m 'e n t	 r ə f ɾ 'ə ð ə m 'e n t 
referents	r ə f ə ɾ 'e n s	 r ə f ə ɾ 'e n t s 
redimensioni	r ə ð i m ə n s i 'ɔ n i	 r ə ð i m ə n s i 'o n i 
recorren	r ə k 'o r ə n	 r ə k 'ɔ r ə n 
reconeixent-ne	r ə k o n ə ʃ 'e n n ə	 r ə k o n ə ʃ 'ɛ n n n ə 
recolzo	r ə k 'o l z o	 r ə k 'ɔ l z o 
recolzament	r ə k o l z ə m 'e n t	 r ə k 'ɔ l z ə m 'e n t 
recolza	r ə k 'o l z ə	 r ə k 'ɔ l z ə 
receptes	r ə s 'ɛ t t ə s	 r ə s 'ə t t ə s 
recents	r ə s 'e n s	 r ə s 'e n t s 
rec	r 'e k	 r 'ɛ k 
rebessin	r ə β 'e s i n	 r ə β 'ə s i n 
realitzo	r e ə l 'i d z o	 r ə ə l 'i d z o 
realisme	r e ə l 'i z m ə	 r ə ə l 'i z m ə 
reafirmin	r e ə f 'i ɾ m i n	 r ə ə f 'i ɾ m i n 
rails	r 'a j l s	 r 'a 'i l s 
quedes	k 'e ð ə s	 k 'ə ð ə s 
quatrecents	k w ə t ɾ ə s 'e n s	 k w ə t ɾ ə s 'e n t s 
psiquiatria	s i k i ə t ɾ 'i ə	 s i k i 'a t ɾ 'i ə 
promocionin	p ɾ o m o s i 'ɔ n i n	 p ɾ o m o s i 'o n 'i n 
preveuen	p ɾ ə v 'ə w ə n	 p ɾ ə v 'ɛ w ə n 
pretendre	p ɾ ə t 'e n d ɾ ə	 p ɾ ə t 'ə n d ɾ ə 
prestatgeria	p ɾ ə s t ə d ʒ ə ɾ 'i ə	 p ɾ ə s t 'a d ʒ ə ɾ 'i ə 
preromàntics	p ɾ ə r o m 'a n t i t s	 p ɾ ə ɾ o m 'a n t i t s 
prengueren	p ɾ ə ŋ g 'e ɾ ə n	 p ɾ ə ŋ g 'ɛ ɾ ə n 
prenent-se	p ɾ ə n 'e n s ə	 p ɾ ə n 'ə n s ə 
premsa	p ɾ 'e n s ə	 p ɾ 'ə m z ə 
preguntem	p ɾ ə ɣ u n t 'ə m	 p ɾ ə ɣ 'u n t 'ə m 
precursors	p ɾ ə k u ɾ s 'o s	 p ɾ ə k 'u s 'o s 
preciosos	p ɾ ə s i 'o z o s	 p ɾ ə s i 'o s o s 
precioses	p ɾ ə s i 'o z ə s	 p ɾ ə s i 'o s ə s 
practicants	p ɾ ə t t i k 'a n s	 p ɾ ə t t i k 'a n t s 
posicioni	p o z i s i 'ɔ n i	 p o z i s i 'o n i 
posant-ne	p o z 'a n n ə	 p o z 'a n n n ə 
porta-me-les	p 'ɔ ɾ t ə m ə l ə s	 p o ɾ t ə m 'ɛ l ə s 
porro	p 'o r o	 p 'ɔ r o 
popes	p 'o p ə s	 p 'ɔ p ə s 
polièdrica	p o l i 'ə ð ɾ i k ə	 p o l i 'ɛ ð ɾ i k ə 
podent	p o ð 'ɛ n t	 p o ð 'e n t 
plumero	p l u m 'e ɾ o	 p l u m 'ɛ ɾ o 
plecs	p l 'ɛ t s	 p l 'ə t s 
planejament	p l ə n ə ʒ ə m 'e n t	 p l ə n d ʒ ə m 'e n t 
planctòniques	p l ə ŋ t t 'ɔ n i k ə s	 p l ə n s t 'ɔ n i k ə s 
pintures	p i n t 'u ɾ ə s	 p 'i n t 'u ɾ ə s 
pertenences	p ə ɾ t ə n 'ɛ n s ə s	 p ə ɾ t ə n 'ə n s ə s 
pertanyés	p ə ɾ t ə ɲ 'e s	 p ə ɾ t 'a ɲ 'e s 
pertanyents	p ə ɾ t ə ɲ 'e n s	 p ə ɾ t 'a ɲ 'e n s 
perruquera	p ə r u k 'e ɾ ə	 p ə r 'u k 'e ɾ ə 
perruquer	p ə r u k 'e	 p ə r 'u k 'e 
perpetren	p ə ɾ p 'e t ɾ ə n	 p ə ɾ p 'ə t ɾ ə n 
peripècia	p ə ɾ i p 'ə s i ə	 p ə ɾ i p 'ɛ s i ə 
perdre-la	p 'ɛ ɾ ð ɾ ə l ə	 p ə ɾ ð ɾ 'ɛ l ə 
perdonant-li	p ə ɾ ð o n 'a n l i	 p ə ɾ ð o n 'a n i l i 
penetren	p ə n 'e t ɾ ə n	 p ə n 'ə t ɾ ə n 
penetrants	p ə n ə t ɾ 'a n s	 p ə n ə t ɾ 'a n t s 
patrimoni	p ə t ɾ i m 'ɔ n i	 p ə t ɾ i m 'o n i 
parèntesis	p ə ɾ 'ɛ n t ə z i s	 p ə ɾ 'ə n t ə z i s 
parcs	p 'a ɾ t s	 p 'a ɾ s i 
paisatgisme	p ə j z ə d ʒ 'i z m ə	 p ə j z 'a d ʒ 'i z m ə 
orienten	o ɾ i 'e n t ə n	 o ɾ i 'ə n t ə n 
operen	o p 'e ɾ ə n	 o p 'ɛ ɾ ə n 
oncle	'o ŋ k l ə	 'ɔ ŋ k l ə 
oloro	o l 'o ɾ o	 o l 'ɔ ɾ o 
obtingudes	o t t i ŋ g 'u ð ə s	 o t t 'i ŋ g 'u ð ə s 
oasi	o 'a z i	 o 'a s i 
nomenament	n o m ə n ə m 'e n t	 n o m 'ə n ə m 'e n t 
nihilistes	n i i l 'i s t ə s	 n i 'a l 'i s t ə s 
nihilista	n i i l 'i s t ə	 n i 'a l 'i s t ə 
netegessin	n ə t ə ʒ 'e s i n	 n ə t ə ʒ 'ɛ s i n 
nedes	n 'e ð ə s	 n 'ə ð ə s 
neden	n 'e ð ə n	 n 'ə ð ə n 
neanderthalensis	n e ə n d ə ɾ t ə l 'ɛ n s i s	 n e ə n d 'e ɾ t 'a l 'ɛ n s i s 
mítings	m 'i t i ŋ s	 m 'i t i ŋ g s 
multiètnica	m u l t i 'ə n n i k ə	 m u l t i 'ɛ n n i k ə 
mosso	m 'o s o	 m 'ɔ s o 
mosca	m 'o s k ə	 m 'ɔ s k ə 
morses	m 'o ɾ s ə s	 m 'ɔ ɾ s ə s 
morros	m 'o r o s	 m 'ɔ r o s 
mon	m 'o n	 m o n 
molècules	m o l 'ə k u l ə s	 m o l 'ɛ k u l ə s 
mofant-se	m o f 'a n s ə	 m o f 'a n t s ə 
moc	m 'o k	 m 'ɔ k 
migcampistes	m i k k ə m p 'i s t ə s	 m i ŋ k ə m p 'i s t ə s 
metros	m 'e t ɾ o s	 m 'ə t ɾ o s 
mesurament	m ə z u ɾ ə m 'e n t	 m ə z 'u ɾ ə m 'e n t 
megahertzos	m ə ɣ ə 'ɛ ɾ d z o s	 m 'ə ɣ ə m ɾ d z o s 
materialisme	m ə t ə ɾ i ə l 'i z m ə	 m ə t ə ɾ 'i ə l 'i z m ə 
marxessin	m ə ɾ ʃ 'e s i n	 m ə ɾ ʃ 'ɛ s i n 
marihuana	m ə ɾ i u 'a n ə	 m 'a ɾ i ə 'a n ə 
mantingut	m ə n t i ŋ g 'u t	 m ə n t 'i ŋ g 'u t 
mantinguda	m ə n t i ŋ g 'u ð ə	 m ə n t 'i ŋ g 'u ð ə 
maltractaments	m ə l t ɾ ə t t ə m 'e n s	 m ə l t ɾ ə t t ə m 'e n t s 
malalts	m ə l 'a l s	 m ə l 'a l t s 
majestuosa	m ə ʒ ə s t u 'o z ə	 m ə ʒ ə s t u 'o s ə 
ma	m 'ə	 m ə 
líder	l 'i ð ə	 l 'i ð e  
lluirà	ʎ u i ɾ 'a	 ʎ u j ɾ 'a 
llistí	ʎ i s t 'i	 ʎ 'i s t 'i 
lletrejar	ʎ ə t ɾ ə ʒ 'a	 ʎ 'ə t ɾ ə ʒ 'a 
llesta	ʎ 'e s t ə	 ʎ 'ə s t ə 
llenya	ʎ 'e ɲ ə	 ʎ 'ə ɲ ə 
llengües	ʎ 'e ŋ g w ə s	 ʎ 'ə ŋ g w ə s 
llegendes	ʎ ə ʒ 'e n d ə s	 ʎ ə ʒ 'ə n d ə s 
llambordes	ʎ ə m b 'o ɾ ð ə s	 ʎ ə m b 'ɔ ɾ ð ə s 
litosfera	l i t o s f 'e ɾ ə	 l 'i t o s f 'e ɾ ə 
lepra	l 'e p ɾ ə	 l 'ə p ɾ ə 
lamento	l ə m 'e n t o	 l ə m 'ɛ n t o 
kafkiana	k ə f k i 'a n ə	 k ə f i i 'a n ə 
justificants	ʒ u s t i f i k 'a n s	 ʒ u s t i f i k 'a n t s 
jurament	ʒ u ɾ ə m 'e n t	 ʒ 'u ɾ ə m 'e n t 
jueva	ʒ u 'e v ə	 ʒ u 'ə v ə 
jamaicans	ʒ ə m ə j k 'a n s	 ʒ ə m ə i k 'a n s 
itinerants	i t i n ə ɾ 'a n s	 i t i n ə ɾ 'a n t s 
intèrpret	i n t 'ɛ ɾ p ɾ ə t	 i n t 'ɛ ɾ p ɾ 'ə t 
interrompre	i n t ə r 'o m p ɾ ə	 i n t ə r 'ɔ m p ɾ ə 
interrogant-los	i n t ə r o ɣ 'a n l o s	 i n t ə r o ɣ 'a n d l o s 
interpretant-la	i n t ə ɾ p ɾ ə t 'a n l ə	 i n t ə ɾ p ɾ ə t 'a n d l ə 
intentar-ho	i n t ə n t 'a ɾ o	 i n t ə n t 'a ɾ i 
insatisfets	i n s ə t i s f 'ə t s	 i n s 'a t i s f 'ə t s 
insatisfeta	i n s ə t i s f 'ə t ə	 i n s 'a t i s f 'ə t ə 
insatisfacció	i n s ə t i s f ə t s i 'o	 i n s 'a t i s f ə t s i 'o 
inquietud	i ŋ k i ə t 'u t	 i ŋ k 'i ə t 'u t 
ingresses	i ŋ g ɾ 'e s ə s	 i ŋ g ɾ 'ə s ə s 
indulgent	i n d u l ʒ 'e n t	 i n d 'u l ʒ 'e n t 
indescriptible	i n d ə s k ɾ i t t 'i b b l ə	 i n d ə s k ɾ 'i t t 'i b b l ə 
incoherents	i ŋ k o ə ɾ 'e n s	 i ŋ k o ə ɾ 'e n t s 
incerts	i n s 'ɛ ɾ s	 i n s 'ɛ ɾ t s 
impressionants	i m p ɾ ə s i o n 'a n s	 i m p ɾ ə s i o n 'a n t s 
import	i m p 'ɔ ɾ t	 i m p 'o ɾ t 
imbècil	i m b 'ə s i l	 i m b 'ɛ s i l 
ignoren	i n n 'o ɾ ə n	 i n n 'ɔ ɾ ə n 
idoni	i ð 'ɔ n i	 i ð 'o n i 
ideat	i ð e 'a t	 i ð 'e 'a t 
hòstia	'ɔ s t i ə	 ə s t i ə 
híbrid	'i β ɾ i t	 ə β ɾ i t 
hàbit	'a β i t	 ə β i t 
horts	'ɔ ɾ s	 ə ɾ t s 
hora	'ɔ ɾ ə	 ə ɾ ə 
hola	'ɔ l ə	 ə l ə 
harmonioses	ə ɾ m o n i 'o z ə s	 ə ɾ m o n i 'o s ə s 
haguessis	ə ɣ 'e s i s	 ə ɣ 'ə s i s 
haguessin	ə ɣ 'e s i n	 ə ɣ 'ə s i n 
hagis	'a ʒ i s	 ə ʒ i s 
guspires	g u s p 'i ɾ ə s	 g 'u s p 'i ɾ ə s 
guspira	g u s p 'i ɾ ə	 g 'u s p 'i ɾ ə 
guinda	g 'i n d ə	 g w 'i n d ə 
guetos	g 'e t o s	 g 'ə t o s 
guard	g w 'a ɾ t	 g w 'a ɾ ə 
guanyant-me	g w ə ɲ 'a m m ə	 g w ə ɲ 'a n t m ə 
greixos	g ɾ 'e ʃ o s	 g ɾ 'ɛ ʃ o s 
golfo	g 'o l f o	 g 'ɔ l f o 
generen	ʒ ə n 'e ɾ ə n	 ʒ ə n 'ɛ ɾ ə n 
gemecs	ʒ ə m 'e t s	 ʒ ə m 'ə t s 
gemec	ʒ ə m 'e k	 ʒ ə m 'ɛ k 
fuig	f 'u t ʃ	 f 'u ʃ 
frens	f ɾ 'ə n s	 f ɾ 'e n s 
fots	f 'o t s	 f 'ɔ t s 
fotre-li	f 'o t ɾ ə l i	 f o t ɾ 'ɛ l i 
fot	f 'o t	 f 'ɔ t 
forestal	f o ɾ ə s t 'a l	 f 'o ɾ ə s t 'a l 
forasters	f o ɾ ə s t 'e s	 f 'o ɾ ə s t 'e s 
foques	f 'o k ə s	 f 'ɔ k ə s 
fluïdesa	f l u i ð 'ə z ə	 f l u 'i ð 'ə z ə 
florint-se	f l o ɾ 'i n s ə	 f l o ɾ 'i n t s ə 
fletxes	f l 'e t ʃ ə s	 f l 'ə t ʃ ə s 
fletxa	f l 'e t ʃ ə	 f l 'ə t ʃ ə 
fiquessin	f i k 'e s i n	 f i k 'ə s i n 
fetus	f 'ɛ t u s	 f 'ə t u s 
fer-hi	f 'e ɾ i	 f 'ɛ ɾ i 
fent-se	f 'e n s ə	 f 'ɛ n s ə 
fent-lo	f 'e n l o	 f 'ɛ n d l o 
fen	f 'e n	 f 'ə n 
feixos	f 'e ʃ o s	 f 'ɛ ʃ o s 
fecundés	f ə k u n d 'e s	 f ə k 'u n d 'e s 
evolucioni	ə v o l u s i 'ɔ n i	 ə v o l u s i 'o n i 
estómac	ə s t 'o m ə k	 ə s t 'o m 'a k 
estudiïn	ə s t u ð 'i i n	 ə s t u ð 'i 'i n 
estrèpit	ə s t ɾ 'ə p i t	 ə s t ɾ 'ɛ p i t 
estris	'ɛ s t ɾ i s	 'ə s t ɾ i s 
estrenyent-me	ə s t ɾ ə ɲ 'e m m ə	 ə s t ɾ ə ɲ 'ə n t m ə 
estratègia	ə s t ɾ ə t 'ə ʒ i ə	 ə s t ɾ ə t 'ɛ ʒ i ə 
estimant-la	ə s t i m 'a n l ə	 ə s t i m 'a n d l ə 
esport	ə s p 'ɔ ɾ t	 ə s p 'o ɾ t 
esplèndid	ə s p l 'ə n d i t	 ə s p l 'ɛ n d i t 
esment	ə z m 'e n t	 'e z m 'e n t 
esgrogueït	ə z ɣ ɾ o ɣ ə 'i t	 ə z ɣ ɾ o ɣ u 'e 'i t 
esgrogueint-se	ə z ɣ ɾ o ɣ ə 'i n s ə	 ə z ɣ ɾ o ɣ u z 'i n t s ə 
esdeveniment	ə z ð ə v ə n i m 'e n t	 ə z ð ə v 'ɛ n i m 'e n t 
escultures	ə s k u l t 'u ɾ ə s	 ə s k 'u l t 'u ɾ ə s 
escrivint-te	ə s k ɾ i v 'i n t ə	 ə s k ɾ i v 'i n t t ə 
escombra	ə s k 'o m b ɾ ə	 ə s k 'ɔ m b ɾ ə 
escolto	ə s k 'o l t o	 ə s k 'ɔ l t o 
escoltes	ə s k 'o l t ə s	 ə s k 'ɔ l t ə s 
esclafant-les	ə s k l ə f 'a n l ə s	 ə s k l ə f 'a n d l ə s 
escalfament	ə s k ə l f ə m 'e n t	 ə s k 'a l f ə m 'e n t 
escaigui	ə s k 'a j ɣ i	 ə s k 'a i ɣ i 
esbufegués	ə z β u f ə ɣ 'e s	 ə z β 'u f ə ɣ 'e s 
esbiaixada	ə z β i ə ʃ 'a ð ə	 ə z β i 'a ʃ 'a ð ə 
enuig	ə n 'u t ʃ	 ə n 'u ʃ 
entretinguda	ə n t ɾ ə t i ŋ g 'u ð ə	 ə n t ɾ ə t 'i ŋ g 'u ð ə 
entremaliadures	ə n t ɾ ə m ə l i ə ð 'u ɾ ə s	 ə n t ɾ ə m ə l 'i ə ð 'u ɾ ə s 
ensenyi	ə n s 'ɛ ɲ i	 ə n s 'ə ɲ i 
ensenyament	ə n s ə ɲ ə m 'e n t	 ə n s 'ə ɲ ə m 'e n t 
enginys	ə n ʒ 'i j n s	 ə n ʒ 'i ɲ s 
endreço	ə n d ɾ 'e s o	 ə n d ɾ 'ə s o 
enclavament	ə ŋ k l ə v ə m 'e n t	 ə ŋ k l 'a v ə m 'e n t 
empentes	ə m p 'ə n t ə s	 ə m p 'e n t ə s 
empenta	ə m p 'ə n t ə	 ə m p 'e n t ə 
emborratxant-me	ə m b o r ə t ʃ 'a m m ə	 ə m b o r 'a t ʃ 'a n t m ə 
embolicant-se	ə m b o l i k 'a n s ə	 ə m b o l i k 'a n t s ə 
embassament	ə m b ə s ə m 'e n t	 ə m b 'a s ə m 'e n t 
elèctrica	ə l 'ə t t ɾ i k ə	 ə l 'ə t t ɾ 'i k ə 
dòlar	d 'ɔ l ə	 d 'ɔ l 'a 
dèficits	d 'ɛ f i s i t s	 d 'ɛ f i s 'i t s 
dèbit	d 'ə β i t	 d 'ɛ β i t 
dèbil	d 'ə β i l	 d 'ɛ β i l 
dutxat	d u t ʃ 'a t	 d 'u t ʃ 'a t 
dugués	d u ɣ 'e s	 d 'u ɣ 'e s 
donessin	d o n 'e s i n	 d o n 'ə s i n 
donant-nos	d o n 'a n n o s	 d o n 'a n n n o s 
donant-los	d o n 'a n l o s	 d o n 'a n d l o s 
donant-li	d o n 'a n l i	 d o n 'a n i l i 
dominants	d o m i n 'a n s	 d o m i n 'a n t s 
domesticar	d o m ə s t i k 'a	 d 'o m ə s t i k 'a 
divuitena	d i v u j t 'ə n ə	 d i v u i t 'ə n ə 
distreuen	d i s t ɾ 'ə w ə n	 d i s t ɾ 'ɛ w ə n 
disposo	d i s p 'o z o	 d i s p 'ɔ z o 
disgustos	d i z ɣ 'u s t o s	 d 'i z ɣ 'u s t o s 
disgust	d i z ɣ 'u s t	 d 'i z ɣ 'u s t 
discrepo	d i s k ɾ 'e p o	 d i s k ɾ 'ə p o 
discjòqueis	d i s k ʒ 'ɔ k ə j s	 d i s k ʒ 'ɔ k 'ə j s 
digueren	d i ɣ 'e ɾ ə n	 d i ɣ 'ɛ ɾ ə n 
dient-se	d i 'e n s ə	 d i 'ə n s ə 
dibuixant-me	d i β u ʃ 'a m m ə	 d i β u ʃ 'a n t m ə 
detinguts	d ə t i ŋ g 'u t s	 d ə t 'i ŋ g 'u t s 
deteniment	d ə t ə n i m 'e n t	 d ə t 'ɛ n i m 'e n t 
desviament	d ə z v i ə m 'e n t	 d ə z v 'i ə m 'e n t 
destorben	d ə s t 'o ɾ β ə n	 d ə s t 'ɔ ɾ β ə n 
despreci	d ə s p ɾ 'ɛ s i	 d ə s p ɾ 'ə s i 
desplegant-se	d ə s p l ə ɣ 'a n s ə	 d ə s p l ə ɣ 'a n t s ə 
desordres	d ə z 'o ɾ ð ɾ ə s	 d ə z 'ɔ ɾ ð ɾ ə s 
desordre	d ə z 'o ɾ ð ɾ ə	 d ə z 'ɔ ɾ ð ɾ ə 
desinteressats	d ə z i n t ə ɾ ə s 'a t s	 d ə z 'i n t ə ɾ ə s 'a t s 
desigs	d ə z 'i t ʃ s	 d ə z 'i n s 
desemboca	d ə z ə m b 'o k ə	 d ə z ə m b 'ɔ k ə 
delinqüents	d ə l i ŋ k w 'e n s	 d ə l i n ə w 'e n s 
deixes	d 'e ʃ ə s	 d 'ə ʃ ə s 
decreixement	d ə k ɾ ə ʃ ə m 'e n t	 d ə k ɾ 'ə ʃ ə m 'e n t 
cònjuge	k 'ɔ n ʒ u ʒ ə	 k 'ɔ n ʒ 'u ʒ ə 
còmplices	k 'ɔ m p l i s ə s	 k 'ɔ m p l 'i s ə s 
cuinés	k u j n 'e s	 k 'u j n 'e s 
cuinera	k u j n 'e ɾ ə	 k u i n 'e ɾ ə 
cuinar	k u j n 'a	 k u i n 'a 
cuidava	k u j ð 'a v ə	 k u i ð 'a v ə 
cuidant	k u j ð 'a n t	 k u i ð 'a n t 
cromos	k ɾ 'o m o s	 k ɾ 'ɔ m o s 
creïn	k ɾ 'e i n	 k ɾ ə 'i n 
crepitegen	k ɾ ə p i t 'ɛ ʒ ə n	 k ɾ ə p i t 'ə ʒ ə n 
cremes	k ɾ 'e m ə s	 k ɾ 'ə m ə s 
cremen	k ɾ 'e m ə n	 k ɾ 'ə m ə n 
crema	k ɾ 'e m ə	 k ɾ 'ə m ə 
covard	k o v 'a ɾ t	 k o v 'a ɾ ə 
cosa	k 'ɔ z ə	 k 'o z ə 
contundent	k o n t u n d 'e n t	 k o n t 'u n d 'e n t 
continuessin	k o n t i n u 'e s i n	 k o n t i n u 'ə s i n 
continguda	k o n t i ŋ g 'u ð ə	 k o n t 'i ŋ g 'u ð ə 
contenen	k o n t 'e n ə n	 k o n t 'ə n ə n 
contemplant-li	k o n t ə m p l 'a n l i	 k o n t ə m p l 'a n 'ɔ l i 
contaminants	k o n t ə m i n 'a n s	 k o n t ə m i n 'a n t s 
consums	k o n s 'u n s	 k 'o n s 'u n s 
consta	k 'o n s t ə	 k 'ɔ n s t ə 
considero	k o n s i ð 'e ɾ o	 k o n s i ð 'ɛ ɾ o 
conques	k 'o ŋ k ə s	 k 'ɔ ŋ k ə s 
connecta	k o n n 'e t t ə	 k o n n 'ɛ t t ə 
concursos	k o ŋ k 'u ɾ s o s	 k 'o ŋ k 'u ɾ s o s 
comtats	k o n t 'a t s	 k o m t 'a t s 
comprant-se	k o m p ɾ 'a n s ə	 k o m p ɾ 'a n t s ə 
compliment	k o m p l i m 'e n t	 k 'ɔ m p l i m 'e n t 
completi	k o m p l 'ɛ t i	 k o m p l 'ə t i 
completa-la	k o m p l 'ə t ə l ə	 k o m p l ə t 'a l ə 
complauen	k o m p l 'a w ə n	 k o m p l 'a ə n 
complaença	k o m p l ə 'ɛ n s ə	 k o m p l 'a 'ɛ n s ə 
comparsero	k o m p ə ɾ s 'e ɾ o	 k o m p ə ɾ s 'ɛ ɾ o 
comences	k o m 'ɛ n s ə s	 k o m 'ə n s ə s 
colpeja	k o l p 'ɛ ʒ ə	 k o l p 'ə ʒ ə 
coixa	k 'o ʃ ə	 k 'ɔ ʃ ə 
coherents	k o ə ɾ 'e n s	 k o ə ɾ 'e n t s 
cofoi	k o f 'ɔ j	 k o f 'o i 
coco	k 'o k o	 k 'ɔ k o 
clavant-li	k l ə v 'a n l i	 k l ə v 'a n i l i 
circuli	s i ɾ k 'u l i	 s 'i ɾ k 'u l i 
cerquem	s ə ɾ k 'ə m	 s 'ɛ ɾ k 'ə m 
centígrads	s ə n t 'i ɣ ɾ ə t s	 s ə n t 'i ɣ ɾ 'a t s 
cents	s 'e n s	 s 'e n t s 
celebren	s ə l 'e β ɾ ə n	 s ə l 'ə β ɾ ə n 
cec	s 'e k	 s 'ɛ k 
catorzena	k ə t o ɾ z 'ə n ə	 k ə t 'o ɾ z 'ə n ə 
catastrofista	k ə t ə s t ɾ o f 'i s t ə	 k 'a t ə s t ɾ o f 'i s t ə 
castigant-se	k ə s t i ɣ 'a n s ə	 k ə s t i ɣ 'a n t s ə 
carboni	k ə ɾ β 'ɔ n i	 k ə ɾ β 'o n i 
carai	k ə ɾ 'a j	 k ə ɾ 'a i 
caracteritzant-lo	k ə ɾ ə t t ə ɾ i d z 'a n l o	 k ə ɾ ə t t ə ɾ i d z 'a n d l o 
caputxeta	k ə p u t ʃ 'ə t ə	 k ə p 'u t ʃ 'ə t ə 
capmàs	k ə m m 'a s	 k ə p m 'a s 
capbussar	k ə b b u s 'a	 k ə p β u s 'a 
cants	k 'a n s	 k 'a n t s 
cansament	k ə n s ə m 'e n t	 k 'a n s ə m 'e n t 
caigudes	k ə j ɣ 'u ð ə s	 k 'a j ɣ 'u ð ə s 
buldòzer	b u l d 'ɔ z ə	 b u l d 'ɔ z e  
buidor	b u j ð 'o	 b u i ð 'o 
brots	b ɾ 'o t s	 b ɾ 'ɔ t s 
bot	b 'o t	 b 'ɔ t 
borden	b 'o ɾ ð ə n	 b 'ɔ ɾ ð ə n 
bolxevic	b o l ʃ ə v 'i k	 b 'ɔ l ʃ ə v 'i k 
bolquen	b 'o l k ə n	 b 'ɔ l k ə n 
boirum	b o j ɾ 'u m	 b 'ɔ j ɾ 'u m 
boirina	b o j ɾ 'i n ə	 b o i ɾ 'i n ə 
bodegues	b o ð 'ə ɣ ə s	 b o ð 'ɛ ɣ ə s 
beuen	b 'ə w ə n	 b 'ɛ w ə n 
besalú	b ə z ə l 'u	 b ə z 'a l 'u 
bes	b 'e s	 b 'ə s 
berzeliïta	b ə ɾ z ə l i 'i t ə	 b ə ɾ z ə l 'i 'i t ə 
beneficiosa	b ə n ə f i s i 'o z ə	 b ə n ə f i s i 'o s ə 
beatífic	b e ə t 'i f i k	 b ə ə t 'i f i k 
beata	b e 'a t ə	 b ə 'a t ə 
basés	b ə z 'e s	 b ə s 'e s 
bastiment	b ə s t i m 'e n t	 b 'a s t i m 'e n t 
basament	b ə z ə m 'e n t	 b 'a z ə m 'e n t 
barranquisme	b ə r ə ŋ k 'i z m ə	 b ə r 'a ŋ k 'i z m ə 
atribuir-ho	ə t ɾ i β u 'i ɾ o	 ə t ɾ i β 'u j ɾ 'ɔ 
atansant-se	ə t ə n s 'a n s ə	 ə t ə n s 'a n t s ə 
assaigs	ə s 'a t ʃ s	 ə s 'a 'i ə s 
assaborint-ne	ə s ə β o ɾ 'i n n ə	 ə s ə β o ɾ 'i n n n ə 
aspirants	ə s p i ɾ 'a n s	 ə s p i ɾ 'a n t s 
asimètrica	ə s i m 'ɛ t ɾ i k ə	 ə z i m 'ɛ t ɾ i k ə 
arrossegant-se	ə r o s ə ɣ 'a n s ə	 ə r o s ə ɣ 'a n t s ə 
arribessin	ə r i β 'e s i n	 ə r i β 'ə s i n 
arreglava	ə r ə g g l 'a v ə	 ə r ə ɣ l 'a v ə 
arreglar-hi	ə r ə g g l 'a ɾ i	 ə r ə ɣ l 'a ɾ i 
arreglar	ə r ə g g l 'a	 ə r ə ɣ l 'a 
arregla	ə r 'e g g l ə	 ə r 'ə g g l ə 
arrabassar	ə r ə β ə s 'a	 ə r 'a β ə s 'a 
arcs	'a ɾ t s	 'a ɾ s i 
aproven	ə p ɾ 'o v ə n	 ə p ɾ 'ɔ v ə n 
apropant-se	ə p ɾ o p 'a n s ə	 ə p ɾ o p 'a n t s ə 
aprofitant-se	ə p ɾ o f i t 'a n s ə	 ə p ɾ o f i t 'a n t s ə 
aprofitament	ə p ɾ o f i t ə m 'e n t	 ə p ɾ o f 'i t ə m 'e n t 
aportessin	ə p o ɾ t 'e s i n	 ə p o ɾ t 'ə s i n 
apartant-lo	ə p ə ɾ t 'a n l o	 ə p ə ɾ t 'a n d l o 
apartament	ə p ə ɾ t ə m 'e n t	 ə p 'a ɾ t ə m 'e n t 
aparegueren	ə p ə ɾ ə ɣ 'e ɾ ə n	 ə p ə ɾ ə ɣ 'ɛ ɾ ə n 
anhelant-la	ə n ə l 'a n l ə	 ə n ə l 'a n d l ə 
angoixa	ə ŋ g 'o ʃ ə	 ə ŋ g 'ɔ ʃ ə 
anessin	ə n 'e s i n	 ə n 'ə s i n 
amagant-li	ə m ə ɣ 'a n l i	 ə m ə ɣ 'a n i l i 
alts	'a l s	 'a l t s 
alteren	ə l t 'e ɾ ə n	 ə l t 'ɛ ɾ ə n 
alinear	ə l i n e 'a	 ə l i n 'ə 'a 
alegre	ə l 'e ɣ ɾ ə	 ə l 'ə ɣ ɾ ə 
ajudés	ə ʒ u ð 'e s	 ə ʒ 'u ð 'e s 
ajudant-la	ə ʒ u ð 'a n l ə	 ə ʒ u ð 'a n d l ə 
aixeco	ə ʃ 'e k o	 ə ʃ 'ɛ k o 
aixeca	ə ʃ 'e k ə	 ə ʃ 'ɛ k ə 
agafessin	ə ɣ ə f 'e s i n	 ə ɣ ə f 'ə s i n 
afruitat	ə f ɾ u j t 'a t	 ə f ɾ u i t 'a t 
adults	ə ð 'u l s	 ə ð 'u l t s 
adscrit	ə s k ɾ 'i t	 ə t s k ɾ 'i t 
adornen	ə ð 'o ɾ n ə n	 ə ð 'ɔ ɾ n ə n 
adequa	ə ð 'e k w ə	 ə ð 'ɛ k w ə 
acostant-se	ə k o s t 'a n s ə	 ə k o s t 'a n t s ə 
acomodament	ə k o m o ð ə m 'e n t	 ə k o m 'ɔ ð ə m 'e n t 
acomiadaríem	ə k o m i ə ð ə ɾ 'i ə m	 ə k o m 'i ə ð ə ɾ 'i ə m 
acomiadament	ə k o m i ə ð ə m 'e n t	 ə k o m i 'a ð ə m 'e n t 
aclariment	ə k l ə ɾ i m 'e n t	 ə k l 'a ɾ i m 'e n t 
acceptant-la	ə t s ə t t 'a n l ə	 ə t s ə t t 'a n d l ə 
acabessim	ə k ə β ə s 'i m	 ə k 'a β ə s 'i m 
abandonament	ə β ə n d o n ə m 'e n t	 ə β ə n d 'ɔ n ə m 'e n t 
a	'ə	 ə 
Zürich	z u ɾ 'i k	 ə w ɾ 'i k ə 
Xop	ʃ 'o p	 ʃ 'ɔ p 
Weissmann	b ə j s m 'a n n	 b 'ə j s m 'a n n 
Webs	b 'e t s	 s 'ə t s 
Vicent	v i s 'ɛ n t	 v i s 'e n t 
Venus	v 'ɛ n u s	 v 'ə n u s 
Ve	v 'e	 v 'ə 
Vailets	v ə j l 'ə t s	 v ə i l 'ə t s 
Vaduz	v ə ð 'u z	 v ə ð 'u 
Unesco	u n 'e s k o	 u n 'ə s k o 
Ulldemol	u ʎ d ə m 'ɔ l	 u ʎ ð ə m 'ɔ l 
Transports	t ɾ ə n s p 'ɔ ɾ s	 t ɾ ə n s p 'o ɾ t s 
Transport	t ɾ ə n s p 'ɔ ɾ t	 t ɾ ə n s p 'o ɾ t 
Tort	t 'ɔ ɾ t	 t 'o ɾ t 
Torno	t 'o ɾ n o	 t 'ɔ ɾ n o 
Tema	t 'e m ə	 t 'ə m ə 
Te	t 'ə	 t ə 
Tants	t 'a n s	 t 'a n t s 
Taipei	t ə j p 'ə j	 t ə i p 'ə j 
Tailàndia	t ə j l 'a n d i ə	 t ə i l 'a n d i ə 
Suècia	s u 'ə s i ə	 s u 'ɛ s i ə 
Sobre	s 'o β ɾ ə	 s 'ɔ β ɾ ə 
Sistemes	s i s t 'e m ə s	 s i s t 'ə m ə s 
Sistema	s i s t 'e m ə	 s i s t 'ə m ə 
Saps	s 'a t s	 s 'a p s 
Samland	s ə m l 'a n t	 s ə m l 'a n d 
Renaixement	r ə n ə ʃ ə m 'e n t	 r ə n 'a ʃ ə m 'e n t 
Reintegrament	r ə i n t ə ɣ ɾ ə m 'e n t	 r ə i n t 'ə ɣ ɾ ə m 'e n t 
Reemissió	r e ə m i s i 'o	 r ə 'ɛ m i s i 'o 
Realisme	r e ə l 'i z m ə	 r ə ə l 'i z m ə 
Raonament	r ə o n ə m 'e n t	 r ə 'ɔ n ə m 'e n t 
Quedo	k 'e ð o	 k 'ə ð o 
Planejament	p l ə n ə ʒ ə m 'e n t	 p l ə n d ʒ ə m 'e n t 
Pingu	p 'i ŋ g u	 p 'i ŋ g w 
Parts	p 'a ɾ s	 p 'a ɾ t s 
Pakistan	p ə k i s t 'a n	 p ə z i s t 'a n 
Pablo	p 'a β l o	 p 'a b b l o 
Ordre	'o ɾ ð ɾ ə	 'ɔ ɾ ð ɾ ə 
Omple	'o m p l ə	 'ɔ m p l ə 
Nois	n 'ɔ j s	 n 'o i s 
Naixement	n ə ʃ ə m 'e n t	 n 'a ʃ ə m 'e n t 
Munich	m u n 'i k	 m u n 'i k ə 
Mossos	m 'o s o s	 m 'ɔ s o s 
Mossegant-se	m o s ə ɣ 'a n s ə	 m o s ə ɣ 'a n t s ə 
Montsià	m o n s i 'a	 m 'o n s i 'a 
Montseny	m o n s 'ə ɲ	 m 'o n t s 'ə ɲ 
Molta	m 'o l t ə	 m 'ɔ l t ə 
Missatger	m i s ə d ʒ 'e	 m i s 'a d ʒ 'e 
Menja	m 'e n ʒ ə	 m 'ə n ʒ ə 
Mataresies	m ə t ə ɾ ə z 'i ə s	 m ə t 'a ɾ ə z 'i ə s 
Martens	m ə ɾ t 'ə n s	 m ə ɾ t 'e n s 
Malone	m ə l 'o n ə	 m ə l 'ɔ n ə 
Légolas	l 'e ɣ o l ə s	 l 'e ɣ o l 'a s 
Lund	l 'u n t	 l 'u n d 
Lo	l 'o	 l o 
Lluch	ʎ 'u k	 ʎ 'u k ə 
Llevo	ʎ 'e v o	 ʎ 'ə v o 
Lisboa	l i z β 'o ə	 l i z β 'ɔ ə 
Kirsten	k 'i ɾ s t ə n	 k 'i s t ə n 
Johannesburg	ʒ o ə n n ə z β 'u ɾ k	 ʒ o e n n ə z β 'u ɾ k 
Jofre	ʒ 'o f ɾ ə	 ʒ 'ɔ f ɾ ə 
Jeroni	ʒ ə ɾ 'ɔ n i	 ʒ ə ɾ 'o n i 
Ignoro	i n n 'o ɾ o	 i n n 'ɔ ɾ o 
Hòstia	'ɔ s t i ə	 ə s t i ə 
Hug	'u k	 'a k 
Horta	'ɔ ɾ t ə	 ə ɾ t ə 
Haig	'a t ʃ	 ə 'i ə 
Günther	g w n t 'e	 g 'u n ə 'e 
Forestal	f o ɾ ə s t 'a l	 f 'o ɾ ə s t 'a l 
Fent-ho	f 'e n t o	 f 'ɛ n t i 
Estructura	ə s t ɾ u t t 'u ɾ ə	 ə s t ɾ 'u t t 'u ɾ ə 
Esports	ə s p 'ɔ ɾ s	 ə s p 'o ɾ t s 
Escriptura	ə s k ɾ i t t 'u ɾ ə	 ə s k ɾ 'i t t 'u ɾ ə 
Elisenda	ə l i z 'e n d ə	 ə l i z 'ə n d ə 
Eindhoven	ə j n d 'o v ə n	 ə j n d 'a v ə n 
Ebre	'e β ɾ ə	 'ə β ɾ ə 
Ebre	'e β ɾ ə	 'ə β ɾ ə 
EAJA	e 'a ʒ ə	 ə 'a ʒ ə 
Detroit	d ə t ɾ 'ɔ j t	 d ə t ɾ 'o 'i t 
Detingut	d ə t i ŋ g 'u t	 d ə t 'i ŋ g 'u t 
Darrere	d ə r 'e ɾ ə	 d ə r 'ɛ ɾ ə 
Creador	k ɾ e ə ð 'o	 k ɾ ə ə ð 'o 
Copia-la	k o p 'i ə l ə	 k o p i 'a l ə 
Copa	k 'o p ə	 k 'ɔ p ə 
Continguts	k o n t i ŋ g 'u t s	 k o n t 'i ŋ g 'u t s 
Consum	k o n s 'u m	 k 'o n s 'u m 
Consulti	k o n s 'u l t i	 k 'o n s 'u l t i 
Consta	k 'o n s t ə	 k 'ɔ n s t ə 
Connecta	k o n n 'e t t ə	 k o n n 'ɛ t t ə 
Comparseros	k o m p ə ɾ s 'e ɾ o s	 k o m p ə ɾ s 'ɛ ɾ o s 
Comences	k o m 'ɛ n s ə s	 k o m 'ə n s ə s 
Cleveland	k l ə v ə l 'a n t	 k l ə v ə l 'a n d 
Chirac	t ʃ i ɾ 'a k	 s i ɾ 'a k 
Caterina	k ə t ə ɾ 'i n ə	  k e t ə ɾ 'i n ə 
Carreras	k ə r 'e ɾ ə s	 k ə r 'ɛ ɾ ə s 
Carnero	k ə ɾ n 'e ɾ o	 k ə ɾ n 'ɛ ɾ o 
Caputxeta	k ə p u t ʃ 'ə t ə	 k ə p 'u t ʃ 'ə t ə 
Cadascuna	k ə ð ə s k 'u n ə	 k 'a ð ə s k 'u n ə 
Cadascun	k ə ð ə s k 'u n	 k 'a ð ə s k 'u n 
Budapest	b u ð ə p 'ə s t	 b 'u ð ə p 'ə s t 
Bodes	b 'o ð ə s	 b 'ɔ ð ə s 
Bangkok	b ə ŋ k k 'o k	 b 'a ŋ g k 'o k 
Arts	'a ɾ s	 'a ɾ t s 
Aixeca	ə ʃ 'e k ə	 ə ʃ 'ɛ k ə 
Ai	'a j	 'a i 
Agustí	ə ɣ u s t 'i	 ə ɣ 'u s t 'i 
Agenda	ə ʒ 'e n d ə	 ə ʒ 'ɛ n d ə 
el	'ə l	 ə l 
desplaçament	d ə s p l ə s ə m 'e n t	 d ə s p l 'a s ə m 'e n t 
amb	'ə m	 'a m b 
oi	'ɔ j	 'o i 
o	'ɔ	 'o 
es	'ə s	 ə s 
el	'ə l	 ə l 
a	'ə	 ə 
Totes	t 'o t ə s	 t 'ɔ t ə s 
Si	s 'i	 s i 
Li	l 'i	 l i 
I	'i	 i 
Ho	'o	 o 
He	'e	 'a 
Et	'ə t	 ə t 
que	k 'ə	 k ə 
hi	'i	 i 
com	k 'ɔ m	 k 'o m 
Si	s 'i	 s i 
Queda	k 'e ð ə	 k 'ə ð ə 
I	'i	 i 
He	'e	 'a 
Com	k 'ɔ m	 k 'o m 
Amb	'ə m	 'a m b 
xilens	ʃ i l 'ə n s	 ʃ i l 'e n s 
xecs	ʃ 'ɛ t s	 ʃ 'ə t s 
virtut	v i ɾ t 'u t	 v 'i ɾ t 'u t 
vinculants	v i ŋ k u l 'a n s	 v i ŋ k u l 'a n t s 
viatger	v i ə d ʒ 'e	 v i 'a d ʒ 'e 
utopies	u t o p 'i ə s	 'u t o p 'i ə s 
túnels	t 'u n ə l s	 t 'u n 'ɛ l s 
tropes	t ɾ 'o p ə s	 t ɾ 'ɔ p ə s 
treva	t ɾ 'e v ə	 t ɾ 'ə v ə 
travessava	t ɾ ə v ə s 'a v ə	 t ɾ 'a v ə s 'a v ə 
torben	t 'o ɾ β ə n	 t 'ɔ ɾ β ə n 
tirant-se	t i ɾ 'a n s ə	 t i ɾ 'a n t s ə 
temple	t 'e m p l ə	 t 'ə m p l ə 
tempestuosa	t ə m p ə s t u 'o z ə	 t ə m p ə s t u 'o s ə 
tanquessin	t ə ŋ k 'e s i n	 t ə ŋ k 'ə s i n 
sys	s 'i s	 s s 
suspens	s u s p 'ə n s	 s 'u s p 'e n s 
surrealisme	s u r e ə l 'i z m ə	 s u r ə ə l 'i z m ə 
sortints	s o ɾ t 'i n s	 s o ɾ t 'i n t s 
situant-se	s i t u 'a n s ə	 s i t u 'a n t s ə 
sexi	s 'ɛ t s i	 s 'ə t s i 
segles	s 'e g g l ə s	 s 'ə ɣ l ə s 
sanejament	s ə n ə ʒ ə m 'e n t	 s ə n d ʒ ə m 'e n t 
ruixats	r u ʃ 'a t s	 r i ʃ 'a t s 
rossa	r 'o s ə	 r 'ɔ s ə 
retinguts	r ə t i ŋ g 'u t s	 r ə t 'i ŋ g 'u t s 
ressort	r ə s 'ɔ ɾ t	 r ə s 'o ɾ t 
resistir-ho	r ə z i s t 'i ɾ o	 r ə z 'i s t 'i ɾ o 
repugnant	r ə p u n n 'a n t	 r ə p 'u ə n 'a n t 
rentessin	r ə n t 'e s i n	 r ə n t 'ə s i n 
removent-se	r ə m o v 'e n s ə	 r ə m o v 'ɛ n s ə 
recepta	r ə s 'ɛ t t ə	 r ə s 'ə t t ə 
qüestionen	k w ə s t i 'o n ə n	 k w ə s t i 'ɔ n ə n 
pàrquings	p 'a ɾ k i ŋ s	 p 'a ɾ k 'i ŋ g s 
puré	p u ɾ 'e	 p 'u ɾ 'e 
puig	p 'u t ʃ	 p 'u ʃ 
provoquen	p ɾ o v 'o k ə n	 p ɾ o v 'ɔ k ə n 
provincies	p ɾ o v i n s 'i ə s	 p ɾ o v 'i n s 'i ə s 
provincia	p ɾ o v i n s 'i ə	 p ɾ o v 'i n s 'i ə 
proveïts	p ɾ o v ə 'i t s	 p ɾ o v ə 'i s 
prospecte	p ɾ o s p 'ɛ t t ə	 p ɾ o s p 'ə t t ə 
promocioni	p ɾ o m o s i 'ɔ n i	 p ɾ o m o s i 'o n i 
promig	p ɾ o m 'i t ʃ	 p ɾ o m 'i k 
promig	p ɾ o m 'i t ʃ	 p ɾ o m 'i k 
progressos	p ɾ o ɣ ɾ 'e s o s	 p ɾ o ɣ ɾ 'ə s o s 
procreat	p ɾ o k ɾ e 'a t	 p ɾ o k ɾ 'e 'a t 
pretenen	p ɾ ə t 'e n ə n	 p ɾ ə t 'ə n ə n 
presentessin	p ɾ ə z ə n t 'e s i n	 p ɾ ə z ə n t 'ə s i n 
preceptes	p ɾ ə s 'ɛ t t ə s	 p ɾ ə s 'ə t t ə s 
preat	p ɾ e 'a t	 p ɾ 'e 'a t 
portessin	p o ɾ t 'e s i n	 p o ɾ t 'ə s i n 
polze	p 'o l z ə	 p 'ɔ l z ə 
pircings	p i ɾ s 'i ŋ s	 p i ɾ s 'i ŋ g s 
picant-li	p i k 'a n l i	 p i k 'a n t l i 
pertinences	p ə ɾ t i n 'ɛ n s ə s	 p ə ɾ t i n 'ə n s ə s 
peatons	p e ə t 'o n s	 p ə ə t 'o n s 
peatge	p e 'a d ʒ ə	 p ə 'a d ʒ ə 
paradoxal	p ə ɾ ə ð o t s 'a l	 p ə ɾ 'a ð o t s 'a l 
omplen	'o m p l ə n	 'ɔ m p l ə n 
obligant-la	o β l i ɣ 'a n l ə	 o β l i ɣ 'a n d l ə 
numero	n u m 'e ɾ o	 n u m 'ɛ ɾ o 
nervioses	n ə ɾ v i 'o z ə s	 n ə ɾ v i 'o s ə s 
movent-se	m o v 'e n s ə	 m o v 'ɛ n s ə 
motos	m 'o t o s	 m 'ɔ t o s 
molsuts	m o l s 'u t s	 m 'ɔ l s 'u t s 
mirant-ne	m i ɾ 'a n n ə	 m i ɾ 'a n n n ə 
minuciosa	m i n u s i 'o z ə	 m i n u s i 'o s ə 
militants	m i l i t 'a n s	 m i l i t 'a n t s 
malestars	m ə l ə s t 'a s	 m 'a l ə s t 'a s 
maleint-me	m ə l ə 'i m m ə	 m ə l 'ə j n t m ə 
maharajàs	m ə ə ɾ ə ʒ 'a s	 m ə ð ə ɾ ə ʒ 'a s 
maduixots	m ə ð u ʃ 'ɔ t s	 m ə ð 'u ʃ 'ɔ t s 
maduixer	m ə ð u ʃ 'e	 m ə ð 'u ʃ 'e 
ludopaties	l u ð o p ə t 'i ə s	 l 'u ð o p ə t 'i ə s 
lluitaven	ʎ u j t 'a v ə n	 ʎ u i t 'a v ə n 
lletja	ʎ 'e d ʒ ə	 ʎ 'ə d ʒ ə 
llestos	ʎ 'e s t o s	 ʎ 'ə s t o s 
llebre	ʎ 'e β ɾ ə	 ʎ 'ə β ɾ ə 
kosovars	k o z o v 'a s	 k o z o v 'a ɾ s 
jazz	ʒ 'a s	 ʒ 'a z ə 
irreals	i r e 'a l s	 i r ə 'a l s 
interpreto	i n t ə ɾ p ɾ 'e t o	 i n t ə ɾ p ɾ 'ə t o 
inspeccionant-la	i n s p ə t s i o n 'a n l ə	 i n s p ə t s i o n 'a n d l ə 
insolvents	i n s o l v 'e n s	 i n s o l v 'e n t s 
ingressos	i ŋ g ɾ 'e s o s	 i ŋ g ɾ 'ə s o s 
incloent-hi	i ŋ k l o 'e n t i	 i ŋ k l o 'ə n t i 
ignoro	i n n 'o ɾ o	 i n n 'ɔ ɾ o 
idealitzen	i ð e ə l 'i d z ə n	 i ð ə ə l 'i d z ə n 
hàgim	'a ʒ i m	 ə ʒ i m 
heroi	ə ɾ 'ɔ j	 ə ɾ 'o i 
glops	g l 'o t s	 g l 'ɔ t s 
ginebra	ʒ i n 'e β ɾ ə	 ʒ i n 'ə β ɾ ə 
gestioni	ʒ ə s t i 'ɔ n i	 ʒ ə s t i 'o n i 
gerds	ʒ 'ɛ ɾ s	 ʒ 'ɛ ɾ t s 
gemma	ʒ 'e m m ə	 ʒ 'ə m m ə 
fosses	f 'o s ə s	 f 'ɔ s ə s 
fessin	f 'e s i n	 f 'ə s i n 
fent-los	f 'e n l o s	 f 'ɛ n d l o s 
fent-la	f 'e n l ə	 f 'ɛ n d l ə 
febre	f 'e β ɾ ə	 f 'ə β ɾ ə 
febles	f 'e b b l ə s	 f 'ə b b l ə s 
exsoci	ə t s 'ɔ s i	 ə ʃ 'ɔ s i 
estrangers	ə s t ɾ ə n ʒ 'e s	 ə s t ɾ 'a ŋ g 'e s 
espaguetis	ə s p ə ɣ 'ɛ t i s	 ə s p ə ɣ 'ə t i s 
eso	'e s o	 'ə z o 
escolten	ə s k 'o l t ə n	 ə s k 'ɔ l t ə n 
escoltar-ho	ə s k o l t 'a ɾ o	 ə s k o l t 'a ɾ i 
entusiasmat	ə n t u z i ə z m 'a t	 ə n t u z i 'a z m 'a t 
ensonyament	ə n s o ɲ ə m 'e n t	 ə n s 'ɔ ɲ ə m 'e n t 
enginyeria	ə n ʒ i ɲ ə ɾ 'i ə	 ə n ʒ 'i ɲ ə ɾ 'i ə 
enganxant-ne	ə ŋ g ə n ʃ 'a n n ə	 ə ŋ g ə n ʃ 'a n n n ə 
ene	'e n ə	 'ə n ə 
endarrere	ə n d ə r 'e ɾ ə	 ə n d ə r 'ɛ ɾ ə 
eixamplament	ə ʃ ə m p l ə m 'e n t	 ə ʃ 'a m p l ə m 'e n t 
ego	'e ɣ o	 'ə ɣ o 
efebus	ə f 'ɛ β u s	 ə f 'ə β u s 
dècimes	d 'ə s i m ə s	 d 'ɛ s i m ə s 
dècim	d 'ə s i m	 d 'ɛ s i m 
dèbils	d 'ə β i l s	 d 'ɛ β i l s 
dèbils	d 'ə β i l s	 d 'ɛ β i l s 
dutxant-me	d u t ʃ 'a m m ə	 d 'u t ʃ 'a n t m ə 
dolços	d 'o l s o s	 d 'ɔ l s o s 
divertiment	d i v ə ɾ t i m 'e n t	 d i v 'ɛ ɾ t i m 'e n t 
disturbis	d i s t 'u ɾ β i s	 d 'i s t 'u ɾ β i s 
distants	d i s t 'a n s	 d i s t 'a n t s 
discorre	d i s k 'o r ə	 d i s k 'ɔ r ə 
dient-me	d i 'e m m ə	 d i 'ə n t m ə 
dient-me	d i 'e m m ə	 d i 'ə n t m ə 
dient-li	d i 'e n l i	 d i 'ɛ n 'ɛ l i 
diamants	d i ə m 'a n s	 d i ə m 'a n t s 
devoro	d ə v 'o ɾ o	 d ə v 'ɔ ɾ o 
descontentament	d ə s k o n t ə n t ə m 'e n t	 d ə s k o n t 'ə n t ə m 'e n t 
desconeixement	d ə s k o n ə ʃ ə m 'e n t	 d ə s k o n 'ə ʃ ə m 'e n t 
desapareguessin	d ə z ə p ə ɾ ə ɣ 'e s i n	 d ə z ə p ə ɾ ə ɣ 'ə s i n 
càmpings	k 'a m p i ŋ s	 k 'a m p i ŋ g s 
curts	k 'u ɾ s	 k 'u ɾ t s 
cuinats	k u j n 'a t s	 k u i n 'a t s 
cuidés	k u j ð 'e s	 k 'u j ð 'e s 
creï	k ɾ 'e i	 k ɾ 'ə i 
crearien	k ɾ e ə ɾ 'i ə n	 k ɾ ə ə ɾ 'i ə n 
creadors	k ɾ e ə ð 'o s	 k ɾ ə ə ð 'o s 
creadora	k ɾ e ə ð 'o ɾ ə	 k ɾ ə ə ð 'o ɾ ə 
coses	k 'ɔ z ə s	 k 'o z ə s 
corba	k 'o ɾ β ə	 k 'ɔ ɾ β ə 
contundents	k o n t u n d 'e n s	 k o n t 'u n d 'e n s 
contrincants	k o n t ɾ i ŋ k 'a n s	 k o n t ɾ i ŋ k 'a n t s 
contempla	k o n t 'e m p l ə	 k o n t 'ə m p l ə 
consideren	k o n s i ð 'e ɾ ə n	 k o n s i ð 'ɛ ɾ ə n 
conscienciós	k o n t s i ə n s i 'o s	 k o n s i ə n s i 'o s 
conscienciació	k o n t s i ə n s i ə s i 'o	 k o n s i ə n s i ə s i 'o 
connecto	k o n n 'e t t o	 k o n n 'ɛ t t o 
connecten	k o n n 'e t t ə n	 k o n n 'ə t t ə n 
comandants	k o m ə n d 'a n s	 k o m ə n d 'a n t s 
clixés	k l i ʃ 'e s	 k l ʃ 'e s 
circulen	s i ɾ k 'u l ə n	 s 'i ɾ k 'u l ə n 
carboncles	k ə ɾ β 'o ŋ k l ə s	 k ə ɾ β 'ɔ ŋ k l ə s 
cantants	k ə n t 'a n s	 k ə n t 'a n t s 
caiguts	k ə j ɣ 'u t s	 k 'a j ɣ 'u t s 
butà	b u t 'a	 b 'u t 'a 
buidant	b u j ð 'a n t	 b u i ð 'a n t 
bomba	b 'o m b ə	 b 'ɔ m b ə 
bistecs	b i s t 'ɛ t s	 b i s t 'ə t s 
be	b 'e	 b 'ə 
bastard	b ə s t 'a ɾ t	 b ə s t 'a ɾ ə 
bastants	b ə s t 'a n s	 b ə s t 'a n t s 
atapeïts	ə t ə p ə 'i t s	 ə t ə p ə 'i s 
assecant-se	ə s ə k 'a n s ə	 ə s ə k 'a n t s ə 
ascens	ə t s 'ə n s	 ə s k 'e n s 
arruinada	ə r u j n 'a ð ə	 ə r u i n 'a ð ə 
arremangant-se	ə r ə m ə ŋ g 'a n s ə	 ə r ə m ə ŋ g 'a n t s ə 
arenga	ə ɾ 'e ŋ g ə	 ə ɾ 'ə ŋ g ə 
apèndix	ə p 'ə n d i t s	 ə p 'ɛ n d i 
aprofundiment	ə p ɾ o f u n d i m 'e n t	 ə p ɾ o f 'u n d i m 'e n t 
anhels	ə n 'ɛ l s	 ə n 'a l s 
amargament	ə m ə ɾ ɣ ə m 'e n t	 ə m 'a ɾ ɣ ə m 'e n t 
amants	ə m 'a n s	 ə m 'a n t s 
alcoholèmies	ə l k o o l 'ɛ m i ə s	 ə l k o o l 'ə m i ə s 
afronten	ə f ɾ 'o n t ə n	 ə f ɾ 'ɔ n t ə n 
adolescents	ə ð o l ə t s 'e n s	 ə ð o l ə s k 'e n t s 
actuïn	ə t t 'u i n	 ə t t u 'i n 
abertzale	ə β ə ɾ d z 'a l ə	 ə β 'e ɾ ə z 'a l ə 
Ull	'u j	 'u ʎ 
Tortura	t o ɾ t 'u ɾ ə	 t 'ɔ ɾ t 'u ɾ ə 
Sens	s 'ə n s	 s 'e n s 
Ruth	r 'u t	 r 'u t i 
Raúl	r ə 'u l	 r 'a 'u l 
Poder	p o ð 'ə	 p o ð 'e 
Plataforma	p l ə t ə f 'o ɾ m ə	 p l ə t ə f 'ɔ ɾ m ə 
Plantejament	p l ə n t ə ʒ ə m 'e n t	 p l ə n t 'ɛ ʒ ə m 'e n t 
Parisien	p ə ɾ i z 'i ə n	 p ə ɾ i s 'i ə n 
Montevideo	m o n t ə v i ð 'e o	 m o n t ə v i ð 'ə o 
Mes	m 'e s	 m 'ə s 
Lègolas	l 'ə ɣ o l ə s	 l 'ə ɣ o l 'a s 
Lluïment	ʎ u i m 'e n t	 ʎ 'u i m 'e n t 
Le	l 'e	 l 'ə 
Joel	ʒ o 'ɛ l	 ʒ 'ɔ 'ɛ l 
Iniciativa	i n i s i ə t 'i v ə	 i n i s 'i ə t 'i v ə 
Hèlsinki	'ɛ l s i ŋ k i	 'a l s i n s i 
Huc	'u k	 'a k 
Hisenda	i z 'e n d ə	 i z 'ɛ n d ə 
Grenoble	g ɾ ə n 'o b b l ə	 g ɾ ə n 'ɔ b b l ə 
Grand	g ɾ 'a n t	 g ɾ 'a n d 
Folch	f 'o l k	 f 'o l k ə 
Endreço	ə n d ɾ 'e s o	 ə n d ɾ 'ə s o 
Dreamweaver	d ɾ e ə m b e ə v 'e	 d ɾ e ə m b ə ə v 'e 
Cultures	k u l t 'u ɾ ə s	 k 'u l t 'u ɾ ə s 
Contra	k 'o n t ɾ ə	 k 'ɔ n t ɾ ə 
Consulta	k o n s 'u l t ə	 k 'o n s 'u l t ə 
Compareseria	k o m p ə ɾ ə z ə ɾ 'i ə	 k o m p 'a ɾ ə z ə ɾ 'i ə 
Celestina	s ə l ə s t 'i n ə	 s 'ɛ l ə s t 'i n ə 
Cadascú	k ə ð ə s k 'u	 k 'a ð ə s k 'u 
COCO	k 'o k o	 k 'ɔ k o 
Ben	b 'e n	 b 'ə n 
Beirut	b ə j ɾ 'u t	 b ə i ɾ 'u t 
habilitaɾan	ə β i l i t ə ɾ 'a n	 ə β i l 'i t ə ɾ 'a n 
habilitaɾà	ə β i l i t ə ɾ 'a	 ə β i l 'i t ə ɾ 'a 
habitants	ə β i t 'a n s	 ə β i t 'a n t s 
habitatge	ə β i t 'a dʒ ə	 ə β i t 'a d ʒ ə 
habitatges	ə β i t 'a dʒ ə s	 ə β i t 'a d ʒ ə s 
habitualment	ə β i t u ˌ a l m 'e n t	 ə β i t u 'a l m 'e n t 
hagi	'a ʒ i	 ə ʒ i 
hagin	'a ʒ i n	 ə ʒ i n 
hagis	'a ʒ i s	 ə ʒ i s 
hagueɾa	ə ɣ 'e ɾ ə	 ə ɣ 'ɛ ɾ ə 
hagueɾen	ə ɣ 'e ɾ ə n	 ə ɣ 'ɛ ɾ ə n 
hagueɾes	ə ɣ 'e ɾ ə s	 ə ɣ 'ɛ ɾ ə s 
haguessen	ə ɣ 'e s ə n	 ə ɣ 'ə s ə n 
haguesses	ə ɣ 'e s ə s	 ə ɣ 'ə s ə s 
haguessin	ə ɣ 'e s i n	 ə ɣ 'ə s i n 
haguessis	ə ɣ 'e s i s	 ə ɣ 'ə s i s 
hagué	ə ɣ 'e	 ə ɣ 'ə 
haguéɾem	ə ɣ 'e ɾ ə m	 ə ɣ 'e 'ə m 
haguéɾeu	ə ɣ 'e ɾ ə w	 ə ɣ 'e 'ɛ w 
hagués	ə ɣ 'e s	 ə ɣ 'ə s 
haguéssem	ə ɣ 'e s ə m	 ə ɣ 'e s 'ə m 
haguésseu	ə ɣ 'e s ə w	 ə ɣ 'e s 'ɛ w 
haguéssim	ə ɣ 'e s i m	 ə ɣ 'e s 'i m 
haguéssiu	ə ɣ 'e s i w	 ə ɣ 'e s 'i w 
haia	'a j ə	 ə 'i ə 
haig	'a tʃ	 ə 'i ə 
haitians	ə j t i 'a n s	 ə i t i 'a n s 
haití	ə j t 'i	 ə i t 'i 
haja	'a ʒ ə	 ə ʒ ə 
halloween	ə ʎ o β 'e ə n	 ə ʎ o β 'ɛ ə n 
halteɾofília	ə l t ə ɾ o f 'i l i ə	 ə l t ə ɾ o f 'i l 'i ə 
hambuɾgueseɾia	ə m b u ɾ ɣ ə z ə ɾ 'i ə	 ə m b u ɾ ɣ 'ə z ə ɾ 'i ə 
hannoveɾ	ə n n o v 'e	 ə n n o v 'ə 
haɾdwaɾe	'a ɾ u ə	 ə ɾ ə 'a ɾ ə 
haɾmoniosa	ə ɾ m o n i 'o z ə	 ə ɾ m o n i 'o s ə 
haɾmoniosament	ə ɾ m o n i ˌ o z ə m 'e n t	 ə ɾ m o n i 'ɔ z ə m 'e n t 
haɾmonioses	ə ɾ m o n i 'o z ə s	 ə ɾ m o n i 'o s ə s 
haɾmònic	ə ɾ m 'ɔ n i k	 ə ɾ m 'ɔ n 'i k 
haɾmònica	ə ɾ m 'ɔ n i k ə	 ə ɾ m 'ɔ n 'i k ə 
haɾmònicament	ə ɾ m ˌ ɔ n i k ə m 'e n t	 ə ɾ m 'ɔ n 'i k ə m 'e n t 
haɾmònics	ə ɾ m 'ɔ n i t s	 ə ɾ m 'ɔ n 'i t s 
haɾmòniques	ə ɾ m 'ɔ n i k ə s	 ə ɾ m 'ɔ n 'i k ə s 
hauɾé	ə w ɾ 'e	 ə w ɾ 'ə 
hauɾíem	ə w ɾ 'i ə m	 ə w ɾ 'i 'ə m 
hauɾíeu	ə w ɾ 'i ə w	 ə w ɾ 'i 'ɛ w 
hemofília	ə m o f 'i l i ə	 ə m o f 'i l 'i ə 
hemoroides	ə m o r 'ɔ j ð ə s	 ə m o ɾ 'ɔ 'i ð ə s 
hemoràgia	ə m o r 'a ʒ i ə	 ə m o ɾ 'a ʒ 'i ə 
hemoràgies	ə m o r 'a ʒ i ə s	 ə m o ɾ 'a ʒ 'i ə s 
henna	'e n n ə	 ə n n ə 
hepàtic	ə p 'a t i k	 ə p 'a t 'i k 
heɾba	'ɛ ɾ β ə	 ə ɾ β ə 
heɾbes	'ɛ ɾ β ə s	 ə ɾ β ə s 
heɾbívoɾ	ə ɾ β 'i v o ɾ	 ə ɾ β 'i v 'o 
heɾbívoɾs	ə ɾ β 'i v o ɾ s	 ə ɾ β 'i v 'o s 
heɾeditàɾia	ə ɾ ə ð i t 'a ɾ i ə	 ə ɾ ə ð i t 'a ɾ 'i ə 
heɾeditàɾies	ə ɾ ə ð i t 'a ɾ i ə s	 ə ɾ ə ð i t 'a ɾ 'i ə s 
heɾetatge	ə ɾ ə t 'a dʒ ə	 ə ɾ ə t 'a d ʒ ə 
heɾeten	ə ɾ 'e t ə n	 ə ɾ 'ə t ə n 
heɾetges	ə ɾ 'e dʒ ə s	 ə ɾ 'ə d ʒ ə s 
heɾetgia	ə ɾ ə dʒ 'i ə	 ə ɾ ə d ʒ 'i ə 
heɾeus	ə ɾ 'ɛ w s	 ə ɾ 'ə 'u s 
heɾeva	ə ɾ 'e v ə	 ə ɾ 'ə v ə 
heɾeves	ə ɾ 'e v ə s	 ə ɾ 'ɛ v ə s 
inapɾehensible	i n ə p ɾ ə ə n s 'i b b l ə	 i n ə p ɾ ə 'ɛ n s 'i b b l ə 
incoheɾència	i ŋ k o ə ɾ 'ɛ n s i ə	 i ŋ k o ə ɾ 'ə n s 'i ə 
incoheɾències	i ŋ k o ə ɾ 'ɛ n s i ə s	 i ŋ k o ə ɾ 'ə n s 'i ə s 
inexhauɾible	i n ə d z ə w ɾ 'i b b l ə	 i n ə ʃ ə w ɾ 'i b b l ə 
inexhauɾibles	i n ə d z ə w ɾ 'i b b l ə s	 i n ə ʃ ə w ɾ 'i b b l ə s 
infɾahumanes	i m f ɾ ə u m 'a n ə s	 i n f ɾ ə u m 'a n ə s 
inhabilitaɾia	i n ə β i l i t ə ɾ 'i ə	 i n ə β i l 'i t ə ɾ 'i ə 
inhalatòɾia	i n ə l ə t 'ɔ ɾ i ə	 i n ə l 'a t 'ɔ ɾ 'i ə 
inhibeix	i n i β 'ə ʃ	 i n i β 'e ʃ 
inhibeixen	i n i β 'ə ʃ ə n	 i n i β 'ɛ ʃ ə n 
inhibeixi	i n i β 'ə ʃ i	 i n i β 'ɛ ʃ i 
inhibiɾse	i n i β 'i ɾ s ə	 i n i β 'i s ə 
inhòspit	i n 'ɔ s p i t	 i n 'ɔ s p 'i t 
inhòspita	i n 'ɔ s p i t ə	 i n 'ɔ s p 'i t ə 
macɾohistòɾia	m ə k ɾ o i s t 'ɔ ɾ i ə	 m ə k ɾ o i s t 'ɔ ɾ 'i ə 
malhumoɾat	m ˌ a l u m o ɾ 'a t	 m ə l u m o ɾ 'a t 
megaheɾtzos	m ə ɣ ə 'ɛ ɾ d z o s	 m 'ə ɣ ə 'ɛ ɾ d z o s 
megaheɾtzs	m ə ɣ ə 'ɛ ɾ d z s	 m 'ə ɣ ə 'ɛ ɾ t t s 
nihilisme	n i i l 'i z m ə	 n i 'a l 'i z m ə 
nihilista	n i i l 'i s t ə	 n i 'a l 'i s t ə 
nihilistes	n i i l 'i s t ə s	 n i 'a l 'i s t ə s 
