ababol	a β a β 'o l	 a β a β 'ɔ l 
abadejo	a β a ð 'e ʒ o	 a β a ð 'ɛ ʒ o 
abandonis	a β a n d 'ɔ n i s	 a β a n d 'o n i s 
abdomen	a b d 'o m e n	 a b d 'ɔ m e n 
abellerol	a β e ʎ e ɾ 'o l	 a β e ʎ e ɾ 'ɔ l 
Abraham	a β ɾ a 'a m	 a β ɾ a 'i m 
abscés	a p s 'e s	 a p s k 'e s 
aconseguits	a k o n s e ɣ 'i t s	 a k o n s e ɣ u 'i t s 
adherida	a ð e ɾ 'i ð a	 a ð e e ɾ 'i ð a 
adherides	a ð e ɾ 'i ð e s	 a ð e e ɾ 'i ð e s 
adherir	a ð e ɾ 'i	 a ð e e ɾ 'i 
adherit	a ð e ɾ 'i t	 a ð e e ɾ 'i t 
adherits	a ð e ɾ 'i t s	 a ð e e ɾ 'i t s 
admetre	a d m 'e t ɾ e	 a d m 'ɛ t ɾ e 
adob	a ð 'o p	 a ð 'o 
adúltera	a ð 'u l t e ɾ a	 a ð u l t 'e ɾ a 
adúlteres	a ð 'u l t e ɾ e s	 a ð u l t 'e ɾ e s 
aerosol	a e ɾ o z 'o l	 a e ɾ o z 'ɔ l 
afaitada	a f a j t 'a ð a	 a f a i t 'a ð a 
afaitades	a f a j t 'a ð e s	 a f a i t 'a ð e s 
afaitar	a f a j t 'a	 a f a i t 'a 
afaitat	a f a j t 'a t	 a f a i t 'a t 
afaitats	a f a j t 'a t s	 a f a i t 'a t s 
afectuoses	a f e k t u 'o z e s	 a f e k t u 'o s e s 
afrodisíac	a f ɾ o ð i z 'i a k	 a f ɾ o ð i s 'i a k 
afronta	a f ɾ 'o n t a	 a f ɾ 'ɔ n t a 
afusellament	a f u z e ʎ a m 'e n	 a f u s e ʎ a m 'e n 
agenda	a ʒ 'e n d a	 a ʒ 'ɛ n d a 
agúen	a ɣ 'u e n	 a ɣ e n 
agúes	a ɣ 'u e s	 a ɣ e s 
ai	'a j	 'a i 
aidada	a j ð 'a ð a	 a i ð 'a ð a 
aidades	a j ð 'a ð e s	 a i ð 'a ð e s 
aidant	a j ð 'a n	 a i ð 'a n 
aidar	a j ð 'a	 a i ð 'a 
aidat	a j ð 'a t	 a i ð 'a t 
aidats	a j ð 'a t s	 a i ð 'a t s 
alegre	a l 'e ɣ ɾ e	 a l 'ɛ ɣ ɾ e 
algebraic	a l dʒ e β ɾ 'a j k	 a l dʒ e β ɾ 'a i k 
alimenti	a l i m 'e n t i	 a l i m 'ɛ n t i 
aljub	a l dʒ 'u p	 a l dʒ 'u 
Altai	a l t 'a j	 a l t 'a i 
alts	'a l s	 'a l t s 
amainada	a m a j n 'a ð a	 a m a i n 'a ð a 
amainades	a m a j n 'a ð e s	 a m a i n 'a ð e s 
amainant	a m a j n 'a n	 a m a i n 'a n 
amainar	a m a j n 'a	 a m a i n 'a 
amainat	a m a j n 'a t	 a m a i n 'a t 
amainats	a m a j n 'a t s	 a m a i n 'a t s 
ampolla	a m p 'o ʎ a	 a m p 'ɔ ʎ a 
anàlegs	a n 'a l e k s	 a n 'a l e ɣ 
àngels	'a n dʒ e l s	 a n dʒ 'ɛ l s 
Àngels	'a n dʒ e l s	 a n dʒ 'ɛ l s 
angoixa	a ŋ g 'o j ʃ a	 a ŋ g o 'i tʃ a 
angoixada	a ŋ g o j ʃ 'a ð a	 a ŋ g o i ʃ 'a ð a 
angoixades	a ŋ g o j ʃ 'a ð e s	 a ŋ g o i ʃ 'a ð e s 
angoixant	a ŋ g o j ʃ 'a n	 a ŋ g o i ʃ 'a n 
angoixar	a ŋ g o j ʃ 'a	 a ŋ g o i ʃ 'a 
angoixat	a ŋ g o j ʃ 'a t	 a ŋ g o i ʃ 'a t 
angoixats	a ŋ g o j ʃ 'a t s	 a ŋ g o i ʃ 'a t s 
anguila	a ŋ g 'i l a	 a ŋ g u 'i l a 
anisòtrops	a n i z 'ɔ t ɾ o p s	 a n i z o t ɾ 'ɔ p s 
antiquats	a n t i k w 'a t s	 a n t i k 'a t s 
Antoni	a n t 'ɔ n i	 a n t 'o n i 
àpats	'a p a t s	 a p 'a t s 
aplec	a p l 'e k	 a p l 'ɛ k 
apòlegs	a p 'ɔ l e k s	 a p o l 'e k s 
apòstols	a p 'ɔ s t o l s	 a p o s t 'o l s 
apòstrofs	a p 'ɔ s t ɾ o f s	 a p o s t ɾ 'ɔ f s 
aprehendre	a p ɾ e 'ɛ n d ɾ e	 a p ɾ e o n d ɾ e 
aqüicultura	a k w i k u l t 'u ɾ a	 a k i k u l t 'u ɾ a 
aràcnid	a ɾ 'a g n i t	 a ɾ 'a k n i t 
arauac	a ɾ a w 'a k	 a ɾ a u 'a k 
asil	a z 'i l	 a s 'i l 
asimètric	a s i m 'ɛ t ɾ i k	 a z i m 'ɛ t ɾ i k 
assumpte	a s 'u m t e	 a s 'u m p t e 
assumptes	a s 'u m t e s	 a s 'u m p t e s 
asteroide	a s t e ɾ 'ɔ j ð e	 a s t e ɾ o 'i ð e 
astròlegs	a s t ɾ 'ɔ l e k s	 a s t ɾ o l 'e k s 
atendre	a t 'e n d ɾ e	 a t 'ɛ n d ɾ e 
atenenc	a t e n 'e ŋ	 a t e n 'e n s 
atles	'a d l e s	 'a t l e s 
Atles	'a d l e s	 'a t l e s 
atleta	a d l 'e t a	 a t l 'e t a 
atlètic	a d l 'ɛ t i k	 a t l 'ɛ t i k 
atlèticament	a d l 'ɛ t i k a m 'e n	 a t l 'ɛ t i k a m 'e n 
atreveixi	a t ɾ e β 'e j ʃ i	 a t ɾ e β 'ɛ j ʃ i 
atreveixin	a t ɾ e β 'e j ʃ i n	 a t ɾ e β 'ɛ j ʃ i n 
atroç	a t ɾ 'ɔ s	 a t ɾ 'o s 
babiloni	b a β i l 'ɔ n i	 b a β i l 'o n i 
Badakhxan	b a ð a k tʃ 'a n	 b a ð a k e 'a n 
bàdminton	b 'a d m i n t o n	 b a d m i n t 'o n 
bagenc	b a ʒ 'e ŋ	 b a ʒ 'e n s 
Bahames	b a 'a m e s	 b a m m e s 
basquetbol	b a s k e d b 'o l	 b a s k e t b 'ɔ l 
batec	b a t 'e k	 b a t 'ɛ k 
be	b 'e	 b 'ɛ 
bec	b 'e k	 b 'ɛ k 
beca	b 'e k a	 b 'ɛ k a 
befa	b 'e f a	 b 'ɛ f a 
bei	b 'ɛ j	 b 'ɛ i 
belen	b 'ɛ l e n	 b 'e l e n 
Belgrad	b e l ɣ ɾ 'a t	 b e l ɣ ɾ 'a 
bens	b 'e n s	 b 'ɛ n s 
beques	b 'e k e s	 b 'ɛ k e s 
bes	b 'e s	 b 'ɛ s 
besnebot	b e z n e β 'o t	 b e z n e β 'ɔ t 
beso	b 'e z o	 b 'ɛ z o 
Bétera	b 'e t e ɾ a	 b e t 'e ɾ a 
bíceps	b 'i s e p s	 b i s 'e p s 
Bigorra	b i ɣ 'ɔ r a	 b i ɣ 'o r a 
bisbalenc	b i z β a l 'e ŋ	 b i z β a l 'e n s 
bixa	b 'i ʃ a	 b 'i tʃ a 
Blai	b l 'a j	 b l 'a i 
bleda	b l 'e ð a	 b l 'ɛ ð a 
boca	b 'o k a	 b 'ɔ k a 
boda	b 'o ð a	 b 'ɔ ð a 
bodega	b o ð 'e ɣ a	 b o ð 'ɛ ɣ a 
bodes	b 'o ð e s	 b 'ɔ ð e s 
boga	b 'o ɣ a	 b 'ɔ ɣ a 
boirina	b o j ɾ 'i n a	 b o i ɾ 'i n a 
bolca	b 'o l k a	 b 'ɔ l k a 
bolígrafs	b o l 'i ɣ ɾ a f s	 b o l i ɣ ɾ 'a f s 
bolquen	b 'o l k e n	 b 'ɔ l k e n 
bomba	b 'o m b a	 b 'ɔ m b a 
bombes	b 'o m b e s	 b 'ɔ m b e s 
bombo	b 'o m b o	 b 'ɔ m b o 
bombolla	b o m b 'o ʎ a	 b o m b 'ɔ ʎ a 
bonze	b 'ɔ n z e	 b 'o n z e 
boques	b 'o k e s	 b 'ɔ k e s 
borrissol	b o r i s 'o l	 b o r i s 'ɔ l 
bosquerol	b o s k e ɾ 'o l	 b o s k e ɾ 'ɔ l 
bossa	b 'o s a	 b 'ɔ s a 
bosses	b 'o s e s	 b 'ɔ s e s 
bot	b 'o t	 b 'ɔ t 
boxa	b 'o k s a	 b 'ɔ k s a 
boxes	b 'o k s e s	 b 'ɔ k s e s 
brega	b ɾ 'e ɣ a	 b ɾ 'ɛ ɣ a 
bretxa	b ɾ 'e tʃ a	 b ɾ 'ɛ tʃ a 
broda	b ɾ 'o ð a	 b ɾ 'ɔ ð a 
broida	b ɾ 'ɔ j ð a	 b ɾ o 'i ð a 
broix	b ɾ 'o j ʃ	 b ɾ 'o tʃ 
brolla	b ɾ 'o ʎ a	 b ɾ 'ɔ ʎ a 
brollen	b ɾ 'o ʎ e n	 b ɾ 'ɔ ʎ e n 
bròquils	b ɾ 'ɔ k i l s	 b ɾ o k 'i l s 
brot	b ɾ 'o t	 b ɾ 'ɔ t 
búbal	b 'u β a l	 b u β 'a l 
búfal	b 'u f a l	 b u f 'a l 
búfals	b 'u f a l s	 b u f 'a l s 
bug	b 'u k	 b 'u 
buidada	b u j ð 'a ð a	 b u i ð 'a ð a 
buidades	b u j ð 'a ð e s	 b u i ð 'a ð e s 
buidar	b u j ð 'a	 b u i ð 'a 
buidat	b u j ð 'a t	 b u i ð 'a t 
buidatge	b u j ð 'a dʒ e	 b u i ð 'a t e e 
buidats	b u j ð 'a t s	 b u i ð 'a t s 
buidor	b u j ð 'o	 b u i ð 'o 
buixol	b u j ʃ 'o l	 b u j ʃ 'ɔ l 
búlgara	b 'u l ɣ a ɾ a	 b u l ɣ 'a ɾ a 
búlgares	b 'u l ɣ a ɾ e s	 b u l ɣ 'a ɾ e s 
cabeça	k a β 'ɛ s a	 k a β 'e s a 
caber	k a β 'ɛ	 k a β 'e 
cabirol	k a β i ɾ 'o l	 k a β i ɾ 'ɔ l 
cabiscol	k a β i s k 'o l	 k a β i s k 'ɔ l 
caigut	k a j ɣ 'u t	 k a i ɣ 'u t 
caiguts	k a j ɣ 'u t s	 k a i ɣ 'u t s 
caiman	k a j m 'a n	 k a i m 'a n 
calb	k 'a l p	 k 'a l i 
calbs	k 'a l p s	 k 'a l i s 
camp	k 'a m	 k 'a m p 
campestre	k a m p 'e s t ɾ e	 k a m p 'ɛ s t ɾ e 
camps	k 'a m s	 k 'a m p s 
canadenc	k a n a ð 'e ŋ	 k a n a ð 'e n s 
caníbal	k a n 'i β a l	 k a n i β 'a l 
caníbals	k a n 'i β a l s	 k a n i β 'a l s 
canoa	k a n 'o a	 k a n 'ɔ a 
capbussó	k a b b u s 'o	 k a p b u s 'o 
capdavall	k a b d a β 'a ʎ	 k a p d a β 'a ʎ 
capvuitada	k a b b u j t 'a ð a	 k a p b u i t 'a ð a 
caragol	k a ɾ a ɣ 'o l	 k a ɾ a ɣ 'ɔ l 
carantoines	k a ɾ a n t 'ɔ j n e s	 k a ɾ a n t 'ɔ i n e s 
caribeny	k a ɾ i β 'e ɲ	 k a ɾ i β 'ɛ ɲ 
caricaturesc	k a ɾ i k a t u ɾ 'e s k	 k a ɾ i k a t u ɾ 'ɛ s k 
càstigs	k 'a s t i k s	 k a s t 'i ɣ s 
catàlegs	k a t 'a l e k s	 k a t 'a l e ɣ 
catanyol	k a t a ɲ 'o l	 k a t a ɲ 'ɔ l 
ce	s 'e	 s 'ɛ 
cec	s 'e k	 s 'ɛ k 
cecs	s 'e k s	 s 'ɛ k s 
cedre	s 'e ð ɾ e	 s 'ɛ ð ɾ e 
cega	s 'e ɣ a	 s 'ɛ ɣ a 
cegues	s 'e ɣ e s	 s 'ɛ ɣ e s 
Ceilan	s e j l 'a n	 s e i l 'a n 
cens	s 'e n s	 s 'ɛ n s 
censos	s 'e n s o s	 s 'ɛ n s o s 
centre	s 'e n t ɾ e	 s 'ɛ n t ɾ e 
centres	s 'e n t ɾ e s	 s 'ɛ n t ɾ e s 
cèntrics	s 'ɛ n t ɾ i k s	 s e n t ɾ 'i k s 
centro	s 'e n t ɾ o	 s 'ɛ n t ɾ o 
ceptre	s 'e p t ɾ e	 s 'ɛ p t ɾ e 
cessi	s 'e s i	 s 'ɛ s i 
cessin	s 'e s i n	 s 'ɛ s i n 
cèstrum	s 'ɛ s t ɾ u m	 s e s t ɾ 'u m 
ciberespai	s i β e ɾ e s p 'a j	 s i β e ɾ e s p 'a i 
ciberespais	s i β e ɾ e s p 'a j s	 s i β e ɾ e s p 'a i s 
Cíclades	s 'i k l a ð e s	 s i k l 'a ð e s 
cilíndrica	s i l 'i n d ɾ i k a	 s i l i n d ɾ 'i k a 
cínamom	s 'i n a m o m	 s i n a m 'o m 
cirrus	s 'i r u s	 s i r 'u s 
cítara	s 'i t a ɾ a	 s i t 'a ɾ a 
clavicèmbal	k l a β i s 'ɛ m b a l	 k l a β i s e m b 'a l 
clixé	k l i ʃ 'e	 k l j ʃ 'e 
clona	k l 'ɔ n a	 k l 'o n a 
clones	k l 'ɔ n e s	 k l 'o n e s 
cloni	k l 'ɔ n i	 k l 'o n i 
clonin	k l 'ɔ n i n	 k l 'o n i n 
clonis	k l 'ɔ n i s	 k l 'o n i s 
clono	k l 'ɔ n o	 k l 'o n o 
clora	k l 'ɔ ɾ a	 k l 'o ɾ a 
clores	k l 'ɔ ɾ e s	 k l 'o ɾ e s 
closes	k l 'ɔ z e s	 k l 'o s e s 
Cluses	k l 'u z e s	 k l 'u s e s 
cobla	k 'o β l a	 k 'ɔ β l a 
cobles	k 'o β l e s	 k 'ɔ β l e s 
cobra	k 'o β ɾ a	 k 'ɔ β ɾ a 
cobren	k 'o β ɾ e n	 k 'ɔ β ɾ e n 
cobres	k 'o β ɾ e s	 k 'ɔ β ɾ e s 
cobro	k 'o β ɾ o	 k 'ɔ β ɾ o 
coco	k 'o k o	 k 'ɔ k o 
còctels	k 'ɔ k t e l s	 k o k t 'ɛ l s 
cofoi	k o f 'ɔ j	 k o f 'o i 
cogoma	k o ɣ 'ɔ m a	 k o ɣ 'o m a 
cogombre	k o ɣ 'o m b ɾ e	 k o ɣ 'ɔ m b ɾ e 
coit	k 'ɔ j t	 k o 'i t 
colesteatoma	k o l e s t e a t 'ɔ m a	 k o l e s t e a t 'o m a 
colesteatomes	k o l e s t e a t 'ɔ m e s	 k o l e s t e a t 'o m e s 
colossos	k o l 'o s o s	 k o l 'ɔ s o s 
colze	k 'o l z e	 k 'ɔ l z e 
colzes	k 'o l z e s	 k 'ɔ l z e s 
comboi	k o m b 'ɔ j	 k o m b 'o i 
cometre	k o m 'e t ɾ e	 k o m 'ɛ t ɾ e 
còmplices	k 'ɔ m p l i s e s	 k o m p l 'i s e s 
compost	k o m p 'ɔ s t	 k o m p 'o s t 
compra	k 'o m p ɾ a	 k 'ɔ m p ɾ a 
compren	k 'o m p ɾ e n	 k 'ɔ m p ɾ e n 
compres	k 'o m p ɾ e s	 k 'ɔ m p ɾ e s 
compro	k 'o m p ɾ o	 k 'ɔ m p ɾ o 
comprometre	k o m p ɾ o m 'e t ɾ e	 k o m p ɾ o m 'ɛ t ɾ e 
compta	k 'o m t a	 k 'ɔ m p t a 
compte	k 'o m t e	 k 'ɔ m p t e 
compten	k 'o m t e n	 k 'ɔ m p t e n 
comptes	k 'o m t e s	 k 'ɔ m p t e s 
compto	k 'o m t o	 k 'ɔ m p t o 
comte	k 'o m t e	 k 'ɔ m t e 
comtes	k 'o m t e s	 k 'ɔ m t e s 
conca	k 'o ŋ k a	 k 'ɔ ŋ k a 
conques	k 'o ŋ k e s	 k 'ɔ ŋ k e s 
conquesta	k o ŋ k 'e s t a	 k o ŋ k 'ɛ s t a 
consens	k o n s 'e n s	 k o n s 'ɛ n s 
consta	k 'o n s t a	 k 'ɔ n s t a 
consten	k 'o n s t e n	 k 'ɔ n s t e n 
consuetud	k o n s u e t 'u t	 k o n s e t 'u 
conta	k 'o n t a	 k 'ɔ n t a 
conte	k 'o n t e	 k 'ɔ n t e 
conten	k 'o n t e n	 k 'ɔ n t e n 
contes	k 'o n t e s	 k 'ɔ n t e s 
contra	k 'o n t ɾ a	 k 'ɔ n t ɾ a 
copa	k 'o p a	 k 'ɔ p a 
copes	k 'o p e s	 k 'ɔ p e s 
copsa	k 'o p s a	 k 'ɔ p s a 
cora	k 'ɔ ɾ a	 k 'o ɾ a 
coratjosa	k o ɾ a dʒ 'o z a	 k o ɾ a dʒ 'o s a 
corre	k 'o r e	 k 'ɔ r e 
corren	k 'o r e n	 k 'ɔ r e n 
corretja	k o r 'e dʒ a	 k o r 'ɛ dʒ a 
corro	k 'o r o	 k 'ɔ r o 
corrompre	k o r 'o m p ɾ e	 k o r 'ɔ m p ɾ e 
cosa	k 'ɔ z a	 k 'o z a 
coses	k 'ɔ z e s	 k 'o z e s 
cosmos	k 'o z m o s	 k 'ɔ z m o s 
cossol	k o s 'o l	 k o s 'ɔ l 
cost	k 'ɔ s t	 k 'o s t 
cotxe	k 'o tʃ e	 k 'ɔ tʃ e 
cotxes	k 'o tʃ e s	 k 'ɔ tʃ e s 
crec	k ɾ 'e k	 k ɾ 'ɛ k 
creï	k ɾ 'e i	 k ɾ 'ɛ i 
creïn	k ɾ 'e i n	 k ɾ e 'i n 
cremes	k ɾ 'e m e s	 k ɾ 'ɛ m e s 
cresta	k ɾ 'e s t a	 k ɾ 'ɛ s t a 
crestes	k ɾ 'e s t e s	 k ɾ 'ɛ s t e s 
cretes	k ɾ 'ɛ t e s	 k ɾ 'e t e s 
cúbits	k 'u β i t s	 k u β 'i t s 
cuboide	k u β 'ɔ j ð e	 k u β o 'i ð e 
cudol	k u ð 'o l	 k u ð 'ɔ l 
cuidada	k u j ð 'a ð a	 k u i ð 'a ð a 
cuidades	k u j ð 'a ð e s	 k u i ð 'a ð e s 
cuidat	k u j ð 'a t	 k u i ð 'a t 
cuidats	k u j ð 'a t s	 k u i ð 'a t s 
cuidava	k u j ð 'a β a	 k u i ð 'a β a 
cuinada	k u j n 'a ð a	 k u i n 'a ð a 
cuinades	k u j n 'a ð e s	 k u i n 'a ð e s 
cuinar	k u j n 'a	 k u i n 'a 
cuinat	k u j n 'a t	 k u i n 'a t 
cuinats	k u j n 'a t s	 k u i n 'a t s 
cuiner	k u j n 'e	 k u i n 'e 
cuitada	k u j t 'a ð a	 k u i t 'a ð a 
cuitades	k u j t 'a ð e s	 k u i t 'a ð e s 
cuitar	k u j t 'a	 k u i t 'a 
cuitat	k u j t 'a t	 k u i t 'a t 
cuitats	k u j t 'a t s	 k u i t 'a t s 
currículum	k u r 'i k u l u m	 k u r i k u l 'u m 
currículums	k u r 'i k u l u m s	 k u r i k u l 'u m s 
daina	d 'a j n a	 d 'a i n a 
damisel·la	d a m i z 'ɛ l a	 d a m i s 'ɛ l a 
dantesc	d a n t 'e s k	 d a n t 'ɛ s k 
dantesca	d a n t 'e s k a	 d a n t 'ɛ s k a 
dantesques	d a n t 'e s k e s	 d a n t 'ɛ s k e s 
darrere	d a r 'e ɾ e	 d a r 'ɛ ɾ e 
dec	d 'e k	 d 'ɛ k 
dècade	d 'ɛ k a ð e	 d e k 'a ð e 
defendre	d e f 'e n d ɾ e	 d e f 'ɛ n d ɾ e 
dèficit	d 'ɛ f i s i t	 d e f i s 'i t 
defora	d e f 'ɔ ɾ a	 d e f 'o ɾ a 
deixeble	d e j ʃ 'e β l e	 d e j ʃ 'ɛ β l e 
deixis	d 'e j ʃ i s	 d 'ɛ j ʃ i s 
deler	d e l 'ɛ	 d e l 'e 
delmen	d 'ɛ l m e n	 d 'e l m e n 
dens	d 'e n s	 d 'ɛ n s 
densa	d 'e n s a	 d 'ɛ n s a 
denses	d 'e n s e s	 d 'ɛ n s e s 
densos	d 'e n s o s	 d 'ɛ n s o s 
dependre	d e p 'e n d ɾ e	 d e p 'ɛ n d ɾ e 
desatendre	d e z a t 'e n d ɾ e	 d e z a t 'ɛ n d ɾ e 
descompte	d e s k 'o m t e	 d e s k 'ɔ m p t e 
desdoblament	d e z ð o β l a m 'e n	 d e z ð 'ɔ β l a m 'e n 
desembeinar	d e z e m b e j n 'a	 d e z e m b e i n 'a 
desembre	d e z 'e m b ɾ e	 d e s 'ɛ m b ɾ e 
deshidratar	d e s i ð ɾ a t 'a	 d e z i ð ɾ a t 'a 
deshonest	d e s o n 'e s t	 d e s o n 'ɛ s t 
desig	d e z 'i tʃ	 d e z 'i 
desigs	d e z 'i tʃ s	 d e z 'i s 
deso	d 'e z o	 d 'ɛ z o 
despendre	d e s p 'e n d ɾ e	 d e s p 'ɛ n d ɾ e 
destra	d 'e s t ɾ a	 d 'ɛ s t ɾ a 
destres	d 'e s t ɾ e s	 d 'ɛ s t ɾ e s 
desuetud	d e z u e t 'u t	 d e z u e t 'u 
detectivesc	d e t e k t i β 'e s k	 d e t e k t i β 'ɛ s k 
detectivesca	d e t e k t i β 'e s k a	 d e t e k t i β 'ɛ s k a 
difondre	d i f 'o n d ɾ e	 d i f 'ɔ n d ɾ e 
difoses	d i f 'o z e s	 d i f 'o s e s 
dimecres	d i m 'e k ɾ e s	 d i m 'ɛ k ɾ e s 
dimoni	d i m 'ɔ n i	 d i m 'o n i 
dimonis	d i m 'ɔ n i s	 d i m 'o n i s 
displicent	d i s p l i s 'e n	 d i s p l i k 'e n 
disseny	d i s 'e ɲ	 d i s 'ɛ ɲ 
distendre	d i s t 'e n d ɾ e	 d i s t 'ɛ n d ɾ e 
divendres	d i β 'e n d ɾ e s	 d i β 'ɛ n d ɾ e s 
dividend	d i β i ð 'e n	 d i β i ð 'ɛ n i 
dobla	d 'o β l a	 d 'ɔ β l a 
doble	d 'o β l e	 d 'ɔ β l e 
doblen	d 'o β l e n	 d 'ɔ β l e n 
dobles	d 'o β l e s	 d 'ɔ β l e s 
dodecaedres	d o ð e k a 'ɛ ð ɾ e s	 d o ð e k a 'ɛ d ɾ e s 
dogma	d 'o g m a	 d 'ɔ g m a 
dogmes	d 'o g m e s	 d 'ɔ g m e s 
dolça	d 'o l s a	 d 'ɔ l s a 
dolçaina	d o l s 'a j n a	 d o l s 'a i n a 
dolces	d 'o l s e s	 d 'ɔ l s e s 
dolços	d 'o l s o s	 d 'ɔ l s o s 
doler	d o l 'ɛ	 d o l 'e 
dona	d 'ɔ n a	 d 'o n a 
donen	d 'o n e n	 d 'ɔ n e n 
dones	d 'ɔ n e s	 d 'o n e s 
dònut	d 'ɔ n u t	 d o n 'u t 
dotze	d 'o d z e	 d 'ɔ d z e 
Ebre	'e β ɾ e	 'ɛ β ɾ e 
eco	'e k o	 'ɛ k o 
ego	'e ɣ o	 'ɛ ɣ o 
ei	'e j	 'ɛ i 
eina	'e j n a	 s i n a 
eivissenc	e j β i s 'e ŋ	 e j β i s 'e n s 
eland	e l 'a n	 e l 'a n i 
elèctrica	e l 'ɛ k t ɾ i k a	 e l e k t ɾ 'i k a 
elèctrics	e l 'ɛ k t ɾ i k s	 e l e k t ɾ 'i k s 
elèctrode	e l 'ɛ k t ɾ o ð e	 e l e k t ɾ 'ɔ ð e 
element	e l e m 'e n	 ɛ l e m 'e n 
Elies	e l 'i e s	 a l 'i e s 
el·lipsoide	e l i p s 'ɔ j ð e	 e l i p s o 'i ð e 
Eloi	e l 'ɔ j	 a l 'o i 
elusiva	e l u z 'i β a	 ɛ l u z 'i β a 
elusives	e l u z 'i β e s	 ɛ l u z 'i β e s 
empaitar	a m p a j t 'a	 a m p a i t 'a 
empra	'e m p ɾ a	 a m p ɾ a 
empremta	a m p ɾ 'e m t a	 a m p ɾ 'ɛ m t a 
encendre	a n s 'e n d ɾ e	 a n s 'ɛ n d ɾ e 
encens	a n s 'e n s	 a n s 'ɛ n s 
encesos	a n s 'e z o s	 a ŋ 'e z o s 
encreuament	a ŋ k ɾ e w a m 'e n	 a ŋ k ɾ e u a m 'e n 
endarrere	a n d a r 'e ɾ e	 a n d a r 'ɛ ɾ e 
endauat	a n d a w 'a t	 a n d a u 'a t 
ene	'e n e	 g n e 
ènema	'ɛ n e m a	 a n 'e m a 
enganxoses	a ŋ g a n tʃ 'o z e s	 a ŋ g a n tʃ 'o s e s 
engreixat	a ŋ g ɾ e j ʃ 'a t	 a ŋ g ɾ e i ʃ 'a t 
engreixats	a ŋ g ɾ e j ʃ 'a t s	 a ŋ g ɾ e i ʃ 'a t s 
enlairament	a n l a j ɾ a m 'e n	 e n l a i ɾ a m 'e n 
enlaire	a n l 'a j ɾ e	 e n l 'a j ɾ e 
enmig	a m m 'i tʃ	 a n m 'i 
enquesta	a ŋ k 'e s t a	 a ŋ k 'ɛ s t a 
ensems	a n s 'e m s	 a n s 'ɛ m s 
entendre	a n t 'e n d ɾ e	 a n t 'ɛ n d ɾ e 
èntesi	'ɛ n t e z i	 a n t e z i 
entre	'e n t ɾ e	 a n t ɾ e 
entres	'e n t ɾ e s	 a n t ɾ e s 
enzim	a n z 'i m	 e n z 'i m 
ep	'e p	 'ɛ p 
èpsilon	'ɛ p s i l o n	 ɛ p s i l 'o n 
eqüestre	e k w 'e s t ɾ e	 e k w 'ɛ s t ɾ e 
equivoco	e k i β 'o k o	 e k i β 'ɔ k o 
érem	'e ɾ e m	 e ɾ 'e m 
erren	'ɛ r e n	 'e r e n 
escafoide	a s k a f 'ɔ j ð e	 a s k a f o 'i ð e 
escairada	a s k a j ɾ 'a ð a	 a s k a i ɾ 'a ð a 
escairades	a s k a j ɾ 'a ð e s	 a s k a i ɾ 'a ð e s 
escairar	a s k a j ɾ 'a	 a s k a i ɾ 'a 
escairat	a s k a j ɾ 'a t	 a s k a i ɾ 'a t 
escairats	a s k a j ɾ 'a t s	 a s k a i ɾ 'a t s 
escletxa	a s k l 'e tʃ a	 a s k l 'ɛ tʃ a 
escolta	a s k 'o l t a	 a s k 'ɔ l t a 
escombra	a s k 'o m b ɾ a	 a s k 'ɔ m b ɾ a 
escometre	a s k o m 'e t ɾ e	 a s k o m 'ɛ t ɾ e 
esfinx	a s f 'i n tʃ	 e s f 'i n 
esglai	a z ɣ l 'a j	 a z ɣ l 'a i 
esguerro	a z ɣ 'ɛ r o	 a z ɣ u 'ɛ r o 
espai	a s p 'a j	 a s p 'a i 
espais	a s p 'a j s	 a s p 'a i s 
espectre	a s p 'e k t ɾ e	 a s p 'ɛ k t ɾ e 
espetec	a s p e t 'e k	 a s p e t 'ɛ k 
esplai	a s p l 'a j	 a s p l 'a i 
espona	a s p 'ɔ n a	 a s p 'o n a 
espondilodiscitis	a s p o n d i l o ð i s 'i t i s	 a s p o n d i l o ð i s k 'i t i s 
est	'e s t	 'a s t 
estai	a s t 'a j	 a s t 'a i 
estanyol	a s t a ɲ 'o l	 a s t a ɲ 'ɔ l 
estendre	a s t 'e n d ɾ e	 a s t 'ɛ n d ɾ e 
estepa	a s t 'e p a	 a s t 'ɛ p a 
esteperol	a s t e p e ɾ 'o l	 a s t e p e ɾ 'ɔ l 
estiueig	a s t i w 'e tʃ	 a s t i u 'e tʃ 
estiuejada	a s t i w e ʒ 'a ð a	 a s t i u e ʒ 'a ð a 
estiuejades	a s t i w e ʒ 'a ð e s	 a s t i u e ʒ 'a ð e s 
estiuejar	a s t i w e ʒ 'a	 a s t i u e ʒ 'a 
estiuejat	a s t i w e ʒ 'a t	 a s t i u e ʒ 'a t 
estiuejats	a s t i w e ʒ 'a t s	 a s t i u e ʒ 'a t s 
estiuenc	a s t i w 'e ŋ	 a s t i w 'e n s 
estómac	a s t 'o m a k	 a s t o m 'a k 
estramoni	a s t ɾ a m 'ɔ n i	 a s t ɾ a m 'o n i 
estranger	a s t ɾ a n dʒ 'e	 a s t ɾ a ŋ 'e 
estrateg	a s t ɾ a t 'e k	 a s t ɾ a t 'ɛ g 
estri	'ɛ s t ɾ i	 a s t ɾ i 
estris	'ɛ s t ɾ i s	 a s t ɾ i s 
eta	'ɛ t a	 'e t a 
età	e t 'a	 a t 'a 
etcètera	e t s 'ɛ t e ɾ a	 a t s 'ɛ t e ɾ a 
etíop	e t 'i o p	 a t 'i o p 
EUA	'ɛ w a	 'ɛ u a 
exabrupte	e g z a β ɾ 'u p t e	 e k s a β ɾ 'u p t e 
examina	e g z a m 'i n a	 e k s a m 'i n a 
excedent	e k s e ð 'e n	 e k s s e ð 'e n 
excedida	e k s e ð 'i ð a	 e k s e e ð 'i ð a 
excedides	e k s e ð 'i ð e s	 e k s e e ð 'i ð e s 
excedir	e k s e ð 'i	 e k s e e ð 'i 
excedit	e k s e ð 'i t	 e k s e e ð 'i t 
excedits	e k s e ð 'i t s	 e k s e e ð 'i t s 
excèntric	e k s 'ɛ n t ɾ i k	 e k s k n t ɾ i k 
excentricitat	e k s e n t ɾ i s i t 'a t	 e k s e e n t ɾ i s i t 'a t 
excés	e k s 'e s	 e k s k s 
exemple	e g z 'e m p l e	 e g z 'ɛ m p l e 
exempt	e g z 'e m t	 e g z 'ɛ m p t 
exili	e g z 'i l i	 e k s 'i l i 
exotòxic	e g z o t 'ɔ k s i k	 e k s o t 'ɔ k s i k 
expresses	e k s p ɾ 'e s e s	 e k s p ɾ 'ɛ s e s 
expressos	e k s p ɾ 'e s o s	 e k s p ɾ 'ɛ s o s 
extens	e k s t 'e n s	 e k s t 'ɛ n s 
extensa	e k s t 'e n s a	 e k s t 'ɛ n s a 
extenses	e k s t 'e n s e s	 e k s t 'ɛ n s e s 
extensos	e k s t 'e n s o s	 e k s t 'ɛ n s o s 
extremeny	e k s t ɾ e m 'e ɲ	 e k s t ɾ e m 'ɛ ɲ 
extremenya	e k s t ɾ e m 'e ɲ a	 e k s t ɾ e m 'ɛ ɲ a 
Fàbregas	f 'a β ɾ e ɣ a s	 f a β ɾ e ɣ 'a s 
fageda	f a ʒ 'e ð a	 f a ʒ 'ɛ ð a 
fagosoma	f a ɣ o z 'ɔ m a	 f a ɣ o z 'o m a 
faisà	f a j z 'a	 f a i z 'a 
fajol	f a ʒ 'o l	 f a ʒ 'ɔ l 
fatxenda	f a tʃ 'e n d a	 f a tʃ 'ɛ n d a 
fe	f 'e	 f 'ɛ 
feble	f 'e β l e	 f 'ɛ β l e 
febles	f 'e β l e s	 f 'ɛ β l e s 
febre	f 'e β ɾ e	 f 'ɛ β ɾ e 
febres	f 'e β ɾ e s	 f 'ɛ β ɾ e s 
fecund	f e k 'u n	 f e k 'u n i 
fecunds	f e k 'u n s	 f e k 'u n i s 
feinada	f e j n 'a ð a	 f e i n 'a ð a 
feiner	f e j n 'e	 f e i n 'e 
fèl·lera	f 'ɛ l e ɾ a	 f e l 'e ɾ a 
ferren	f 'ɛ r e n	 f 'e r e n 
fes	f 'e s	 f 'ɛ s 
Fes	f 'e s	 f 'ɛ s 
fesol	f e z 'o l	 f e z 'ɔ l 
fessin	f 'e s i n	 f 'ɛ s i n 
fessis	f 'e s i s	 f 'ɛ s i s 
festa	f 'e s t a	 f 'ɛ s t a 
festes	f 'e s t e s	 f 'ɛ s t e s 
fetge	f 'e dʒ e	 f 'ɛ dʒ e 
fideuà	f i ð e w 'a	 f i ð e u 'a 
figuerenc	f i ɣ e ɾ 'e ŋ	 f i ɣ e ɾ 'e n s 
fillol	f i ʎ 'o l	 f i ʎ 'ɔ l 
finestra	f i n 'e s t ɾ a	 f i n 'ɛ s t ɾ a 
flairada	f l a j ɾ 'a ð a	 f l a i ɾ 'a ð a 
flairades	f l a j ɾ 'a ð e s	 f l a i ɾ 'a ð e s 
flairar	f l a j ɾ 'a	 f l a i ɾ 'a 
flairat	f l a j ɾ 'a t	 f l a i ɾ 'a t 
flairats	f l a j ɾ 'a t s	 f l a i ɾ 'a t s 
flamenc	f l a m 'e ŋ	 f l a m 'e n s 
fleca	f l 'e k a	 f l 'ɛ k a 
flegma	f l 'e g m a	 f l 'ɛ g m a 
fleques	f l 'e k e s	 f l 'ɛ k e s 
fletxa	f l 'e tʃ a	 f l 'ɛ tʃ a 
fletxes	f l 'e tʃ e s	 f l 'ɛ tʃ e s 
floricol	f l o ɾ i k 'o l	 f l o ɾ i k 'ɔ l 
fluid	f l 'u j t	 f l 'u j i 
Foix	f 'o j ʃ	 f 'o tʃ 
folla	f 'o ʎ a	 f 'ɔ ʎ a 
folles	f 'o ʎ e s	 f 'ɔ ʎ e s 
fonda	f 'o n d a	 f 'ɔ n d a 
fondes	f 'o n d e s	 f 'ɔ n d e s 
fondo	f 'o n d o	 f 'ɔ n d o 
fondos	f 'o n d o s	 f 'ɔ n d o s 
fondre	f 'o n d ɾ e	 f 'ɔ n d ɾ e 
fora	f 'ɔ ɾ a	 f 'o ɾ a 
foren	f 'o ɾ e n	 f 'ɔ ɾ e n 
fosca	f 'o s k a	 f 'ɔ s k a 
foscos	f 'o s k o s	 f 'ɔ s k o s 
fosques	f 'o s k e s	 f 'ɔ s k e s 
foten	f 'o t e n	 f 'ɔ t e n 
foto	f 'o t o	 f 'ɔ t o 
fotos	f 'o t o s	 f 'ɔ t o s 
fotre	f 'o t ɾ e	 f 'ɔ t ɾ e 
Francesc	f ɾ a n s 'e s k	 f ɾ a n s 'ɛ s k 
fre	f ɾ 'e	 f ɾ 'ɛ 
frec	f ɾ 'e k	 f ɾ 'ɛ k 
fred	f ɾ 'e t	 f ɾ 'e 
freda	f ɾ 'e ð a	 f ɾ 'ɛ ð a 
fredes	f ɾ 'e ð e s	 f ɾ 'ɛ ð e s 
freds	f ɾ 'e t s	 f ɾ 'ɛ s 
frega	f ɾ 'e ɣ a	 f ɾ 'ɛ ɣ a 
frego	f ɾ 'e ɣ o	 f ɾ 'ɛ ɣ o 
fregues	f ɾ 'e ɣ e s	 f ɾ 'ɛ ɣ e s 
freno	f ɾ 'e n o	 f ɾ 'ɛ n o 
frens	f ɾ 'e n s	 f ɾ 'ɛ n s 
fresc	f ɾ 'e s k	 f ɾ 'ɛ s k 
fresca	f ɾ 'e s k a	 f ɾ 'ɛ s k a 
frescos	f ɾ 'e s k o s	 f ɾ 'ɛ s k o s 
fresques	f ɾ 'e s k e s	 f ɾ 'ɛ s k e s 
fumerol	f u m e ɾ 'o l	 f u m e ɾ 'ɔ l 
furibund	f u ɾ i β 'u n	 f u ɾ i β 'u n i 
gai	g 'a j	 g 'a i 
gaire	g 'a j ɾ e	 g 'a i ɾ e 
gairebé	g a j ɾ e β 'e	 g a i ɾ e β 'e 
gaiter	g a j t 'e	 g a i t 'e 
galilea	g a l i l 'ɛ a	 g a l i l 'e a 
galindaina	g a l i n d 'a j n a	 g a l i n d 'a i n a 
galindaines	g a l i n d 'a j n e s	 g a l i n d 'a i n e s 
gallec	g a ʎ 'e k	 g a ʎ 'ɛ k 
galleda	g a ʎ 'e ð a	 g a ʎ 'ɛ ð a 
ganyol	g a ɲ 'o l	 g a ɲ 'ɔ l 
gasela	g a z 'ɛ l a	 g a s 'ɛ l a 
gasoil	g a z 'ɔ j l	 g a z o 'i l 
gegantesc	dʒ e ɣ a n t 'e s k	 dʒ e ɣ a n t 'ɛ s k 
gelen	dʒ 'ɛ l e n	 dʒ 'e l e n 
gemec	dʒ e m 'e k	 dʒ e m 'ɛ k 
gemma	dʒ 'e m m a	 dʒ 'ɛ m m a 
Gemma	dʒ 'e m m a	 dʒ 'ɛ m m a 
gens	dʒ 'e n s	 dʒ 'ɛ n s 
geocèntrics	dʒ e o s 'ɛ n t ɾ i k s	 dʒ e o s e n t ɾ 'i k s 
gespa	dʒ 'e s p a	 g s p a 
gest	dʒ 'e s t	 dʒ 'ɛ s t 
gesta	dʒ 'e s t a	 dʒ 'ɛ s t a 
gestes	dʒ 'e s t e s	 dʒ 'ɛ s t e s 
gestos	dʒ 'e s t o s	 dʒ 'ɛ s t o s 
ginebra	dʒ i n 'e β ɾ a	 dʒ i n 'ɛ β ɾ a 
Ginebra	dʒ i n 'e β ɾ a	 dʒ i n 'ɛ β ɾ a 
ginesta	dʒ i n 'e s t a	 dʒ i n 'ɛ s t a 
gland	g l 'a n	 g l 'a n i 
glands	g l 'a n s	 g l 'a n i s 
glop	g l 'o p	 g l 'ɔ p 
glosa	g l 'ɔ z a	 g l 'o z a 
gloses	g l 'ɔ z e s	 g l 'o z e s 
goig	g 'ɔ tʃ	 g o 'i a 
golfa	g 'o l f a	 g 'ɔ l f a 
golfes	g 'o l f e s	 g 'ɔ l f e s 
gossa	g 'o s a	 g 'ɔ s a 
gossos	g 'o s o s	 g 'ɔ s o s 
gota	g 'o t a	 g 'ɔ t a 
gotes	g 'o t e s	 g 'ɔ t e s 
granger	g ɾ a n dʒ 'e	 g ɾ a ŋ 'e 
granuloma	g ɾ a n u l 'ɔ m a	 g ɾ a n u l 'o m a 
grànuls	g ɾ 'a n u l s	 g ɾ a n 'u l s 
grec	g ɾ 'e k	 g ɾ 'ɛ k 
grecs	g ɾ 'e k s	 g ɾ 'ɛ k s 
grega	g ɾ 'e ɣ a	 g ɾ 'ɛ ɣ a 
gregues	g ɾ 'e ɣ e s	 g ɾ 'ɛ ɣ e s 
greixat	g ɾ e j ʃ 'a t	 g ɾ e i ʃ 'a t 
gresca	g ɾ 'e s k a	 g ɾ 'ɛ s k a 
grinyol	g ɾ i ɲ 'o l	 g ɾ i ɲ 'ɔ l 
groguenc	g ɾ o ɣ 'e ŋ	 g ɾ o ɣ 'e n s 
gronxa	g ɾ 'o n tʃ a	 g ɾ 'ɔ n tʃ a 
grop	g ɾ 'o p	 g ɾ 'ɔ p 
grotesc	g ɾ o t 'e s k	 g ɾ o t 'ɛ s k 
guai	g w 'a j	 g w 'a i 
guaità	g w a j t 'a	 g w a i t 'a 
guaitar	g w a j t 'a	 g w a i t 'a 
guaitat	g w a j t 'a t	 g w a i t 'a t 
gualdrapa	g w a l d ɾ 'a p a	 g u a l d ɾ 'a p a 
guerra	g 'ɛ r a	 g u 'ɛ r a 
guilla	g 'i ʎ a	 g u 'i ʎ a 
guinda	g 'i n d a	 g u 'i n d a 
guit	g 'i t	 g w 'i t 
guitza	g 'i d z a	 g w 'i d z a 
guix	g 'i ʃ	 g 'i tʃ 
guixa	g 'i ʃ a	 g 'i tʃ a 
guru	g 'u ɾ u	 g u ɾ 'u 
hàbitat	'a β i t a t	 a β i t 'a t 
hàbitats	'a β i t a t s	 a β i t 'a t s 
hafni	'a f n i	 u 'a f n i 
haig	'a tʃ	 o 'i a 
Hainan	a j n 'a n	 a i n 'a n 
Haití	a j t 'i	 a i t 'i 
halat	a l 'a t	 u a l 'a t 
halats	a l 'a t s	 u a l 'a t s 
hamaca	a m 'a k a	 u a m 'a k a 
he	'e	 'a 
hebraic	e β ɾ 'a j k	 e β ɾ 'a i k 
heli	'ɛ l i	 i 'ɛ l i 
Hèmera	'ɛ m e ɾ a	 u m 'e ɾ a 
heparina	e p a ɾ 'i n a	 a p a ɾ 'i n a 
hepàtic	e p 'a t i k	 a e p 'a t i k 
hepàtica	e p 'a t i k a	 a e p 'a t i k a 
hepàtics	e p 'a t i k s	 a e p 'a t i k s 
hepàtiques	e p 'a t i k e s	 a e p 'a t i k e s 
hepatitis	e p a t 'i t i s	 a p a t 'i t i s 
hesitada	e z i t 'a ð a	 a z i t 'a ð a 
hesitades	e z i t 'a ð e s	 a z i t 'a ð e s 
hesitar	e z i t 'a	 a z i t 'a 
hesitat	e z i t 'a t	 a z i t 'a t 
hesitats	e z i t 'a t s	 a z i t 'a t s 
hevea	e β 'ɛ a	 a β 'e a 
híbrid	'i β ɾ i t	 a β ɾ i t 
hidroelèctrica	i ð ɾ o e l 'ɛ k t ɾ i k a	 i ð ɾ o e l e k t ɾ 'i k a 
hidroelèctrics	i ð ɾ o e l 'ɛ k t ɾ i k s	 i ð ɾ o e l e k t ɾ 'i k s 
himen	'i m e n	 a m e n 
himne	'i m n e	 u 'i m n e 
hiperespai	i p e ɾ e s p 'a j	 i p e ɾ e s p 'a i 
hiperespais	i p e ɾ e s p 'a j s	 i p e ɾ e s p 'a i s 
hipnosi	i b n 'ɔ z i	 i p n 'ɔ z i 
hipnòtic	i b n 'ɔ t i k	 i p n 'ɔ t i k 
hipnotisme	i b n o t 'i z m e	 i p n o t 'i z m e 
hipocamp	i p o k 'a m	 i p o k 'a m p 
hola	'ɔ l a	 'a l a 
holmi	'ɔ l m i	 u 'ɔ l m i 
home	'ɔ m e	 u m e 
hondureny	o n d u ɾ 'e ɲ	 o n d u ɾ 'ɛ ɲ 
honest	o n 'e s t	 ɔ n 'ɛ s t 
hoquei	o k 'e j	 ɔ k 'ɛ i 
hora	'ɔ ɾ a	 a ɾ a 
hores	'ɔ ɾ e s	 a ɾ e s 
hostes	'ɔ s t e s	 i s t e s 
hotel	o t 'ɛ l	 ɔ t 'ɛ l 
humus	'u m u s	 u m u s 
ictus	'i k t u s	 i k t 'u s 
illenc	i ʎ 'e ŋ	 i ʎ 'e n s 
immens	i m m 'e n s	 i m m 'ɛ n s 
ímpetu	'i m p e t u	 i m p e t 'u 
impremta	i m p ɾ 'e m t a	 i m p ɾ 'ɛ m t a 
inhalada	i n a l 'a ð a	 i n i a l 'a ð a 
inhalades	i n a l 'a ð e s	 i n i a l 'a ð e s 
inhalant	i n a l 'a n	 i n e l 'a n 
inhalar	i n a l 'a	 i n i a l 'a 
inhalat	i n a l 'a t	 i n i a l 'a t 
inhalats	i n a l 'a t s	 i n i a l 'a t s 
inhòspit	i n 'ɔ s p i t	 i n 'e s p i t 
ininterromput	i n i n t e r o m p 'u t	 i n i n t e r 'o m p 'u t 
instituiré	i n s t i t u i ɾ 'e	 i n s t i t u j ɾ 'e 
insulinoma	i n s u l i n 'ɔ m a	 i n s u l i n 'o m a 
intens	i n t 'e n s	 i n t 'ɛ n s 
interrompre	i n t e r 'o m p ɾ e	 i n t e r 'ɔ m p ɾ e 
ípsilon	'i p s i l o n	 i p s i l 'o n 
irascible	i ɾ a s 'i β l e	 i ɾ a s k 'i β l e 
irascibles	i ɾ a s 'i β l e s	 i ɾ a s k 'i β l e s 
jazz	dʒ 'a s	 dʒ 'a z i 
jazzístic	dʒ a z z 'i s t i k	 dʒ a d z 'i s t i k 
jesuïta	dʒ e z u 'i t a	 dʒ e s u 'i t a 
jòquer	dʒ 'ɔ k e	 dʒ o k 'e 
jove	dʒ 'o β e	 dʒ 'ɔ β e 
jóvens	dʒ 'o β e n s	 dʒ o β 'e n s 
joves	dʒ 'o β e s	 dʒ 'ɔ β e s 
júnyer	dʒ 'u ɲ e	 dʒ u ɲ 'e 
Kazakhstan	k a z a k s t 'a n	 k a z a k 'ɔ t 'a n 
Kenya	k 'e ɲ a	 k 'ɛ ɲ a 
kenyà	k e ɲ 'a	 dʒ e ɲ 'a 
kenyana	k e ɲ 'a n a	 dʒ e ɲ 'a n a 
kiwi	k 'i β i	 a 'i z i 
Kuwait	k u β 'a j t	 k u ɾ 'a i t 
lacrosse	l a k ɾ 'o s e	 l a k ɾ 'ɔ s e 
lemes	l 'e m e s	 l 'ɛ m e s 
lèmur	l 'ɛ m u	 l e m 'u 
lepra	l 'e p ɾ a	 l 'ɛ p ɾ a 
Lesotho	l e z 'ɔ t o	 l e z 'ɔ t e 
Líban	l 'i β a n	 l i β 'a n 
lingot	l i ŋ g 'o t	 l i ŋ g 'ɔ t 
liquar	l i k w 'a	 l i k 'a 
lisosoma	l i z o z 'ɔ m a	 l i z o z 'o m a 
llamp	ʎ 'a m	 ʎ 'a m p 
llampec	ʎ a m p 'e k	 ʎ a m p 'ɛ k 
llebre	ʎ 'e β ɾ e	 ʎ 'ɛ β ɾ e 
llega	ʎ 'e ɣ a	 ʎ 'ɛ ɣ a 
llegenda	ʎ e ʒ 'e n d a	 ʎ e ʒ 'ɛ n d a 
llegendes	ʎ e ʒ 'e n d e s	 ʎ e ʒ 'ɛ n d e s 
llei	ʎ 'e j	 ʎ 'ɛ i 
Lleida	ʎ 'e j ð a	 ʎ e 'i ð a 
lleis	ʎ 'e j s	 ʎ 'ɛ i s 
llenço	ʎ 'e n s o	 ʎ 'ɛ n s o 
llenços	ʎ 'e n s o s	 ʎ 'ɛ n s o s 
llenya	ʎ 'e ɲ a	 ʎ 'ɛ ɲ a 
llepa	ʎ 'e p a	 ʎ 'ɛ p a 
llesques	ʎ 'e s k e s	 ʎ 'ɛ s k e s 
llest	ʎ 'e s t	 ʎ 'ɛ s t 
llesta	ʎ 'e s t a	 ʎ 'ɛ s t a 
llestes	ʎ 'e s t e s	 ʎ 'ɛ s t e s 
llestos	ʎ 'e s t o s	 ʎ 'ɛ s t o s 
lletges	ʎ 'e dʒ e s	 ʎ 'ɛ dʒ e s 
lletja	ʎ 'e dʒ a	 ʎ 'ɛ dʒ a 
lletjos	ʎ 'e dʒ o s	 ʎ 'ɛ dʒ o s 
lletra	ʎ 'e t ɾ a	 ʎ 'ɛ t ɾ a 
lletres	ʎ 'e t ɾ e s	 ʎ 'ɛ t ɾ e s 
lleva	ʎ 'e β a	 ʎ 'ɛ β a 
lleves	ʎ 'e β e s	 ʎ 'ɛ β e s 
llevo	ʎ 'e β o	 ʎ 'ɛ β o 
lloa	ʎ 'o a	 ʎ 'ɔ a 
lloba	ʎ 'o β a	 ʎ 'ɔ β a 
lloen	ʎ 'o e n	 ʎ 'ɔ e n 
llop	ʎ 'o p	 ʎ 'ɔ p 
Llorach	ʎ o ɾ 'a k	 ʎ o ɾ 'a s i 
lluitada	ʎ u j t 'a ð a	 ʎ u i t 'a ð a 
lluitades	ʎ u j t 'a ð e s	 ʎ u i t 'a ð e s 
lluitant	ʎ u j t 'a n	 ʎ u i t 'a n 
lluitar	ʎ u j t 'a	 ʎ u i t 'a 
lluitat	ʎ u j t 'a t	 ʎ u i t 'a t 
lluitats	ʎ u j t 'a t s	 ʎ u i t 'a t s 
londinenc	l o n d i n 'e ŋ	 l o n d i n 'e n s 
Londres	l 'o n d ɾ e s	 l 'ɔ n d ɾ e s 
loquaç	l o k w 'a s	 l o k 'a s 
macedoni	m a s e ð 'ɔ n i	 m a s e ð 'o n i 
Madrid	m a ð ɾ 'i t	 m a ð ɾ 'i 
madrileny	m a ð ɾ i l 'e ɲ	 m a ð ɾ i l 'ɛ ɲ 
madrilenya	m a ð ɾ i l 'e ɲ a	 m a ð ɾ i l 'ɛ ɲ a 
madrilenyes	m a ð ɾ i l 'e ɲ e s	 m a ð ɾ i l 'ɛ ɲ e s 
mag	m 'a k	 m 'a 
Mahoma	m a 'ɔ m a	 m a u m a 
mainada	m a j n 'a ð a	 m a i n 'a ð a 
malai	m a l 'a j	 m a l 'a i 
malaisi	m a l 'a j z i	 m a l a 'i z i 
mal·lèol	m a l 'ɛ o l	 m a l e 'o l 
mallol	m a ʎ 'o l	 m a ʎ 'ɔ l 
mandonguilla	m a n d o ŋ g 'i ʎ a	 m a n d o ŋ g u 'i ʎ a 
manifest	m a n i f 'e s t	 m a n i f 'ɛ s t 
manxec	m a n tʃ 'e k	 m a n tʃ 'ɛ k 
maresme	m a ɾ 'e z m e	 m a ɾ 'ɛ z m e 
maridatge	m a ɾ i ð 'a dʒ e	 m a ɾ i ð 'a t e e 
Marràqueix	m a r 'a k e j ʃ	 m a r a k 'e j ʃ 
marrec	m a r 'e k	 m a r 'ɛ k 
matallops	m a t a ʎ 'o p s	 m a t a ʎ 'ɔ p s 
meca	m 'e k a	 m 'ɛ k a 
Meca	m 'e k a	 m 'ɛ k a 
meitat	m e j t 'a t	 m e i t 'a t 
membre	m 'e m b ɾ e	 m 'ɛ m b ɾ e 
membres	m 'e m b ɾ e s	 m 'ɛ m b ɾ e s 
menges	m 'e n dʒ e s	 m 'ɛ n dʒ e s 
menja	m 'e n dʒ a	 m 'ɛ n dʒ a 
menjo	m 'e n dʒ o	 m 'ɛ n dʒ o 
mentre	m 'e n t ɾ e	 m 'ɛ n t ɾ e 
merescuda	m e ɾ e s k 'u ð a	 m e ɾ 'e s k 'u ð a 
merescudes	m e ɾ e s k 'u ð e s	 m e ɾ 'e s k 'u ð e s 
merescut	m e ɾ e s k 'u t	 m e ɾ 'e s k 'u t 
merescuts	m e ɾ e s k 'u t s	 m e ɾ 'e s k 'u t s 
mero	m 'e ɾ o	 m 'ɛ ɾ o 
mes	m 'e s	 m 'ɛ s 
mescla	m 'e s k l a	 m 'ɛ s k l a 
mescles	m 'e s k l e s	 m 'ɛ s k l e s 
mestra	m 'e s t ɾ a	 m 'ɛ s t ɾ a 
mestre	m 'e s t ɾ e	 m 'ɛ s t ɾ e 
mestres	m 'e s t ɾ e s	 m 'ɛ s t ɾ e s 
metge	m 'e dʒ e	 m 'ɛ dʒ e 
metges	m 'e dʒ e s	 m 'ɛ dʒ e s 
metre	m 'e t ɾ e	 m 'ɛ t ɾ e 
metres	m 'e t ɾ e s	 m 'ɛ t ɾ e s 
metro	m 'e t ɾ o	 m 'ɛ t ɾ o 
metxa	m 'e tʃ a	 m 'ɛ tʃ a 
meua	m 'e w a	 m 'ɛ u a 
mig	m 'i tʃ	 m 'i 
migcampista	m i k k a m p 'i s t a	 m i ɣ k a m p 'i s t a 
mixina	m i ʃ 'i n a	 m i k s 'i n a 
mixt	m 'i k s t	 m 'i tʃ 
mocs	m 'o k s	 m 'ɔ k s 
modest	m o ð 'e s t	 m o ð 'ɛ s t 
mogol	m o ɣ 'o l	 m o ɣ 'ɔ l 
moix	m 'o j ʃ	 m 'o tʃ 
mòllera	m 'ɔ ʎ e ɾ a	 m o ʎ 'e ɾ a 
molsa	m 'o l s a	 m 'ɔ l s a 
moneda	m o n 'e ð a	 m o n 'ɛ ð a 
monocroma	m o n o k ɾ 'ɔ m a	 m o n o k ɾ 'o m a 
monocromes	m o n o k ɾ 'ɔ m e s	 m o n o k ɾ 'o m e s 
monologuista	m o n o l o ɣ 'i s t a	 m o n o l o ɣ u 'i s t a 
Montcada	m o n t k 'a ð a	 m o n e k 'a ð a 
Montse	m 'o n s e	 m 'ɔ n s e 
Montseny	m o n s 'e ɲ	 m o n s 'ɛ ɲ 
morro	m 'o r o	 m 'ɔ r o 
morros	m 'o r o s	 m 'ɔ r o s 
mosaic	m o z 'a j k	 m o z 'a i k 
mosca	m 'o s k a	 m 'ɔ s k a 
mosques	m 'o s k e s	 m 'ɔ s k e s 
mossega	m o s 'e ɣ a	 m o s 'ɛ ɣ a 
mossegaire	m o s e ɣ 'a j ɾ e	 m o s e ɣ 'a i ɾ e 
mosso	m 'o s o	 m 'ɔ s o 
mossos	m 'o s o s	 m 'ɔ s o s 
mot	m 'o t	 m 'ɔ t 
moto	m 'o t o	 m 'ɔ t o 
motos	m 'o t o s	 m 'ɔ t o s 
motoserra	m o t o z 'ɛ r a	 m o t o s 'ɛ r a 
mudèjar	m u ð 'ɛ ʒ a	 m u ð e ʒ 'a 
mujol	m u ʒ 'o l	 m u ʒ 'ɔ l 
muntanyenc	m u n t a ɲ 'e ŋ	 m u n t a ɲ 'e n s 
nadalenc	n a ð a l 'e ŋ	 n a ð a l 'e n s 
nahua	n a 'u a	 n a 'i a 
naip	n 'a j p	 n 'a i p 
neboda	n e β 'o ð a	 n e β 'ɔ ð a 
nebot	n e β 'o t	 n e β 'ɔ t 
neda	n 'e ð a	 n 'ɛ ð a 
nedes	n 'e ð e s	 n 'ɛ ð e s 
nefand	n e f 'a n	 n e f 'a n i 
nega	n 'e ɣ a	 n 'ɛ ɣ a 
nego	n 'e ɣ o	 n 'ɛ ɣ o 
negra	n 'e ɣ ɾ a	 n 'ɛ ɣ ɾ a 
negre	n 'e ɣ ɾ e	 n 'ɛ ɣ ɾ e 
negres	n 'e ɣ ɾ e s	 n 'ɛ ɣ ɾ e s 
negues	n 'e ɣ e s	 n 'ɛ ɣ e s 
neva	n 'e β a	 n 'ɛ β a 
noi	n 'ɔ j	 n 'o i 
nois	n 'ɔ j s	 n 'o i s 
nores	n 'ɔ ɾ e s	 n 'o ɾ e s 
noruec	n o ɾ u 'e k	 n o ɾ u 'ɛ k 
Noruega	n o ɾ u 'e ɣ a	 n o ɾ u 'ɛ ɣ a 
novembre	n o β 'e m b ɾ e	 n o β 'ɛ m b ɾ e 
número	n 'u m e ɾ o	 n u m 'e ɾ o 
obliquades	o β l i k w 'a ð e s	 o β l i k 'a ð e s 
obliquar	o β l i k w 'a	 o β l i k 'a 
obliquats	o β l i k w 'a t s	 o β l i k 'a t s 
obscena	o p s 'e n a	 o p s k 'e n a 
obscenes	o p s 'e n e s	 o p s k 'e n e s 
obscens	o p s 'e n s	 o p s k 'ɛ n s 
obtús	o p t 'u s	 ɔ p t 'u s 
octubre	o k t 'u β ɾ e	 ɔ k t 'u β ɾ e 
oest	o 'e s t	 o 'ɛ s t 
ofec	o f 'e k	 o f 'ɛ k 
ofega	o f 'e ɣ a	 o f 'ɛ ɣ a 
ofendre	o f 'e n d ɾ e	 o f 'ɛ n d ɾ e 
oi	'ɔ j	 'o i 
olíban	o l 'i β a n	 o l i β 'a n 
ombra	'o m b ɾ a	 'ɔ m b ɾ a 
ombres	'o m b ɾ e s	 'ɔ m b ɾ e s 
omega	o m 'e ɣ a	 o m 'ɛ ɣ a 
ometre	o m 'e t ɾ e	 o m 'ɛ t ɾ e 
òmicron	'ɔ m i k ɾ o n	 ɔ m i k ɾ 'o n 
omòplat	o m 'ɔ p l a t	 o m o p l 'a t 
omple	'o m p l e	 'ɔ m p l e 
omplen	'o m p l e n	 'ɔ m p l e n 
omples	'o m p l e s	 'ɔ m p l e s 
omplo	'o m p l o	 'ɔ m p l o 
oncle	'o ŋ k l e	 'ɔ ŋ k l e 
oncles	'o ŋ k l e s	 'ɔ ŋ k l e s 
onzes	'o n z e s	 'ɔ n z e s 
opta	'o p t a	 'ɔ p t a 
opten	'o p t e n	 'ɔ p t e n 
opto	'o p t o	 'ɔ p t o 
ores	'ɔ ɾ e s	 'o ɾ e s 
Òscar	'ɔ s k a	 ɔ s k 'a 
osonenc	o z o n 'e ŋ	 o z o n 'e n s 
oxímoron	o k s 'i m o ɾ o n	 o k s i m o ɾ 'o n 
pairal	p a j ɾ 'a l	 p a i ɾ 'a l 
paisatge	p a j z 'a dʒ e	 p a i z 'a dʒ e 
pakistanesa	p a k i s t a n 'e z a	 p a z i s t a n 'e z a 
pakistaneses	p a k i s t a n 'e z e s	 p a z i s t a n 'e z e s 
pakistanesos	p a k i s t a n 'e z o s	 p a z i s t a n 'e z o s 
paleòlegs	p a l e 'ɔ l e k s	 p a l e o l 'e k s 
pallol	p a ʎ 'o l	 p a ʎ 'ɔ l 
pamperol	p a m p e ɾ 'o l	 p a m p e ɾ 'ɔ l 
panameny	p a n a m 'e ɲ	 p a n a m 'ɛ ɲ 
pàncrees	p 'a ŋ k ɾ e e s	 p a ŋ k ɾ 'e e s 
pandemoni	p a n d e m 'ɔ n i	 p a n d e m 'o n i 
papagai	p a p a ɣ 'a j	 p a p a ɣ 'a i 
papil·loma	p a p i l 'ɔ m a	 p a p i l 'o m a 
paradisíac	p a ɾ a ð i z 'i a k	 p a ɾ a ð i s 'i a k 
paranoic	p a ɾ a n 'ɔ j k	 p a ɾ a n o 'i k 
paranoide	p a ɾ a n 'ɔ j ð e	 p a ɾ a n o 'i ð e 
parènquima	p a ɾ 'ɛ ŋ k i m a	 p a ɾ e ŋ k 'i m a 
parisenc	p a ɾ i z 'e ŋ	 p a ɾ i s 'e n s 
patracol	p a t ɾ a k 'o l	 p a t ɾ a k 'ɔ l 
patrimoni	p a t ɾ i m 'ɔ n i	 p a t ɾ i m 'o n i 
pebre	p 'e β ɾ e	 p 'ɛ β ɾ e 
peca	p 'e k a	 p 'ɛ k a 
pedra	p 'e ð ɾ a	 p 'ɛ ð ɾ a 
pedres	p 'e ð ɾ e s	 p 'ɛ ð ɾ e s 
pega	p 'e ɣ a	 p 'ɛ ɣ a 
pego	p 'e ɣ o	 p 'ɛ ɣ o 
pegues	p 'e ɣ e s	 p 'ɛ ɣ e s 
peixos	p 'e j ʃ o s	 p 'ɛ j ʃ o s 
pèlag	p 'ɛ l a k	 p e l 'a k 
pelen	p 'ɛ l e n	 p 'e l e n 
penetra	p e n 'e t ɾ a	 p e n 'ɛ t ɾ a 
penges	p 'e n dʒ e s	 p 'ɛ n dʒ e s 
penja	p 'e n dʒ a	 p 'ɛ n dʒ a 
penjo	p 'e n dʒ o	 p 'ɛ n dʒ o 
penombra	p e n 'o m b ɾ a	 p e n 'ɔ m b ɾ a 
pensa	p 'e n s a	 p 'ɛ n s a 
penses	p 'e n s e s	 p 'ɛ n s e s 
penso	p 'e n s o	 p 'ɛ n s o 
penúltims	p e n 'u l t i m s	 p e n u l t 'i m s 
penya	p 'e ɲ a	 p 'ɛ ɲ a 
penyes	p 'e ɲ e s	 p 'ɛ ɲ e s 
Pere	p 'e ɾ e	 p 'ɛ ɾ e 
perenne	p e ɾ 'e n n e	 p e ɾ 'ɛ n n e 
pes	p 'e s	 p 'ɛ s 
pesca	p 'e s k a	 p 'ɛ s k a 
pesco	p 'e s k o	 p 'ɛ s k o 
peso	p 'e z o	 p 'ɛ z o 
pessebre	p e s 'e β ɾ e	 p e s 'ɛ β ɾ e 
pessigolles	p e s i ɣ 'o ʎ e s	 p e s i ɣ 'ɔ ʎ e s 
pesta	p 'e s t a	 p 'ɛ s t a 
petges	p 'e dʒ e s	 p 'ɛ dʒ e s 
petja	p 'e dʒ a	 p 'ɛ dʒ a 
peto	p 'e t o	 p 'ɛ t o 
peuada	p e w 'a ð a	 p e u 'a ð a 
picarol	p i k a ɾ 'o l	 p i k a ɾ 'ɔ l 
pineda	p i n 'e ð a	 p i n 'ɛ ð a 
pirinenc	p i ɾ i n 'e ŋ	 p i ɾ i n 'e n s 
piscina	p i s 'i n a	 p i s k 'i n a 
pixa	p 'i ʃ a	 p 'i tʃ a 
plàncton	p l 'a ŋ k t o n	 p l a ŋ k t 'o n 
ple	p l 'e	 p l 'ɛ 
plec	p l 'e k	 p l 'ɛ k 
plega	p l 'e ɣ a	 p l 'ɛ ɣ a 
plego	p l 'e ɣ o	 p l 'ɛ ɣ o 
plens	p l 'e n s	 p l 'ɛ n s 
plomo	p l 'o m o	 p l 'ɔ m o 
plores	p l 'ɔ ɾ e s	 p l 'o ɾ e s 
plutoni	p l u t 'ɔ n i	 p l u t 'o n i 
poblen	p 'o β l e n	 p 'ɔ β l e n 
poesia	p o e z 'i a	 p o e s 'i a 
polígam	p o l 'i ɣ a m	 p o l i ɣ 'a m 
polla	p 'o ʎ a	 p 'ɔ ʎ a 
poloni	p o l 'ɔ n i	 p o l 'o n i 
polpa	p 'o l p a	 p 'ɔ l p a 
poltre	p 'o l t ɾ e	 p 'ɔ l t ɾ e 
polze	p 'o l z e	 p 'ɔ l z e 
pop	p 'o p	 p 'ɔ p 
popa	p 'o p a	 p 'ɔ p a 
popes	p 'o p e s	 p 'ɔ p e s 
porro	p 'o r o	 p 'ɔ r o 
porros	p 'o r o s	 p 'ɔ r o s 
post	p 'ɔ s t	 p 'o s t 
prec	p ɾ 'e k	 p ɾ 'ɛ k 
precoç	p ɾ e k 'ɔ s	 p ɾ e k 'o s 
precs	p ɾ 'e k s	 p ɾ 'ɛ k s 
prega	p ɾ 'e ɣ a	 p ɾ 'ɛ ɣ a 
prego	p ɾ 'e ɣ o	 p ɾ 'ɛ ɣ o 
premsa	p ɾ 'e m s a	 p ɾ 'ɛ m s a 
prens	p ɾ 'e n s	 p ɾ 'ɛ n s 
preqüela	p ɾ e k w 'ɛ l a	 p ɾ e k 'ɛ l a 
pres	p ɾ 'e s	 p ɾ 'ɛ s 
pressupost	p ɾ e s u p 'ɔ s t	 p ɾ e s u p 'o s t 
presta	p ɾ 'e s t a	 p ɾ 'ɛ s t a 
prestes	p ɾ 'e s t e s	 p ɾ 'ɛ s t e s 
presto	p ɾ 'e s t o	 p ɾ 'ɛ s t o 
presumpta	p ɾ e z 'u m t a	 p ɾ e z 'u m p t a 
presumpte	p ɾ e z 'u m t e	 p ɾ e z 'u m p t e 
pretendre	p ɾ e t 'e n d ɾ e	 p ɾ e t 'ɛ n d ɾ e 
primerenc	p ɾ i m e ɾ 'e ŋ	 p ɾ i m e ɾ 'e n s 
prínceps	p ɾ 'i n s e p s	 p ɾ i n s 'e p s 
proa	p ɾ 'o a	 p ɾ 'ɔ a 
profund	p ɾ o f 'u n	 p ɾ o f 'u n i 
profunds	p ɾ o f 'u n s	 p ɾ o f 'u n i s 
prohom	p ɾ o 'o m	 p ɾ o 'i m 
prolixa	p ɾ o l 'i ʃ a	 p ɾ o l 'i tʃ a 
prolixes	p ɾ o l 'i ʃ e s	 p ɾ o l 'i tʃ e s 
prometre	p ɾ o m 'e t ɾ e	 p ɾ o m 'ɛ t ɾ e 
prona	p ɾ 'ɔ n a	 p ɾ 'o n a 
prones	p ɾ 'ɔ n e s	 p ɾ 'o n e s 
prosseguits	p ɾ o s e ɣ 'i t s	 p ɾ o s e ɣ u 'i t s 
protesta	p ɾ o t 'e s t a	 p ɾ o t 'ɛ s t a 
psique	s 'i k e	 p s 'i k e 
psíquic	s 'i k i k	 p s 'i k i k 
púlsar	p 'u l s a	 p u l s 'a 
punk	p 'u ŋ k	 p 'u n i 
quaresma	k w a ɾ 'e z m a	 k w a ɾ 'ɛ z m a 
quètxup	k 'ɛ tʃ u p	 k e tʃ 'u p 
quid	k 'i t	 k 'i 
rai	r 'a j	 r 'a i 
rail	r 'a j l	 r 'a i l 
raima	r 'a j m a	 r 'a i m a 
readmetre	r e a d m 'e t ɾ e	 r e a d m 'ɛ t ɾ e 
rebo	r 'e β o	 r 'ɛ β o 
rebost	r e β 'ɔ s t	 r e β 'o s t 
rebre	r 'e β ɾ e	 r 'ɛ β ɾ e 
rec	r 'e k	 r 'ɛ k 
reca	r 'e k a	 r 'ɛ k a 
recompte	r e k 'o m t e	 r e k 'ɔ m p t e 
recorre	r e k 'o r e	 r e k 'ɔ r e 
refresc	r e f ɾ 'e s k	 r e f ɾ 'ɛ s k 
rega	r 'e ɣ a	 r 'ɛ ɣ a 
regna	r 'e g n a	 r 'ɛ g n a 
regne	r 'e g n e	 r 'ɛ g n e 
regnes	r 'e g n e s	 r 'ɛ g n e s 
reiterada	r e i t e ɾ 'a ð a	 r e j t e ɾ 'a ð a 
reiterades	r e i t e ɾ 'a ð e s	 r e j t e ɾ 'a ð e s 
reiterar	r e i t e ɾ 'a	 r e j t e ɾ 'a 
reiterat	r e i t e ɾ 'a t	 r e j t e ɾ 'a t 
reiterats	r e i t e ɾ 'a t s	 r e j t e ɾ 'a t s 
remei	r e m 'e j	 r e m 'ɛ i 
remeis	r e m 'e j s	 r e m 'ɛ i s 
remes	r 'e m e s	 r 'ɛ m e s 
remetre	r e m 'e t ɾ e	 r e m 'ɛ t ɾ e 
remo	r 'e m o	 r 'ɛ m o 
renda	r 'e n d a	 r 'ɛ n d a 
rendes	r 'e n d e s	 r 'ɛ n d e s 
renebot	r e n e β 'o t	 r e n e β 'ɔ t 
renec	r e n 'e k	 r e n 'ɛ k 
rengla	r 'e ŋ g l a	 r 'ɛ ŋ g l a 
rengle	r 'e ŋ g l e	 r 'ɛ ŋ g l e 
rengles	r 'e ŋ g l e s	 r 'ɛ ŋ g l e s 
renti	r 'e n t i	 r 'ɛ n t i 
rentin	r 'e n t i n	 r 'ɛ n t i n 
renya	r 'e ɲ a	 r 'ɛ ɲ a 
rep	r 'e p	 r 'ɛ p 
repta	r 'e p t a	 r 'ɛ p t a 
repte	r 'e p t e	 r 'ɛ p t e 
reptes	r 'e p t e s	 r 'ɛ p t e s 
repto	r 'e p t o	 r 'ɛ p t o 
rere	r 'e ɾ e	 r 'ɛ ɾ e 
res	r 'e s	 r 'ɛ s 
resclosa	r e s k l 'ɔ z a	 r e s k l 'o z a 
reso	r 'e z o	 r 'ɛ z o 
respost	r e s p 'ɔ s t	 r e s p 'o s t 
ressec	r e s 'e k	 r e s 'ɛ k 
resseguits	r e s e ɣ 'i t s	 r e s e ɣ u 'i t s 
ressenya	r e s 'e ɲ a	 r e s 'ɛ ɲ a 
resta	r 'e s t a	 r 'ɛ s t a 
restes	r 'e s t e s	 r 'ɛ s t e s 
resto	r 'e s t o	 r s t o 
reto	r 'e t o	 r 'ɛ t o 
retre	r 'e t ɾ e	 r 'ɛ t ɾ e 
retrògrad	r e t ɾ 'ɔ ɣ ɾ a t	 r e t ɾ o ɣ ɾ 'a t 
reverend	r e β e ɾ 'e n	 r e β e ɾ 'ɛ n i 
Ricosind	r i k o z 'i n	 r i k o z 'i n i 
roina	r 'ɔ j n a	 r 'ɔ i n a 
Roland	r o l 'a n	 r o l 'a n i 
rombe	r 'o m b e	 r 'ɔ m b e 
rombes	r 'o m b e s	 r 'ɔ m b e s 
romesco	r o m 'e s k o	 r o m 'ɛ s k o 
rompre	r 'o m p ɾ e	 r 'ɔ m p ɾ e 
rompsac	r o m s 'a k	 r o m z 'a k 
ronca	r 'o ŋ k a	 r 'ɔ ŋ k a 
ronda	r 'o n d a	 r 'ɔ n d a 
rondes	r 'o n d e s	 r 'ɔ n d e s 
roquerol	r o k e ɾ 'o l	 r o k e ɾ 'ɔ l 
rossos	r 'o s o s	 r 'ɔ s o s 
rot	r 'o t	 r 'ɔ t 
rotonda	r o t 'o n d a	 r o t 'ɔ n d a 
rotund	r o t 'u n	 r o t 'u n i 
rovellol	r o β e ʎ 'o l	 r o β e ʎ 'ɔ l 
rugbi	r 'u g b i	 r 'u g β i 
ruixat	r u j ʃ 'a t	 r i ʃ 'a t 
ruixats	r u j ʃ 'a t s	 r i ʃ 'a t s 
sabadellenc	s a β a ð e ʎ 'e ŋ	 s a β a ð e ʎ 'e n s 
sahrauí	s a ɾ a w 'i	 s a i a u 'i 
sainet	s a j n 'e t	 s a i n 'e t 
sanefa	s a n 'e f a	 s a n 'ɛ f a 
sanglot	s a ŋ g l 'o t	 s a ŋ g l 'ɔ t 
sanguini	s a ŋ g 'i n i	 s a ŋ g w 'i n i 
sanguinyol	s a ŋ g i ɲ 'o l	 s a ŋ g i ɲ 'ɔ l 
sec	s 'e k	 s 'ɛ k 
seca	s 'e k a	 s 'ɛ k a 
secs	s 'e k s	 s 'ɛ k s 
seda	s 'e ð a	 s 'ɛ ð a 
sedes	s 'e ð e s	 s 'ɛ ð e s 
sega	s 'e ɣ a	 s 'ɛ ɣ a 
segarrenc	s e ɣ a r 'e ŋ	 s e ɣ a r 'e ŋ k 
segrest	s e ɣ ɾ 'e s t	 s e ɣ ɾ 'ɛ s t 
seguits	s e ɣ 'i t s	 s e ɣ u 'i t s 
sembla	s 'e m b l a	 s 'ɛ m b l a 
sembles	s 'e m b l e s	 s 'ɛ m b l e s 
semblo	s 'e m b l o	 s 'ɛ m b l o 
sembra	s 'e m b ɾ a	 s 'ɛ m b ɾ a 
semestre	s e m 'e s t ɾ e	 s e m 'ɛ s t ɾ e 
seminoma	s e m i n 'ɔ m a	 s e m i n 'o m a 
seminomes	s e m i n 'ɔ m e s	 s e m i n 'o m e s 
sempre	s 'e m p ɾ e	 s 'ɛ m p ɾ e 
senda	s 'e n d a	 s 'ɛ n d a 
sengles	s 'e ŋ g l e s	 s 'ɛ ŋ g l e s 
sens	s 'e n s	 s 'ɛ n s 
sense	s 'e n s e	 s 'ɛ n s e 
senti	s 'e n t i	 s 'ɛ n t i 
sentin	s 'e n t i n	 s 'ɛ n t i n 
sentis	s 'e n t i s	 s 'ɛ n t i s 
sento	s 'e n t o	 s 'ɛ n t o 
seny	s 'e ɲ	 s 'ɛ ɲ 
senyes	s 'e ɲ e s	 s 'ɛ ɲ e s 
seques	s 'e k e s	 s 'ɛ k e s 
serren	s 'ɛ r e n	 s 'e r e n 
setembre	s e t 'e m b ɾ e	 s e t 'ɛ m b ɾ e 
setge	s 'e dʒ e	 s 'ɛ dʒ e 
setges	s 'e dʒ e s	 s 'ɛ dʒ e s 
setze	s 'e d z e	 s 'ɛ d z e 
seua	s 'e w a	 s 'ɛ u a 
sèver	s 'ɛ β e	 s e β 'e 
sexen	s 'ɛ k s e n	 s 'e tʃ e n 
síl·laba	s 'i l a β a	 s i l 'a β a 
singlot	s i ŋ g l 'o t	 s i ŋ g l 'ɔ t 
sintèticament	s i n t 'ɛ t i k a m 'e n	 s 'i n t 'ɛ t i k a m 'e n 
sobra	s 'o β ɾ a	 s 'ɔ β ɾ a 
sobre	s 'o β ɾ e	 s 'ɔ β ɾ e 
sobta	s 'o p t a	 s 'ɔ p t a 
sofre	s 'o f ɾ e	 s 'ɔ f ɾ e 
solemne	s o l 'e m n e	 s o l 'ɛ m n e 
soler	s o l 'ɛ	 s o l 'e 
Sóller	s 'o ʎ e	 s o ʎ 'e 
sonda	s 'o n d a	 s 'ɔ n d a 
sondes	s 'o n d e s	 s 'ɔ n d e s 
sones	s 'ɔ n e s	 s 'o n e s 
soni	s 'ɔ n i	 s 'o n i 
sonin	s 'ɔ n i n	 s 'o n i n 
sonis	s 'ɔ n i s	 s 'o n i s 
sopa	s 'o p a	 s 'ɔ p a 
sopen	s 'o p e n	 s 'ɔ p e n 
sopes	s 'o p e s	 s 'ɔ p e s 
sota	s 'o t a	 s 'ɔ t a 
sotmesa	s o d m 'e z a	 s o t m 'e z a 
sotmeses	s o d m 'e z e s	 s o t m 'e z e s 
sotmesos	s o d m 'e z o s	 s o t m 'e z o s 
sotmetiment	s o d m e t i m 'e n	 s o t m 'ɛ t i m 'e n 
sotmetre	s o d m 'e t ɾ e	 s o t m 'ɛ t ɾ e 
subaquàtic	s u p a k w 'a t i k	 s u β a k w 'a t i k 
subespai	s u p e s p 'a j	 s u p e s p 'a i 
subespais	s u p e s p 'a j s	 s u p e s p 'a i s 
subhasta	s u β 'a s t a	 s u β e 'a s t a 
sud	s 'u t	 s 'u d 
suec	s u 'e k	 s u 'ɛ k 
sueca	s u 'e k a	 s u 'ɛ k a 
sues	s 'u e s	 s e s 
suspendre	s u s p 'e n d ɾ e	 s u s p 'ɛ n d ɾ e 
t'estimo	t a s t 'i m o	 t e s t 'i m o 
tabloide	t a β l 'ɔ j ð e	 t a β l 'ɔ 'i ð e 
tailandesa	t a j l a n d 'e z a	 t a i l a n d 'e z a 
tallarol	t a ʎ a ɾ 'o l	 t a ʎ a ɾ 'ɔ l 
tàlveg	t 'a l β e k	 t 'a l β e ɣ 
tanmateix	t a m m a t 'e j ʃ	 t a n m a t 'e j ʃ 
tecla	t 'e k l a	 t 'ɛ k l a 
tecles	t 'e k l e s	 t 'ɛ k l e s 
tecnicisme	t e g n i s 'i z m e	 t e k n i s 'i z m e 
tecnoestructura	t e g n o e s t ɾ u k t 'u ɾ a	 t e k n o e s t ɾ u k t 'u ɾ a 
telefoni	t e l e f 'ɔ n i	 t e l e f 'o n i 
telèfons	t e l 'ɛ f o n s	 t e l e f 'o n s 
telègraf	t e l 'ɛ ɣ ɾ a f	 t e l e ɣ ɾ 'a f 
temes	t 'e m e s	 t 'ɛ m e s 
temo	t 'e m o	 t 'ɛ m o 
tempesta	t e m p 'e s t a	 t e m p 'ɛ s t a 
templa	t 'e m p l a	 t 'ɛ m p l a 
temple	t 'e m p l e	 t 'ɛ m p l e 
temples	t 'e m p l e s	 t 'ɛ m p l e s 
temps	t 'e m s	 t 'ɛ m p s 
tempteig	t e m t 'e tʃ	 t e m p t 'e tʃ 
tenda	t 'e n d a	 t 'ɛ n d a 
tendes	t 'e n d e s	 t 'ɛ n d e s 
tenebra	t e n 'e β ɾ a	 t e n 'ɛ β ɾ a 
tenebres	t e n 'e β ɾ e s	 t e n 'ɛ β ɾ e s 
tens	t 'e n s	 t 'ɛ n s 
tensa	t 'e n s a	 t 'ɛ n s a 
tenses	t 'e n s e s	 t 'ɛ n s e s 
tensos	t 'e n s o s	 t 'ɛ n s o s 
terrassenc	t e r a s 'e ŋ	 t e r a s 'e n s 
terreny	t e r 'e ɲ	 t e r 'ɛ ɲ 
terrestre	t e r 'e s t ɾ e	 t e r 'ɛ s t ɾ e 
terrestres	t e r 'e s t ɾ e s	 t e r 'ɛ s t ɾ e s 
test	t 'e s t	 t 'ɛ s t 
testa	t 'e s t a	 t 'ɛ s t a 
testimoni	t e s t i m 'ɔ n i	 t e s t i m 'o n i 
testos	t 'e s t o s	 t 'ɛ s t o s 
tètan	t 'ɛ t a n	 t e t 'a n 
tètanus	t 'ɛ t a n u s	 t e t a n 'u s 
Texas	t 'ɛ k s a s	 t e k s 'a s 
tifoide	t i f 'ɔ j ð e	 t i f o 'i ð e 
Tirol	t i ɾ 'o l	 t i ɾ 'ɔ l 
tomba	t 'o m b a	 t 'ɔ m b a 
tomben	t 'o m b e n	 t 'ɔ m b e n 
tombes	t 'o m b e s	 t 'ɔ m b e s 
tonya	t 'ɔ ɲ a	 t 'o ɲ a 
topen	t 'o p e n	 t 'ɔ p e n 
topo	t 'o p o	 t 'ɔ p o 
torra	t 'ɔ r a	 t 'o r a 
torre	t 'o r e	 t 'ɔ r e 
tosca	t 'o s k a	 t 'ɔ s k a 
tot	t 'o t	 t 'ɔ t 
tota	t 'o t a	 t 'ɔ t a 
totes	t 'o t e s	 t 'ɔ t e s 
totxo	t 'o tʃ o	 t 'ɔ tʃ o 
tova	t 'o β a	 t 'ɔ β a 
trametre	t ɾ a m 'e t ɾ e	 t ɾ a m 'ɛ t ɾ e 
transmetre	t ɾ a n z m 'e t ɾ e	 t ɾ a n z m 'ɛ t ɾ e 
trapezoide	t ɾ a p e z 'ɔ j ð e	 t ɾ a p e z o 'i ð e 
trec	t ɾ 'e k	 t ɾ 'ɛ k 
tremp	t ɾ 'e m	 t ɾ 'ɛ m p 
Tremp	t ɾ 'e m	 t ɾ 'ɛ m p 
trenc	t ɾ 'e ŋ	 t ɾ 'e n s 
trens	t ɾ 'e n s	 t ɾ 'ɛ n s 
trepa	t ɾ 'e p a	 t ɾ 'ɛ p a 
trepes	t ɾ 'e p e s	 t ɾ 'ɛ p e s 
trepig	t ɾ e p 'i tʃ	 t ɾ e p 'i 
tres	t ɾ 'e s	 t ɾ 'ɛ s 
tretze	t ɾ 'e d z e	 t ɾ 'ɛ d z e 
treva	t ɾ 'e β a	 t ɾ 'ɛ β a 
trimestre	t ɾ i m 'e s t ɾ e	 t ɾ i m 'ɛ s t ɾ e 
troica	t ɾ 'ɔ j k a	 t ɾ 'ɔ i k a 
tromba	t ɾ 'o m b a	 t ɾ 'ɔ m b a 
trompa	t ɾ 'o m p a	 t ɾ 'ɔ m p a 
trompes	t ɾ 'o m p e s	 t ɾ 'ɔ m p e s 
troni	t ɾ 'ɔ n i	 t ɾ 'o n i 
tronin	t ɾ 'ɔ n i n	 t ɾ 'o n i n 
tronis	t ɾ 'ɔ n i s	 t ɾ 'o n i s 
tropa	t ɾ 'o p a	 t ɾ 'ɔ p a 
tropes	t ɾ 'o p e s	 t ɾ 'ɔ p e s 
tsarévitx	t s a ɾ 'e β i tʃ	 t s a ɾ e β 'i tʃ 
tub	t 'u p	 t 'u 
txagatai	tʃ a ɣ a t 'a j	 tʃ a ɣ a t 'a i 
txec	tʃ 'e k	 tʃ 'ɛ k 
txeca	tʃ 'e k a	 tʃ 'ɛ k a 
txecs	tʃ 'e k s	 tʃ 'ɛ k s 
txeques	tʃ 'e k e s	 tʃ 'ɛ k e s 
ubiqüitat	u β i k w i t 'a t	 u β i k i t 'a t 
udol	u ð 'o l	 u ð 'ɔ l 
vaguista	b a ɣ 'i s t a	 b a ɣ u 'i s t a 
vailet	b a j l 'e t	 b a i l 'e t 
vainilla	b a j n 'i ʎ a	 b a i n 'i ʎ a 
vainilles	b a j n 'i ʎ e s	 b a i n 'i ʎ e s 
vallenc	b a ʎ 'e ŋ	 b a ʎ 'e n s 
ve	b 'e	 b 'ɛ 
veça	b 'ɛ s a	 b 'e s a 
veda	b 'e ð a	 b 'ɛ ð a 
veloç	b e l 'ɔ s	 b e l 'o s 
vencem	b e n s 'e m	 b e ŋ 'e m 
venda	b 'e n d a	 b 'ɛ n d a 
vendre	b 'e n d ɾ e	 b 'ɛ n d ɾ e 
vens	b 'e n s	 b 'ɛ n s 
ventre	b 'e n t ɾ e	 b 'ɛ n t ɾ e 
ves	b 'e s	 b 'ɛ s 
vespa	b 'e s p a	 b 'ɛ s p a 
vespre	b 'e s p ɾ e	 b 'ɛ s p ɾ e 
Vicent	b i s 'ɛ n	 b i k 'e n 
vicesecretari	b i s e s e k ɾ e t 'a ɾ i	 b i s e z e k ɾ e t 'a ɾ i 
virrei	b i r 'e j	 b i r 'ɛ i 
voivoda	b o j β 'ɔ ð a	 b o i β 'ɔ ð a 
volt	b 'ɔ l	 b 'o l 
voto	b 'o t o	 b 'ɔ t o 
vuitada	b u j t 'a ð a	 b u i t 'a ð a 
vuitanta	b u j t 'a n t a	 b u i t 'a n t a 
web	b 'e p	 b 'ɛ p 
wiki	b 'i k i	 b 'i z i 
Xangai	tʃ a ŋ g 'a j	 tʃ a ŋ g 'a i 
xe	tʃ 'e	 tʃ 
xec	tʃ 'e k	 tʃ 'ɛ k 
xecs	tʃ 'e k s	 tʃ 'ɛ k s 
xef	tʃ 'e f	 tʃ 'ɛ f 
xeic	tʃ 'e j k	 tʃ 'ɛ j k 
xerrameca	tʃ e r a m 'e k a	 tʃ e r a m 'ɛ k a 
xistorra	tʃ i s t 'ɔ r a	 tʃ i s t 'o r a 
xop	tʃ 'o p	 tʃ 'ɔ p 
Xúquer	tʃ 'u k e	 tʃ u k 'e 
zebra	z 'e β ɾ a	 i 'ɛ β ɾ a 
zero	z 'e ɾ o	 z 'ɛ ɾ o 
zífid	z 'i f i t	 z 'i f i d 
de	d 'e	 d e 
que	k 'e	 k e 
la	l 'a	 l a 
i	'i	 i 
a	'a	 a 
el	'e l	 e l 
en	'e n	 e n 
les	l 'e s	 l e s 
els	'e l s	 'ɛ l s 
del	d 'e l	 d e l 
es	'e s	 e s 
El	'e l	 e l 
dels	d 'e l s	 d 'ɛ l s 
hi	'i	 i 
La	l 'a	 l a 
si	s 'i	 s i 
li	l 'i	 l i 
tot	t 'o t	 t 'ɔ t 
Els	'e l s	 'ɛ l s 
A	'a	 a 
sobre	s 'o β ɾ e	 s 'ɔ β ɾ e 
tres	t ɾ 'e s	 t ɾ 'ɛ s 
En	'e n	 e n 
Si	s 'i	 s i 
sense	s 'e n s e	 s 'ɛ n s e 
ho	'o	 o 
res	r 'e s	 r 'ɛ s 
temps	t 'e m s	 t 'ɛ m p s 
De	d 'e	 d e 
pel	p 'e l	 p e l 
tots	t 'o t s	 t 'ɔ t s 
aquesta	a k 'e s t a	 a k 'ɛ s t a 
entre	'e n t ɾ e	 a n t ɾ e 
sempre	s 'e m p ɾ e	 s 'ɛ m p ɾ e 
I	'i	 i 
he	'e	 'a 
cosa	k 'ɔ z a	 k 'o z a 
se	s 'e	 s e 
Les	l 'e s	 l e s 
s'ha	s 'a	 s 'e 
tota	t 'o t a	 t 'ɔ t a 
mentre	m 'e n t ɾ e	 m 'ɛ n t ɾ e 
des	d 'e s	 d 'ɛ s 
Es	'e s	 e s 
hores	'ɔ ɾ e s	 a ɾ e s 
totes	t 'o t e s	 t 'ɔ t e s 
coses	k 'ɔ z e s	 k 'o z e s 
Hi	'i	 i 
sembla	s 'e m b l a	 s 'ɛ m b l a 
dona	d 'ɔ n a	 d 'o n a 
Li	l 'i	 l i 
número	n 'u m e ɾ o	 n u m 'e ɾ o 
centre	s 'e n t ɾ e	 s 'ɛ n t ɾ e 
Aquesta	a k 'e s t a	 a k 'ɛ s t a 
sota	s 'o t a	 s 'ɔ t a 
aquests	a k 'e t s	 a k 'ɛ s t s 
s'hi	s 'i	 s 'e 
zero	z 'e ɾ o	 z 'ɛ ɾ o 
pels	p 'e l s	 p 'ɛ l s 
contra	k 'o n t ɾ a	 k 'ɔ n t ɾ a 
mig	m 'i tʃ	 m 'i 
aquestes	a k 'e s t e s	 a k 'ɛ s t e s 
finestra	f i n 'e s t ɾ a	 f i n 'ɛ s t ɾ a 
cotxe	k 'o tʃ e	 k 'ɔ tʃ e 
compte	k 'o m t e	 k 'ɔ m p t e 
Ho	'o	 o 
mes	m 'e s	 m 'ɛ s 
gairebé	g a j ɾ e β 'e	 g a i ɾ e β 'e 
web	b 'e p	 b 'ɛ p 
metres	m 'e t ɾ e s	 m 'ɛ t ɾ e s 
fora	f 'ɔ ɾ a	 f 'o ɾ a 
home	'ɔ m e	 u m e 
ve	b 'e	 b 'ɛ 
llei	ʎ 'e j	 ʎ 'ɛ i 
sento	s 'e n t o	 s 'ɛ n t o 
gaire	g 'a j ɾ e	 g 'a i ɾ e 
He	'e	 'a 
hora	'ɔ ɾ a	 a ɾ a 
se'n	s 'e n	 s 'ɛ n 
Tot	t 'o t	 t 'ɔ t 
darrere	d a r 'e ɾ e	 d a r 'ɛ ɾ e 
exemple	e g z 'e m p l e	 e g z 'ɛ m p l e 
tretze	t ɾ 'e d z e	 t ɾ 'ɛ d z e 
ple	p l 'e	 p l 'ɛ 
dotze	d 'o d z e	 d 'ɔ d z e 
camp	k 'a m	 k 'a m p 
dones	d 'ɔ n e s	 d 'o n e s 
queda	k 'e ð a	 k 'ɛ ð a 
noi	n 'ɔ j	 n 'o i 
m'ha	m 'a	 m 'e 
l'home	l 'ɔ m e	 l 'i m e 
setze	s 'e d z e	 s 'ɛ d z e 
llengua	ʎ 'e ŋ g w a	 ʎ 'ɛ ŋ g w a 
metro	m 'e t ɾ o	 m 'ɛ t ɾ o 
Tots	t 'o t s	 t 'ɔ t s 
crec	k ɾ 'e k	 k ɾ 'ɛ k 
fred	f ɾ 'e t	 f ɾ 'e 
Que	k 'e	 k e 
jove	dʒ 'o β e	 dʒ 'ɔ β e 
Mentre	m 'e n t ɾ e	 m 'ɛ n t ɾ e 
joves	dʒ 'o β e s	 dʒ 'ɔ β e s 
Sempre	s 'e m p ɾ e	 s 'ɛ m p ɾ e 
negre	n 'e ɣ ɾ e	 n 'ɛ ɣ ɾ e 
S'ha	s 'a	 s 'e 
resta	r 'e s t a	 r 'ɛ s t a 
n'hi	n 'i	 n 'e 
boca	b 'o k a	 b 'ɔ k a 
temes	t 'e m e s	 t 'ɛ m e s 
tecla	t 'e k l a	 t 'ɛ k l a 
lletra	ʎ 'e t ɾ a	 ʎ 'ɛ t ɾ a 
centres	s 'e n t ɾ e s	 s 'ɛ n t ɾ e s 
Madrid	m a ð ɾ 'i t	 m a ð ɾ 'i 
Lleida	ʎ 'e j ð a	 ʎ e 'i ð a 
Des	d 'e s	 d 'ɛ s 
Aquests	a k 'e t s	 a k 'ɛ s t s 
tens	t 'e n s	 t 'ɛ n s 
se'ls	s 'e l s	 s 'ɛ l s 
camps	k 'a m s	 k 'a m p s 
trens	t ɾ 'e n s	 t ɾ 'ɛ n s 
rebre	r 'e β ɾ e	 r 'ɛ β ɾ e 
divendres	d i β 'e n d ɾ e s	 d i β 'ɛ n d ɾ e s 
se'ns	s 'e n s	 s 'ɛ n s 
s'ho	s 'o	 s 'e 
festa	f 'e s t a	 f 'ɛ s t a 
fes	f 'e s	 f 'ɛ s 
desembre	d e z 'e m b ɾ e	 d e s 'ɛ m b ɾ e 
Crec	k ɾ 'e k	 k ɾ 'ɛ k 
vuitanta	b u j t 'a n t a	 b u i t 'a n t a 
peixos	p 'e j ʃ o s	 p 'ɛ j ʃ o s 
l'hora	l 'ɔ ɾ a	 l e ɾ a 
haig	'a tʃ	 o 'i a 
foto	f 'o t o	 f 'ɔ t o 
Pere	p 'e ɾ e	 p 'ɛ ɾ e 
setembre	s e t 'e m b ɾ e	 s e t 'ɛ m b ɾ e 
l'he	l 'e	 l 'i 
etcètera	e t s 'ɛ t e ɾ a	 a t s 'ɛ t e ɾ a 
conte	k 'o n t e	 k 'ɔ n t e 
a	'a	 a 
pensa	p 'e n s a	 p 'ɛ n s a 
me'n	m 'e n	 m 'ɛ n 
bossa	b 'o s a	 b 'ɔ s a 
Entre	'e n t ɾ e	 a n t ɾ e 
pedra	p 'e ð ɾ a	 p 'ɛ ð ɾ a 
paisatge	p a j z 'a dʒ e	 p a i z 'a dʒ e 
novembre	n o β 'e m b ɾ e	 n o β 'ɛ m b ɾ e 
nois	n 'ɔ j s	 n 'o i s 
moneda	m o n 'e ð a	 m o n 'ɛ ð a 
l'ha	l 'a	 l 'i 
gens	dʒ 'e n s	 dʒ 'ɛ n s 
espai	a s p 'a j	 a s p 'a i 
cotxes	k 'o tʃ e s	 k 'ɔ tʃ e s 
compra	k 'o m p ɾ a	 k 'ɔ m p ɾ a 
Montse	m 'o n s e	 m 'ɔ n s e 
sud	s 'u t	 s 'u d 
penso	p 'e n s o	 p 'ɛ n s o 
negres	n 'e ɣ ɾ e s	 n 'ɛ ɣ ɾ e s 
me	m 'e	 m e 
mateixos	m a t 'e j ʃ o s	 m a t 'ɛ j ʃ o s 
lletres	ʎ 'e t ɾ e s	 ʎ 'ɛ t ɾ e s 
gossos	g 'o s o s	 g 'ɔ s o s 
Sembla	s 'e m b l a	 s 'ɛ m b l a 
Pel	p 'e l	 p e l 
últims	'u l t i m s	 u l t 'i m s 
volen	b 'o l e n	 b 'ɔ l e n 
se'm	s 'e m	 s 'ɛ m 
plens	p l 'e n s	 p l 'ɛ n s 
dimecres	d i m 'e k ɾ e s	 d i m 'ɛ k ɾ e s 
Sense	s 'e n s e	 s 'ɛ n s e 
L'home	l 'ɔ m e	 l 'i m e 
Aquestes	a k 'e s t e s	 a k 'ɛ s t e s 
processos	p ɾ o s 'e s o s	 p ɾ o s 'ɛ s o s 
pedres	p 'e ð ɾ e s	 p 'ɛ ð ɾ e s 
membres	m 'e m b ɾ e s	 m 'ɛ m b ɾ e s 
l'havia	l a β 'i a	 l u a β 'i a 
guerra	g 'ɛ r a	 g u 'ɛ r a 
desig	d e z 'i tʃ	 d e z 'i 
Se	s 'e	 s e 
tempesta	t e m p 'e s t a	 t e m p 'ɛ s t a 
monedes	m o n 'e ð e s	 m o n 'ɛ ð e s 
fosca	f 'o s k a	 f 'ɔ s k a 
entendre	a n t 'e n d ɾ e	 a n t 'ɛ n d ɾ e 
dolça	d 'o l s a	 d 'ɔ l s a 
disseny	d i s 'e ɲ	 d i s 'ɛ ɲ 
ves	b 'e s	 b 'ɛ s 
sistemes	s i s t 'e m e s	 s i s t 'ɛ m e s 
metges	m 'e dʒ e s	 m 'ɛ dʒ e s 
gest	dʒ 'e s t	 dʒ 'ɛ s t 
festes	f 'e s t e s	 f 'ɛ s t e s 
Camp	k 'a m	 k 'a m p 
i	'i	 i 
vespre	b 'e s p ɾ e	 b 'ɛ s p ɾ e 
quedo	k 'e ð o	 k 'ɛ ð o 
pres	p ɾ 'e s	 p ɾ 'ɛ s 
meitat	m e j t 'a t	 m e i t 'a t 
lleis	ʎ 'e j s	 ʎ 'ɛ i s 
leis	l 'e j s	 l 'ɛ i s 
introdueixi	i n t ɾ o ð u 'e j ʃ i	 i n t ɾ o ð u 'ɛ j ʃ i 
doble	d 'o β l e	 d 'ɔ β l e 
disposen	d i s p 'o z e n	 d i s p 'ɔ z e n 
A	'a	 a 
seca	s 'e k a	 s 'ɛ k a 
restes	r 'e s t e s	 r 'ɛ s t e s 
negra	n 'e ɣ ɾ a	 n 'ɛ ɣ ɾ a 
l'esquena	l a s k 'e n a	 l e s k 'e n a 
espais	a s p 'a j s	 a s p 'a i s 
bombes	b 'o m b e s	 b 'ɔ m b e s 
Penso	p 'e n s o	 p 'ɛ n s o 
Francesc	f ɾ a n s 'e s k	 f ɾ a n s 'ɛ s k 
se'l	s 'e l	 s 'ɛ l 
s'hagi	s 'a ʒ i	 s 'ɔ ʒ i 
s'aixeca	s a j ʃ 'e k a	 s a j ʃ 'ɛ k a 
fotos	f 'o t o s	 f 'ɔ t o s 
finestres	f i n 'e s t ɾ e s	 f i n 'ɛ s t ɾ e s 
ampolla	a m p 'o ʎ a	 a m p 'ɔ ʎ a 
Sento	s 'e n t o	 s 'ɛ n t o 
N'hi	n 'i	 n 'e 
Introdueixi	i n t ɾ o ð u 'e j ʃ i	 i n t ɾ o ð u 'ɛ j ʃ i 
Dóna'm	d 'o n a m	 d o n 'a m 
Conca	k 'o ŋ k a	 k 'ɔ ŋ k a 
terreny	t e r 'e ɲ	 t e r 'ɛ ɲ 
sentin	s 'e n t i n	 s 'ɛ n t i n 
proposen	p ɾ o p 'o z e n	 p ɾ o p 'ɔ z e n 
pressupost	p ɾ e s u p 'ɔ s t	 p ɾ e s u p 'o s t 
premsa	p ɾ 'e m s a	 p ɾ 'ɛ m s a 
pes	p 'e s	 p 'ɛ s 
metge	m 'e dʒ e	 m 'ɛ dʒ e 
lluitar	ʎ u j t 'a	 ʎ u i t 'a 
immens	i m m 'e n s	 i m m 'ɛ n s 
freda	f ɾ 'e ð a	 f ɾ 'ɛ ð a 
comptes	k 'o m t e s	 k 'ɔ m p t e s 
comencem	k o m e n s 'e m	 k o m e ŋ 'e m 
caigut	k a j ɣ 'u t	 k a i ɣ 'u t 
atendre	a t 'e n d ɾ e	 a t 'ɛ n d ɾ e 
Totes	t 'o t e s	 t 'ɔ t e s 
Gairebé	g a j ɾ e β 'e	 g a i ɾ e β 'e 
Boi	b 'ɔ j	 b 'o i 
vendes	b 'e n d e s	 b 'ɛ n d e s 
tinguessin	t i ŋ g 'e s i n	 t i ŋ g u 'ɛ s i n 
telèfons	t e l 'ɛ f o n s	 t e l e f 'o n s 
rugbi	r 'u g b i	 r 'u g β i 
mots	m 'o t s	 m 'ɔ t s 
moto	m 'o t o	 m 'ɔ t o 
mot	m 'o t	 m 'ɔ t 
moribund	m o ɾ i β 'u n	 m o ɾ i β 'u n i 
m'hi	m 'i	 m 'e 
llest	ʎ 'e s t	 ʎ 'ɛ s t 
llengües	ʎ 'e ŋ g w e s	 ʎ 'ɛ ŋ g w e s 
interessos	i n t e ɾ 'e s o s	 i n t e ɾ 'ɛ s o s 
fresca	f ɾ 'e s k a	 f ɾ 'ɛ s k a 
fe	f 'e	 f 'ɛ 
enmig	a m m 'i tʃ	 a n m 'i 
enlaire	a n l 'a j ɾ e	 e n l 'a j ɾ e 
contes	k 'o n t e s	 k 'ɔ n t e s 
afegeix	a f e ʒ 'e j ʃ	 a f e ʒ 'e tʃ 
Tremp	t ɾ 'e m	 t ɾ 'ɛ m p 
Peso	p 'e z o	 p 'ɛ z o 
Montcada	m o n t k 'a ð a	 m o n e k 'a ð a 
Fes	f 'e s	 f 'ɛ s 
En	'e n	 e n 
mestres	m 'e s t ɾ e s	 m 'ɛ s t ɾ e s 
menja	m 'e n dʒ a	 m 'ɛ n dʒ a 
intento	i n t 'e n t o	 i n t 'ɛ n t o 
envolten	a m b 'o l t e n	 a m b 'ɔ l t e n 
eina	'e j n a	 s i n a 
currículum	k u r 'i k u l u m	 k u r i k u l 'u m 
cost	k 'ɔ s t	 k 'o s t 
corre	k 'o r e	 k 'ɔ r e 
copes	k 'o p e s	 k 'ɔ p e s 
començo	k o m 'e n s o	 k o m 'ɛ n s o 
caigui	k 'a j ɣ i	 k 'a i ɣ i 
Tres	t ɾ 'e s	 t ɾ 'ɛ s 
Tanmateix	t a m m a t 'e j ʃ	 t a n m a t 'e j ʃ 
S'hi	s 'i	 s 'e 
Compte	k 'o m t e	 k 'ɔ m p t e 
Antoni	a n t 'ɔ n i	 a n t 'o n i 
érem	'e ɾ e m	 e ɾ 'e m 
àpats	'a p a t s	 a p 'a t s 
vivendes	b i β 'e n d e s	 b i β 'ɛ n d e s 
vivenda	b i β 'e n d a	 b i β 'ɛ n d a 
s'escapa	s a s k 'a p a	 s e s k 'a p a 
repte	r 'e p t e	 r 'ɛ p t e 
recompte	r e k 'o m t e	 r e k 'ɔ m p t e 
produeixin	p ɾ o ð u 'e j ʃ i n	 p ɾ o ð u 'ɛ j ʃ i n 
poesia	p o e z 'i a	 p o e s 'i a 
plàncton	p l 'a ŋ k t o n	 p l a ŋ k t 'o n 
piscina	p i s 'i n a	 p i s k 'i n a 
nego	n 'e ɣ o	 n 'ɛ ɣ o 
neboda	n e β 'o ð a	 n e β 'ɔ ð a 
mag	m 'a k	 m 'a 
lo	l 'o	 l o 
llop	ʎ 'o p	 ʎ 'ɔ p 
l'havien	l a β 'i e n	 l u a β 'i e n 
intens	i n t 'e n s	 i n t 'ɛ n s 
gotes	g 'o t e s	 g 'ɔ t e s 
gota	g 'o t a	 g 'ɔ t a 
glop	g l 'o p	 g l 'ɔ p 
gallec	g a ʎ 'e k	 g a ʎ 'ɛ k 
fosques	f 'o s k e s	 f 'ɔ s k e s 
fetge	f 'e dʒ e	 f 'ɛ dʒ e 
entenc	a n t 'e ŋ	 a n t 'e n s 
endarrere	a n d a r 'e ɾ e	 a n d a r 'ɛ ɾ e 
encreuament	a ŋ k ɾ e w a m 'e n	 a ŋ k ɾ e u a m 'e n 
encendre	a n s 'e n d ɾ e	 a n s 'ɛ n d ɾ e 
eines	'e j n e s	 'ɛ i n e s 
donen	d 'o n e n	 d 'ɔ n e n 
dimonis	d i m 'ɔ n i s	 d i m 'o n i s 
diguem-ne	d i ɣ 'e m n e	 d i ɣ u 'ɛ m n e 
descens	d e s 'e n s	 d e s 'ɛ n s 
deixi	d 'e j ʃ i	 d 'ɛ j ʃ i 
defensa	d e f 'e n s a	 d e f 'ɛ n s a 
convoquen	k o m b 'o k e n	 k o m b 'ɔ k e n 
continuï	k o n t i n 'u i	 k o n t i n 'u 
compta	k 'o m t a	 k 'ɔ m p t a 
compro	k 'o m p ɾ o	 k 'ɔ m p ɾ o 
agenda	a ʒ 'e n d a	 a ʒ 'ɛ n d a 
Seguint	s e ɣ 'i n	 s e ɣ u 'i n 
Res	r 'e s	 r 'ɛ s 
Pineda	p i n 'e ð a	 p i n 'ɛ ð a 
Pensa	p 'e n s a	 p 'ɛ n s a 
Londres	l 'o n d ɾ e s	 l 'ɔ n d ɾ e s 
L'he	l 'e	 l 'i 
Intento	i n t 'e n t o	 i n t 'ɛ n t o 
Eines	'e j n e s	 'ɛ i n e s 
Divendres	d i β 'e n d ɾ e s	 d i β 'ɛ n d ɾ e s 
txec	tʃ 'e k	 tʃ 'ɛ k 
testimonis	t e s t i m 'ɔ n i s	 t e s t i m 'o n i s 
te	t 'e	 t e 
t'hi	t 'i	 t 'e 
suspendre	s u s p 'e n d ɾ e	 s u s p 'ɛ n d ɾ e 
seguint	s e ɣ 'i n	 s e ɣ u 'i n 
s'hagin	s 'a ʒ i n	 s 'ɔ ʒ i n 
s'adonessin	s a ð o n 'e s i n	 s a ð o n 'ɛ s i n 
retrobo	r e t ɾ 'o β o	 r e t ɾ 'ɔ β o 
renda	r 'e n d a	 r 'ɛ n d a 
remei	r e m 'e j	 r e m 'ɛ i 
profund	p ɾ o f 'u n	 p ɾ o f 'u n i 
pesca	p 'e s k a	 p 'ɛ s k a 
pateixis	p a t 'e j ʃ i s	 p a t 'ɛ j ʃ i s 
mestre	m 'e s t ɾ e	 m 'ɛ s t ɾ e 
menjo	m 'e n dʒ o	 m 'ɛ n dʒ o 
membre	m 'e m b ɾ e	 m 'ɛ m b ɾ e 
llegeix	ʎ e ʒ 'e j ʃ	 ʎ e ʒ 'e tʃ 
l'hem	l 'ɛ m	 l 'i m 
hotel	o t 'ɛ l	 ɔ t 'ɛ l 
grega	g ɾ 'e ɣ a	 g ɾ 'ɛ ɣ a 
goig	g 'ɔ tʃ	 g o 'i a 
foscos	f 'o s k o s	 f 'ɔ s k o s 
foren	f 'o ɾ e n	 f 'ɔ ɾ e n 
estrangers	a s t ɾ a n dʒ 'e s	 a s t ɾ a ŋ 'e s 
element	e l e m 'e n	 ɛ l e m 'e n 
eh	'e	 'ɛ 
dimoni	d i m 'ɔ n i	 d i m 'o n i 
creixi	k ɾ 'e j ʃ i	 k ɾ 'ɛ j ʃ i 
corren	k 'o r e n	 k 'ɔ r e n 
conec	k o n 'e k	 k o n 'ɛ k 
celebra	s e l 'e β ɾ a	 s e l 'ɛ β ɾ a 
bàsquet	b 'a s k e t	 b a s k 'e t 
bec	b 'e k	 b 'ɛ k 
admetre	a d m 'e t ɾ e	 a d m 'ɛ t ɾ e 
Volen	b 'o l e n	 b 'ɔ l e n 
Valladolid	b a ʎ a ð o l 'i t	 b a ʎ a ð o l 'i d 
Tens	t 'e n s	 t 'ɛ n s 
Sota	s 'o t a	 s 'ɔ t a 
Pontevedra	p o n t e β 'e ð ɾ a	 p o n t e β 'ɛ ð ɾ a 
Pels	p 'e l s	 p 'ɛ l s 
Menjo	m 'e n dʒ o	 m 'ɛ n dʒ o 
L'havien	l a β 'i e n	 l u a β 'i e n 
Home	'ɔ m e	 u m e 
Espero	a s p 'e ɾ o	 a s p 'ɛ ɾ o 
Començo	k o m 'e n s o	 k o m 'ɛ n s o 
Centre	s 'e n t ɾ e	 s 'ɛ n t ɾ e 
tub	t 'u p	 t 'u 
trametre	t ɾ a m 'e t ɾ e	 t ɾ a m 'ɛ t ɾ e 
tonto	t 'o n t o	 t 'ɔ n t o 
testimoni	t e s t i m 'ɔ n i	 t e s t i m 'o n i 
tecles	t 'e k l e s	 t 'ɛ k l e s 
te'n	t 'e n	 t 'ɛ n 
t'ho	t 'o	 t 'e 
suen	s 'u e n	 s e n 
sofre	s 'o f ɾ e	 s 'ɔ f ɾ e 
sisena	s i z 'e n a	 s i s 'e n a 
seguim	s e ɣ 'i m	 s e ɣ u 'i m 
segueixi	s e ɣ 'e j ʃ i	 s e ɣ u 'ɛ j ʃ i 
seda	s 'e ð a	 s 'ɛ ð a 
sec	s 'e k	 s 'ɛ k 
sanefes	s a n 'e f e s	 s a n 'ɛ f e s 
sanefa	s a n 'e f a	 s a n 'ɛ f a 
ronda	r 'o n d a	 r 'ɔ n d a 
rere	r 'e ɾ e	 r 'ɛ ɾ e 
refresco	r e f ɾ 'e s k o	 r e f ɾ 'ɛ s k o 
recorre	r e k 'o r e	 r e k 'ɔ r e 
protegeix	p ɾ o t e ʒ 'e j ʃ	 p ɾ o t e ʒ 'e tʃ 
presta	p ɾ 'e s t a	 p ɾ 'ɛ s t a 
presses	p ɾ 'e s e s	 p ɾ 'ɛ s e s 
presento	p ɾ e z 'e n t o	 p ɾ e s 'ɛ n t o 
policies	p o l i s 'i e s	 p o l i k 'i e s 
poguessin	p o ɣ 'e s i n	 p o ɣ 'u 'ɛ s i n 
poemes	p o 'e m e s	 p o 'ɛ m e s 
perenne	p e ɾ 'e n n e	 p e ɾ 'ɛ n n e 
penja	p 'e n dʒ a	 p 'ɛ n dʒ a 
passegen	p a s 'e ʒ e n	 p a s 'e dʒ e n 
parisencs	p a ɾ i z 'e ŋ s	 p a ɾ i s 'e ŋ s 
palauet	p a l a w 'e t	 p a l a u 'e t 
omple	'o m p l e	 'ɔ m p l e 
ombres	'o m b ɾ e s	 'ɔ m b ɾ e s 
n'estava	n a s t 'a β a	 n e s t 'a β a 
megues	m 'e ɣ e s	 m 'ɛ ɣ e s 
matrimoni	m a t ɾ i m 'ɔ n i	 m a t ɾ i m 'o n i 
lluitava	ʎ u j t 'a β a	 ʎ u i t 'a β a 
lletja	ʎ 'e dʒ a	 ʎ 'ɛ dʒ a 
l'hagués	l a ɣ 'e s	 l u a ɣ 'e s 
l'alcohol	l a l k o 'o l	 l a l k o 'a l 
incloses	i ŋ k l 'o z e s	 i ŋ k l 'o s e s 
immenses	i m m 'e n s e s	 i m m 'ɛ n s e s 
immensa	i m m 'e n s a	 i m m 'ɛ n s a 
haver-hi	a β 'e ɾ i	 a β 'ɛ ɾ i 
grecs	g ɾ 'e k s	 g ɾ 'ɛ k s 
grec	g ɾ 'e k	 g ɾ 'ɛ k 
golfes	g 'o l f e s	 g 'ɔ l f e s 
gespa	dʒ 'e s p a	 g s p a 
gasoil	g a z 'ɔ j l	 g a z o 'i l 
frescos	f ɾ 'e s k o s	 f ɾ 'ɛ s k o s 
frego	f ɾ 'e ɣ o	 f ɾ 'ɛ ɣ o 
freds	f ɾ 'e t s	 f ɾ 'ɛ s 
fotre	f 'o t ɾ e	 f 'ɔ t ɾ e 
exempts	e g z 'e m t s	 e g z 'ɛ m p t s 
escolta	a s k 'o l t a	 a s k 'ɔ l t a 
escletxa	a s k l 'e tʃ a	 a s k l 'ɛ tʃ a 
entrega	a n t ɾ 'e ɣ a	 a n t ɾ 'ɛ g a 
enquestes	a ŋ k 'e s t e s	 a ŋ k 'ɛ s t e s 
enquesta	a ŋ k 'e s t a	 a ŋ k 'ɛ s t a 
empremtes	a m p ɾ 'e m t e s	 a m p ɾ 'ɛ m t e s 
elèctrics	e l 'ɛ k t ɾ i k s	 e l e k t ɾ 'i k s 
dotant-les	d o t 'a n l e s	 d o t 'a n d l e s 
digui'm	d 'i ɣ i m	 d i ɣ u 'i m 
difondre	d i f 'o n d ɾ e	 d i f 'ɔ n d ɾ e 
d'hores	d 'ɔ ɾ e s	 d e ɾ e s 
d'homes	d 'ɔ m e s	 d u m e s 
còctels	k 'ɔ k t e l s	 k o k t 'ɛ l s 
creuem	k ɾ e w 'e m	 k ɾ e u 'e m 
creua	k ɾ 'e w a	 k ɾ 'ɛ w a 
conca	k 'o ŋ k a	 k 'ɔ ŋ k a 
comte	k 'o m t e	 k 'ɔ m t e 
compren	k 'o m p ɾ e n	 k 'ɔ m p ɾ e n 
colze	k 'o l z e	 k 'ɔ l z e 
ceptre	s 'e p t ɾ e	 s 'ɛ p t ɾ e 
cegues	s 'e ɣ e s	 s 'ɛ ɣ e s 
calçoina	k a l s 'ɔ j n a	 k a l s 'ɔ i n a 
brolla	b ɾ 'o ʎ a	 b ɾ 'ɔ ʎ a 
bots	b 'o t s	 b 'ɔ t s 
bosses	b 'o s e s	 b 'ɔ s e s 
bolígrafs	b o l 'i ɣ ɾ a f s	 b o l i ɣ ɾ 'a f s 
boixedes	b o j ʃ 'e ð e s	 b o j ʃ 'ɛ ð e s 
beca	b 'e k a	 b 'ɛ k a 
assumptes	a s 'u m t e s	 a s 'u m p t e s 
assumpte	a s 'u m t e	 a s 'u m p t e 
anècdotes	a n 'ɛ g d o t e s	 a n e g d 'ɔ t e s 
ampolles	a m p 'o ʎ e s	 a m p 'ɔ ʎ e s 
aimara	a j m 'a ɾ a	 a i m 'a ɾ a 
agafant-me	a ɣ a f 'a m m e	 a ɣ a f 'a n d m e 
adquireixin	a t k i ɾ 'e j ʃ i n	 a t k i ɾ 'ɛ j ʃ i n 
accepto	a k s 'e p t o	 a k s 'ɛ p t o 
Web	b 'e p	 b 'ɛ p 
Torre	t 'o r e	 t 'ɔ r e 
Temps	t 'e m s	 t 'ɛ m p s 
Regne	r 'e g n e	 r 'ɛ g n e 
Noruega	n o ɾ u 'e ɣ a	 n o ɾ u 'ɛ ɣ a 
Mig	m 'i tʃ	 m 'i 
Me	m 'e	 m e 
Maresme	m a ɾ 'e z m e	 m a ɾ 'ɛ z m e 
Llei	ʎ 'e j	 ʎ 'ɛ i 
Kuwait	k u β 'a j t	 k u ɾ 'a i t 
Hola	'ɔ l a	 'a l a 
Guerra	g 'ɛ r a	 g u 'ɛ r a 
Escolta	a s k 'o l t a	 a s k 'ɔ l t a 
Dones	d 'ɔ n e s	 d 'o n e s 
Dimecres	d i m 'e k ɾ e s	 d i m 'ɛ k ɾ e s 
Descarrega't	d e s k a r 'e ɣ a t	 d e s k a r e ɣ 'a t 
Del	d 'e l	 d e l 
Celoni	s e l 'ɔ n i	 s e l 'o n i 
Camps	k 'a m s	 k 'a m p s 
Belgrad	b e l ɣ ɾ 'a t	 b e l ɣ ɾ 'a 
Volen	b 'o l e n	 b 'ɔ l e n 
Hi	'i	 i 
De	d 'e	 d e 
xops	tʃ 'o p s	 tʃ 'ɔ p s 
vinguessis	b i ŋ g 'e s i s	 b i ŋ g u 'ɛ s i s 
vendre	b 'e n d ɾ e	 b 'ɛ n d ɾ e 
tenda	t 'e n d a	 t 'ɛ n d a 
seny	s 'e ɲ	 s 'ɛ ɲ 
sens	s 'e n s	 s 'ɛ n s 
seguien	s e ɣ 'i e n	 s e ɣ u 'i e n 
s'escapava	s a s k a p 'a β a	 s e s k a p 'a β a 
s'encarregarà	s a ŋ k a r e ɣ a ɾ 'a	 s e ŋ k a r e ɣ a ɾ 'a 
reiterada	r e i t e ɾ 'a ð a	 r e j t e ɾ 'a ð a 
regeix	r e ʒ 'e j ʃ	 r e ʒ 'e tʃ 
presumpte	p ɾ e z 'u m t e	 p ɾ e z 'u m p t e 
pop	p 'o p	 p 'ɔ p 
poder-hi	p o ð 'e ɾ i	 p o ð 'ɛ ɾ i 
pinedes	p i n 'e ð e s	 p i n 'ɛ ð e s 
pessigolles	p e s i ɣ 'o ʎ e s	 p e s i ɣ 'ɔ ʎ e s 
penses	p 'e n s e s	 p 'ɛ n s e s 
pegues	p 'e ɣ e s	 p 'ɛ ɣ e s 
ombra	'o m b ɾ a	 'ɔ m b ɾ a 
oi	'ɔ j	 'o i 
mossec	m o s 'e k	 m o s 'ɛ k 
morro	m 'o r o	 m 'ɔ r o 
molesta	m o l 'e s t a	 m o l 'ɛ s t a 
mirant-lo	m i ɾ 'a n l o	 m i ɾ 'a n d l o 
metres	m 'e t ɾ e s	 m 'ɛ t ɾ e s 
linux	l i n 'u k s	 l i n 'u 
irrompre	i r 'o m p ɾ e	 i r 'ɔ m p ɾ e 
honest	o n 'e s t	 ɔ n 'ɛ s t 
hipnotitza	i b n o t 'i d z a	 i p n o t 'i d z a 
himne	'i m n e	 u 'i m n e 
grotesc	g ɾ o t 'e s k	 g ɾ o t 'ɛ s k 
fonda	f 'o n d a	 f 'ɔ n d a 
fleca	f l 'e k a	 f l 'ɛ k a 
feble	f 'e β l e	 f 'ɛ β l e 
estrangeres	a s t ɾ a n dʒ 'e ɾ e s	 a s t ɾ a ŋ 'e ɾ e s 
estranger	a s t ɾ a n dʒ 'e	 a s t ɾ a ŋ 'e 
distendre	d i s t 'e n d ɾ e	 d i s t 'ɛ n d ɾ e 
deshidratades	d e s i ð ɾ a t 'a ð e s	 d e z i ð ɾ a t 'a ð e s 
descomptes	d e s k 'o m t e s	 d e s k 'ɔ m p t e s 
descompte	d e s k 'o m t e	 d e s k 'ɔ m p t e 
d'interessant	d i n t e ɾ e s 'a n	 d i n t 'e ɾ e s 'a n 
d'home	d 'ɔ m e	 d u m e 
corro	k 'o r o	 k 'ɔ r o 
copa	k 'o p a	 k 'ɔ p a 
comprometre	k o m p ɾ o m 'e t ɾ e	 k o m p ɾ o m 'ɛ t ɾ e 
compres	k 'o m p ɾ e s	 k 'ɔ m p ɾ e s 
beques	b 'e k e s	 b 'ɛ k e s 
arruinats	a r u j n 'a t s	 a r u i n 'a t s 
aquesta	a k 'e s t a	 a k 'ɛ s t a 
alcohòlica	a l k o 'ɔ l i k a	 a l k o 'a l i k a 
afronta	a f ɾ 'o n t a	 a f ɾ 'ɔ n t a 
Tota	t 'o t a	 t 'ɔ t a 
Sec	s 'e k	 s 'ɛ k 
Se'm	s 'e m	 s 'ɛ m 
Ronda	r 'o n d a	 r 'ɔ n d a 
Queda	k 'e ð a	 k 'ɛ ð a 
M'hi	m 'i	 m 'e 
M'ha	m 'a	 m 'e 
Ginebra	dʒ i n 'e β ɾ a	 dʒ i n 'ɛ β ɾ a 
Engega	a n dʒ 'e ɣ a	 a n dʒ 'ɛ ɣ a 
Conec	k o n 'e k	 k o n 'ɛ k 
ítems	'i t e m s	 i t 'e m s 
àngels	'a n dʒ e l s	 a n dʒ 'ɛ l s 
que	k 'e	 k e 
eh	'e	 'ɛ 
Que	k 'e	 k e 
La	l 'a	 l a 
En	'e n	 e n 
xopa	tʃ 'o p a	 tʃ 'ɔ p a 
xop	tʃ 'o p	 tʃ 'ɔ p 
xeics	tʃ 'e j k s	 tʃ e 'i k s 
xef	tʃ 'e f	 tʃ 'ɛ f 
whiskys	b 'i s k i s	 a 'i s k s 
web	b 'e p	 b 'ɛ p 
vuitens	b u j t 'e n s	 b u j t 'ɛ n s 
vuitena	b u j t 'e n a	 b u i t 'e n a 
vodka	b 'o t k a	 b 'ɔ ð k a 
virrei	b i r 'e j	 b i r 'ɛ i 
vespres	b 'e s p ɾ e s	 b 'ɛ s p ɾ e s 
vendre'ns	b 'e n d ɾ e n s	 b e n d ɾ 'ɛ n s 
vendre'ls	b 'e n d ɾ e l s	 b e n d ɾ 'ɛ l s 
venc	b 'e ŋ	 b 'e n s 
valoren	b a l 'o ɾ e n	 b a l 'ɔ ɾ e n 
vagabund	b a ɣ a β 'u n	 b a ɣ a β 'u n i 
txecs	tʃ 'e k s	 tʃ 'ɛ k s 
tronxos	t ɾ 'o n tʃ o s	 t ɾ 'ɔ n tʃ o s 
trontolla	t ɾ o n t 'o ʎ a	 t ɾ o n t 'ɔ ʎ a 
trobadoresca	t ɾ o β a ð o ɾ 'e s k a	 t ɾ o β a ð o ɾ 'ɛ s k a 
trepig	t ɾ e p 'i tʃ	 t ɾ e p 'i 
trec	t ɾ 'e k	 t ɾ 'ɛ k 
trasplantessin	t ɾ a s p l a n t 'e s i n	 t ɾ a s p l a n t 'ɛ s i n 
transmetre	t ɾ a n z m 'e t ɾ e	 t ɾ a n z m 'ɛ t ɾ e 
transmeto	t ɾ a n z m 'e t o	 t ɾ a n z m 'ɛ t o 
transmetent-me	t ɾ a n z m e t 'e m m e	 t ɾ a n z m e t 'ɛ n d m e 
transcorre	t ɾ a n s k 'o r e	 t ɾ a n s k 'ɔ r e 
tova	t 'o β a	 t 'ɔ β a 
totxo	t 'o tʃ o	 t 'ɔ tʃ o 
totes	t 'o t e s	 t 'ɔ t e s 
tot	t 'o t	 t 'ɔ t 
torre	t 'o r e	 t 'ɔ r e 
torero	t o ɾ 'e ɾ o	 t o ɾ 'ɛ ɾ o 
topen	t 'o p e n	 t 'ɔ p e n 
tomba	t 'o m b a	 t 'ɔ m b a 
tirallongues	t i ɾ a ʎ 'o ŋ g e s	 t i ɾ a ʎ 'ɔ ŋ g e s 
tirallonga	t i ɾ a ʎ 'o ŋ g a	 t i ɾ a ʎ 'ɔ ŋ g a 
tinguent	t i ŋ g 'e n	 t i ŋ g w 'e n 
testos	t 'e s t o s	 t 'ɛ s t o s 
testa	t 'e s t a	 t 'ɛ s t a 
terraqüi	t e r 'a k w i	 t e r 'a k i 
tenyint-lo	t e ɲ 'i n l o	 t e ɲ 'i n d l o 
tempteig	t e m t 'e tʃ	 t e m p t 'e tʃ 
teclegen	t e k l 'e ʒ e n	 t e k l 'e dʒ e n 
te'm	t 'e m	 t 'ɛ m 
te'l	t 'e l	 t 'ɛ l 
t'havia	t a β 'i a	 t e β 'i a 
t'estimes	t a s t 'i m e s	 t e s t 'i m e s 
t'estima	t a s t 'i m a	 t e s t 'i m a 
t'estic	t a s t 'i k	 t e s t 'i k 
t'enyoro	t e ɲ 'o ɾ o	 t e ɲ 'ɔ ɾ o 
t'ensenyen	t a n s 'e ɲ e n	 t e n s 'e ɲ e n 
t'ensenyaré	t a n s e ɲ a ɾ 'e	 t e n s e ɲ a ɾ 'e 
súbdits	s 'u b d i t s	 s u b d 'i t s 
successos	s u k s 'e s o s	 s u k s 'ɛ s o s 
subministressin	s u b m i n i s t ɾ 'e s i n	 s u b m i n i s t ɾ 'ɛ s i n 
subhasta	s u β 'a s t a	 s u β e 'a s t a 
subgrup	s u b g ɾ 'u p	 s u p ɣ ɾ 'u p 
sotmetre	s o d m 'e t ɾ e	 s o t m 'ɛ t ɾ e 
sotmesos	s o d m 'e z o s	 s o t m 'e z o s 
sosteniment	s o s t e n i m 'e n	 s o s t 'ɛ n i m 'e n 
sopes	s 'o p e s	 s 'ɔ p e s 
sopen	s 'o p e n	 s 'ɔ p e n 
sopa	s 'o p a	 s 'ɔ p a 
solemnes	s o l 'e m n e s	 s o l 'ɛ m n e s 
silvestres	s i l β 'e s t ɾ e s	 s i l β 'ɛ s t ɾ e s 
serens	s e ɾ 'e n s	 s e ɾ 'ɛ n s 
ser-hi	s 'e ɾ i	 s 'ɛ ɾ i 
seques	s 'e k e s	 s 'ɛ k e s 
sentis	s 'e n t i s	 s 'ɛ n t i s 
sentint-me	s e n t 'i m m e	 s e n t 'i n d m e 
sempre	s 'e m p ɾ e	 s 'ɛ m p ɾ e 
semblessin	s e m b l 'e s i n	 s e m b l 'ɛ s i n 
seitons	s e j t 'o n s	 s e i t 'o n s 
segueixin	s e ɣ 'e j ʃ i n	 s e ɣ u 'ɛ i ʃ i n 
secs	s 'e k s	 s 'ɛ k s 
salts	s 'a l s	 s 'a l t s 
salpebra	s a l p 'e β ɾ a	 s a l p 'ɛ β ɾ a 
sahrauí	s a ɾ a w 'i	 s a i a u 'i 
s'oposen	s o p 'o z e n	 s o p 'ɔ z e n 
s'executen	s e g z e k 'u t e n	 s e k s e k 'u t e n 
s'esperava	s a s p e ɾ 'a β a	 s e s p e ɾ 'a β a 
s'espera	s a s p 'e ɾ a	 s e s p 'e ɾ a 
s'especifiquen	s a s p e s i f 'i k e n	 s e s p e s i f 'i k e n 
s'espantin	s a s p 'a n t i n	 s e s p 'a n t i n 
s'escoltà	s a s k o l t 'a	 s e s k o l t 'a 
s'equivoquen	s e k i β 'o k e n	 s e k i β 'ɔ k e n 
s'envia	s a m b 'i a	 s e m b 'i a 
s'ensenyen	s a n s 'e ɲ e n	 s e n s 'e ɲ e n 
s'enlairaria	s a n l a j ɾ a ɾ 'i a	 s e n l a j ɾ a ɾ 'i a 
s'enganxen	s a ŋ g 'a n tʃ e n	 s e ŋ g 'a n tʃ e n 
s'endureixin	s a n d u ɾ 'e j ʃ i n	 s e n d u ɾ 'ɛ i ʃ i n 
s'endugui	s a n d 'u ɣ i	 s e n d 'u ɣ i 
s'encén	s a n s 'e n	 s e n s 'e n 
s'encarrega	s a ŋ k a r 'e ɣ a	 s e ŋ k a r 'ɛ ɣ a 
s'emmiralla	s a m m i ɾ 'a ʎ a	 s e m m i ɾ 'a ʎ a 
s'embolica	s a m b o l 'i k a	 s e m b o l 'i k a 
s'avaluen	s a β a l 'u e n	 s a β a l e n 
s'atrinxeren	s a t ɾ i n tʃ 'ɛ ɾ e n	 s a t ɾ i n tʃ 'e ɾ e n 
s'amaguessin	s a m a ɣ 'e s i n	 s a m a ɣ u 'ɛ s i n 
s'adonen	s a ð 'o n e n	 s a ð 'ɔ n e n 
rotonda	r o t 'o n d a	 r o t 'ɔ n d a 
ronden	r 'o n d e n	 r 'ɔ n d e n 
ronca	r 'o ŋ k a	 r 'ɔ ŋ k a 
rodolen	r o ð 'o l e n	 r o ð 'ɔ l e n 
resseguint	r e s e ɣ 'i n	 r e s e ɣ u 'i n 
respecto	r e s p 'e k t o	 r e s p 'ɛ k t o 
respectessin	r e s p e k t 'e s i n	 r e s p e k t 'ɛ s i n 
resisteixin	r e z i s t 'e j ʃ i n	 r e z i s t 'ɛ j ʃ i n 
res	r 'e s	 r 'ɛ s 
requadre	r e k w 'a ð ɾ e	 r e k 'a ð ɾ e 
reptes	r 'e p t e s	 r 'ɛ p t e s 
reproduint-la	r e p ɾ o ð u 'i n l a	 r e p ɾ o ð i n d l a 
reprodueixi	r e p ɾ o ð u 'e j ʃ i	 r e p ɾ o ð u 'ɛ j ʃ i 
repeteixi	r e p e t 'e j ʃ i	 r e p e t 'ɛ j ʃ i 
rep	r 'e p	 r 'ɛ p 
renoven	r e n 'o β e n	 r e n 'ɔ β e n 
renecs	r e n 'e k s	 r e n 'ɛ k s 
rencontre	r e ŋ k 'o n t ɾ e	 r e ŋ k 'ɔ n t ɾ e 
remescles	r e m 'e s k l e s	 r e m 'ɛ s k l e s 
reintegrament	r e i n t e ɣ ɾ a m 'e n	 r e i n t 'ɛ ɣ ɾ a m 'e n 
regne	r 'e g n e	 r 'ɛ g n e 
reexaminar	r e e k s a m i n 'a	 r e e g z a m i n 'a 
redemptora	r e ð e m t 'o ɾ a	 r e ð e m p t 'o ɾ a 
recorren	r e k 'o r e n	 r e k 'ɔ r e n 
reconeixent-ne	r e k o n e j ʃ 'e n n e	 r e k o n e j ʃ 'ɛ n n e 
recolzo	r e k 'o l z o	 r e k 'ɔ l z o 
recolza	r e k 'o l z a	 r e k 'ɔ l z a 
rec	r 'e k	 r 'ɛ k 
rebessin	r e β 'e s i n	 r e β 'ɛ s i n 
rails	r 'a j l s	 r a 'i l s 
quedes	k 'e ð e s	 k 'ɛ ð e s 
psíquics	s 'i k i k s	 p s 'i k i k s 
proposo	p ɾ o p 'o z o	 p ɾ o p 'ɔ z o 
prometre'm	p ɾ o m 'e t ɾ e m	 p ɾ o m e t ɾ 'ɛ m 
prometre	p ɾ o m 'e t ɾ e	 p ɾ o m 'ɛ t ɾ e 
prometo	p ɾ o m 'e t o	 p ɾ o m 'ɛ t o 
preveuen	p ɾ e β 'e w e n	 p ɾ e β 'e e n 
pretendre	p ɾ e t 'e n d ɾ e	 p ɾ e t 'ɛ n d ɾ e 
presumpta	p ɾ e z 'u m t a	 p ɾ e z 'u m p t a 
prest	p ɾ 'e s t	 p ɾ 'ɛ s t 
premsa	p ɾ 'e m s a	 p ɾ 'ɛ m s a 
prefereixin	p ɾ e f e ɾ 'e j ʃ i n	 p ɾ e f e ɾ 'ɛ i ʃ i n 
porro	p 'o r o	 p 'ɔ r o 
popes	p 'o p e s	 p 'ɔ p e s 
podreixi	p o ð ɾ 'e j ʃ i	 p o ð ɾ 'ɛ j ʃ i 
plumero	p l u m 'e ɾ o	 p l u m 'ɛ ɾ o 
plego	p l 'e ɣ o	 p l 'ɛ ɣ o 
plega	p l 'e ɣ a	 p l 'ɛ ɣ a 
plecs	p l 'e k s	 p l 'ɛ k s 
piscines	p i s 'i n e s	 p i s k 'i n e s 
pintoresca	p i n t o ɾ 'e s k a	 p i n t o ɾ 'ɛ s k a 
peuets	p e w 'e t s	 p e u 'e t s 
penjo	p 'e n dʒ o	 p 'ɛ n dʒ o 
pega	p 'e ɣ a	 p 'ɛ ɣ a 
pebre	p 'e β ɾ e	 p 'ɛ β ɾ e 
patrimoni	p a t ɾ i m 'ɔ n i	 p a t ɾ i m 'o n i 
pateixin	p a t 'e j ʃ i n	 p a t 'ɛ j ʃ i n 
paisatgisme	p a j z a dʒ 'i z m e	 p a i z a dʒ 'i z m e 
oscil·la	o s 'i l a	 o s k 'i l a 
oncle	'o ŋ k l e	 'ɔ ŋ k l e 
oloro	o l 'o ɾ o	 o l 'ɔ ɾ o 
ofereixi	o f e ɾ 'e j ʃ i	 o f e ɾ 'ɛ j ʃ i 
ofendre's	o f 'e n d ɾ e s	 o f e n d ɾ 'ɛ s 
oest	o 'e s t	 o 'ɛ s t 
netegessin	n e t e ʒ 'e s i n	 n e t e ʒ 'ɛ s i n 
nedes	n 'e ð e s	 n 'ɛ ð e s 
navega	n a β 'e ɣ a	 n a β 'ɛ ɣ a 
naips	n 'a j p s	 n a 'i p s 
na	n 'a	 n a 
n'està	n a s t 'a	 n e s t 'a 
n'estic	n a s t 'i k	 n e s t 'i k 
n'escoltem	n a s k o l t 'e m	 n e s k o l t 'e m 
museòlegs	m u z e 'ɔ l e k s	 m u z e 'ɔ l 'e k s 
mosso	m 'o s o	 m 'ɔ s o 
mosca	m 'o s k a	 m 'ɔ s k a 
mosaic	m o z 'a j k	 m o z 'a i k 
morros	m 'o r o s	 m 'ɔ r o s 
molest	m o l 'e s t	 m o l 'ɛ s t 
moix	m 'o j ʃ	 m 'o tʃ 
millorant-les	m i ʎ o ɾ 'a n l e s	 m i ʎ o ɾ 'a n d l e s 
migcampistes	m i k k a m p 'i s t e s	 m i ɣ k a m p 'i s t e s 
metros	m 'e t ɾ o s	 m 'ɛ t ɾ o s 
metre	m 'e t ɾ e	 m 'ɛ t ɾ e 
mestra	m 'e s t ɾ a	 m 'ɛ s t ɾ a 
mescles	m 'e s k l e s	 m 'ɛ s k l e s 
manxec	m a n tʃ 'e k	 m a n tʃ 'ɛ k 
manifesta	m a n i f 'e s t a	 m a n i f 'ɛ s t a 
malaguenya	m a l a ɣ 'e ɲ a	 m a l a ɣ u 'ɛ ɲ a 
madrileny	m a ð ɾ i l 'e ɲ	 m a ð ɾ i l 'ɛ ɲ 
ma	m 'a	 m a 
m'has	m 'a s	 m 'e s 
m'hagis	m 'a ʒ i s	 m 'ɔ ʒ i s 
lluirà	ʎ u i ɾ 'a	 ʎ u j ɾ 'a 
lletra	ʎ 'e t ɾ a	 ʎ 'ɛ t ɾ a 
llesta	ʎ 'e s t a	 ʎ 'ɛ s t a 
llenço	ʎ 'e n s o	 ʎ 'ɛ n s o 
llenya	ʎ 'e ɲ a	 ʎ 'ɛ ɲ a 
llengües	ʎ 'e ŋ g w e s	 ʎ 'ɛ ŋ g w e s 
llegendes	ʎ e ʒ 'e n d e s	 ʎ e ʒ 'ɛ n d e s 
llegeixin	ʎ e ʒ 'e j ʃ i n	 ʎ e ʒ 'ɛ i ʃ i n 
llegeixi	ʎ e ʒ 'e j ʃ i	 ʎ e ʒ e 'i ʃ i 
lepra	l 'e p ɾ a	 l 'ɛ p ɾ a 
lamento	l a m 'e n t o	 l a m 'ɛ n t o 
l'interessava	l i n t e ɾ e s 'a β a	 l i n t 'e ɾ e s 'a β a 
l'hoste	l 'ɔ s t e	 l e s t e 
l'envoltaven	l a m b o l t 'a β e n	 l e m b o l t 'a β e n 
l'envoltava	l a m b o l t 'a β a	 l e m b o l t 'a β a 
l'algebraic	l a l dʒ e β ɾ 'a j k	 l a l dʒ e β ɾ 'a i k 
l'Antoni	l a n t 'ɔ n i	 l a n t 'o n i 
jueva	dʒ u 'e β a	 dʒ u 'ɛ β a 
jesuïtes	dʒ e z u 'i t e s	 dʒ e s u 'i t e s 
jamaicans	dʒ a m a j k 'a n s	 dʒ a m a i k 'a n s 
intrínsecs	i n t ɾ 'i n s e k s	 i n t ɾ i n s 'e k s 
interrompre	i n t e r 'o m p ɾ e	 i n t e r 'ɔ m p ɾ e 
interrogant-los	i n t e r o ɣ 'a n l o s	 i n t e r o ɣ 'a n d l o s 
interessin	i n t e ɾ 'e s i n	 i n t e ɾ 'ɛ s i n 
intensos	i n t 'e n s o s	 i n t 'ɛ n s o s 
intensa	i n t 'e n s a	 i n t 'ɛ n s a 
insisteixi	i n s i s t 'e j ʃ i	 i n s i s t 'ɛ j ʃ i 
ingresses	i ŋ g ɾ 'e s e s	 i ŋ g ɾ 'ɛ s e s 
incideixi	i n s i ð 'e j ʃ i	 i n s i ð 'ɛ j ʃ i 
ignoren	i g n 'o ɾ e n	 i g n 'ɔ ɾ e n 
idoni	i ð 'ɔ n i	 i ð 'o n i 
híbrid	'i β ɾ i t	 a β ɾ i t 
hostesses	o s t 'e s e s	 o s t 'ɛ s e s 
hora	'ɔ ɾ a	 a ɾ a 
hola	'ɔ l a	 'a l a 
himnes	'i m n e s	 u 'i m n e s 
heteròtrofa	e t e ɾ 'ɔ t ɾ o f a	 a t e ɾ 'ɔ t ɾ o f a 
haguessis	a ɣ 'e s i s	 a ɣ u 'ɛ s i s 
haguessin	a ɣ 'e s i n	 a ɣ u 'ɛ s i n 
guinda	g 'i n d a	 g u 'i n d a 
guetos	g 'e t o s	 g u 'ɛ t o s 
guanyant-me	g w a ɲ 'a m m e	 g w a ɲ 'a n d m e 
groguenc	g ɾ o ɣ 'e ŋ	 g ɾ o ɣ 'e n s 
grinyolen	g ɾ i ɲ 'o l e n	 g ɾ i ɲ 'ɔ l e n 
greixos	g ɾ 'e j ʃ o s	 g ɾ 'ɛ j ʃ o s 
granger	g ɾ a n dʒ 'e	 g ɾ a ŋ 'e 
golfo	g 'o l f o	 g 'ɔ l f o 
gestos	dʒ 'e s t o s	 dʒ 'ɛ s t o s 
gesta	dʒ 'e s t a	 dʒ 'ɛ s t a 
gemecs	dʒ e m 'e k s	 dʒ e m 'ɛ k s 
gemec	dʒ e m 'e k	 dʒ e m 'ɛ k 
gallega	g a ʎ 'e ɣ a	 g a ʎ 'ɛ ɣ a 
galleda	g a ʎ 'e ð a	 g a ʎ 'ɛ ð a 
gairell	g a j ɾ 'e ʎ	 g a i ɾ 'e ʎ 
férem	f 'e ɾ e m	 f e ɾ 'e m 
fresc	f ɾ 'e s k	 f ɾ 'ɛ s k 
frens	f ɾ 'e n s	 f ɾ 'ɛ n s 
frega	f ɾ 'e ɣ a	 f ɾ 'ɛ ɣ a 
fredes	f ɾ 'e ð e s	 f ɾ 'ɛ ð e s 
frec	f ɾ 'e k	 f ɾ 'ɛ k 
fots	f 'o t s	 f 'ɔ t s 
fotre-li	f 'o t ɾ e l i	 f o t ɾ 'ɛ l i 
fot	f 'o t	 f 'ɔ t 
fletxes	f l 'e tʃ e s	 f l 'ɛ tʃ e s 
fletxa	f l 'e tʃ a	 f l 'ɛ tʃ a 
flamenc	f l a m 'e ŋ	 f l a m 'e n s 
fiquessin	f i k 'e s i n	 f i k 'ɛ s i n 
finestra	f i n 'e s t ɾ a	 f i n 'ɛ s t ɾ a 
fer-hi	f 'e ɾ i	 f 'ɛ ɾ i 
fent-lo	f 'e n l o	 f 'ɛ n d l o 
feixos	f 'e j ʃ o s	 f 'ɛ j ʃ o s 
fatxendes	f a tʃ 'e n d e s	 f a tʃ 'ɛ n d e s 
extrems	e k s t ɾ 'e m s	 e k s t ɾ 'ɛ m s 
extremenya	e k s t ɾ e m 'e ɲ a	 e k s t ɾ e m 'ɛ ɲ a 
extensa	e k s t 'e n s a	 e k s t 'ɛ n s a 
extens	e k s t 'e n s	 e k s t 'ɛ n s 
expressant-li	e k s p ɾ e s 'a n l i	 e k s p ɾ e s 'a n d l i 
expliquessin	e k s p l i k 'e s i n	 e k s p l i k 'ɛ s i n 
explicant-me	e k s p l i k 'a m m e	 e k s p l i k 'a n d m e 
explicant-los	e k s p l i k 'a n l o s	 e k s p l i k 'a n d l o s 
existeixi	e g z i s t 'e j ʃ i	 e g z i s t 'ɛ j ʃ i 
exemples	e g z 'e m p l e s	 e g z 'ɛ m p l e s 
executa	e g z e k 'u t a	 e k s e k 'u t a 
excedit	e k s e ð 'i t	 e k s e e ð 'i t 
etc	'e t k	 'ɛ t k 
estómac	a s t 'o m a k	 a s t o m 'a k 
estudiïn	a s t u ð 'i i n	 a s t u ð i 'i n 
estris	'ɛ s t ɾ i s	 a s t ɾ i s 
estrenyent-me	a s t ɾ e ɲ 'e m m e	 a s t ɾ e ɲ 'ɛ n d m e 
estimant-la	a s t i m 'a n l a	 a s t i m 'a n d l a 
estepa	a s t 'e p a	 a s t 'ɛ p a 
espessos	a s p 'e s o s	 a s p 'ɛ s o s 
espero	a s p 'e ɾ o	 a s p 'ɛ ɾ o 
esperessis	a s p e ɾ 'e s i s	 a s p e ɾ 'ɛ s i s 
esperessin	a s p e ɾ 'e s i n	 a s p e ɾ 'ɛ s i n 
esperant-los	a s p e ɾ 'a n l o s	 a s p e ɾ 'a n d l o s 
esgrogueït	a z ɣ ɾ o ɣ e 'i t	 a z ɣ ɾ o ɣ u 'ɛ 'i t 
esglai	a z ɣ l 'a j	 a z ɣ l 'a i 
esgarrifoses	a z ɣ a r i f 'o z e s	 a z ɣ a r i f 'o s e s 
esfinx	a s f 'i n tʃ	 e s f 'i n 
escombra	a s k 'o m b ɾ a	 a s k 'ɔ m b ɾ a 
escolto	a s k 'o l t o	 a s k 'ɔ l t o 
escoltes	a s k 'o l t e s	 a s k 'ɔ l t e s 
esclafant-les	a s k l a f 'a n l e s	 a s k l a f 'a n d l e s 
escaigui	a s k 'a j ɣ i	 a s k 'a i ɣ i 
esbufega	a z β u f 'e ɣ a	 a z β u f 'ɛ ɣ a 
enviïn	a m b 'i i n	 a m b i 'i n 
entendre'n	a n t 'e n d ɾ e n	 a n t e n d ɾ 'ɛ n 
engego	a n dʒ 'e ɣ o	 a n dʒ 'ɛ ɣ o 
engega	a n dʒ 'e ɣ a	 a n dʒ 'ɛ ɣ a 
enganxoses	a ŋ g a n tʃ 'o z e s	 a ŋ g a n tʃ 'o s e s 
endreço	a n d ɾ 'e s o	 a n d ɾ 'ɛ s o 
encabeixi	a ŋ k a β 'e j ʃ i	 a ŋ k a β 'ɛ j ʃ i 
emborratxant-me	a m b o r a tʃ 'a m m e	 a m b o r a tʃ 'a n d m e 
elèctrica	e l 'ɛ k t ɾ i k a	 e l e k t ɾ 'i k a 
dèficits	d 'ɛ f i s i t s	 d e f i s 'i t s 
donessin	d o n 'e s i n	 d o n 'ɛ s i n 
donant-nos	d o n 'a n n o s	 d o n 'a n i n o s 
donant-los	d o n 'a n l o s	 d o n 'a n d l o s 
donant-li	d o n 'a n l i	 d o n 'a n d l i 
dobla	d 'o β l a	 d 'ɔ β l a 
divuitena	d i β u j t 'e n a	 d i β u i t 'e n a 
distribueixin	d i s t ɾ i β u 'e j ʃ i n	 d i s t ɾ i β u 'ɛ j ʃ i n 
disposo	d i s p 'o z o	 d i s p 'ɔ z o 
discrepo	d i s k ɾ 'e p o	 d i s k ɾ 'ɛ p o 
dirigeixi's	d i ɾ i ʒ 'e j ʃ i s	 d i ɾ i ʒ e j ʃ 'i s 
diferencio	d i f e ɾ e n s 'i o	 d i f e ɾ e ŋ 'i o 
diferencien	d i f e ɾ e n s 'i e n	 d i f e ɾ e ŋ 'i e n 
dibuixant-me	d i β u j ʃ 'a m m e	 d i β u j ʃ 'a n d m e 
detesto	d e t 'e s t o	 d e t 'ɛ s t o 
desitgi	d e z 'i dʒ i	 d e z 'i tʃ i 
desinteressats	d e z i n t e ɾ e s 'a t s	 d e z i n t 'e ɾ e s 'a t s 
desigs	d e z 'i tʃ s	 d e z 'i s 
descobreixin	d e s k o β ɾ 'e j ʃ i n	 d e s k o β ɾ 'ɛ j ʃ i n 
delinqüents	d e l i ŋ k w 'e n s	 d e l i n e 'e n s 
deixis	d 'e j ʃ i s	 d 'ɛ j ʃ i s 
deixi'm	d 'e j ʃ i m	 d e j ʃ 'i m 
deixessin	d e j ʃ 'e s i n	 d e j ʃ 'ɛ s i n 
deixant-me	d e j ʃ 'a m m e	 d e j ʃ 'a n d m e 
deixa't	d 'e j ʃ a t	 d e j ʃ 'a t 
deixa'm	d 'e j ʃ a m	 d e j ʃ 'a m 
defenses	d e f 'e n s e s	 d e f 'ɛ n s e s 
decideixi	d e s i ð 'e j ʃ i	 d e s i ð 'ɛ j ʃ i 
decep	d e s 'e p	 d e s 'ɛ p 
damisel·la	d a m i z 'ɛ l a	 d a m i s 'ɛ l a 
d'or	d 'ɔ r	 d 'o 
d'exotisme	d e g z o t 'i z m e	 d e k s o t 'i z m e 
d'anècdotes	d a n 'ɛ g d o t e s	 d a n e g d 'ɔ t e s 
d'alcohol	d a l k o 'o l	 d a l k o 'a l 
d'afeitar	d a f e j t 'a	 d a f e i t 'a 
d'Alcohòlics	d a l k o 'ɔ l i k s	 d a l k o 'a l i k s 
còmplices	k 'ɔ m p l i s e s	 k o m p l 'i s e s 
càstigs	k 'a s t i k s	 k a s t 'i ɣ s 
cuinera	k u j n 'e ɾ a	 k u i n 'e ɾ a 
cuinar	k u j n 'a	 k u i n 'a 
cuidava	k u j ð 'a β a	 k u i ð 'a β a 
cuidant	k u j ð 'a n	 k u i ð 'a n 
cromos	k ɾ 'o m o s	 k ɾ 'ɔ m o s 
creïn	k ɾ 'e i n	 k ɾ e 'i n 
cremes	k ɾ 'e m e s	 k ɾ 'ɛ m e s 
creessin	k ɾ e 'e s i n	 k ɾ e 'ɛ s i n 
credo	k ɾ 'e ð o	 k ɾ 'ɛ ð o 
cosa	k 'ɔ z a	 k 'o z a 
convidant-los	k o m b i ð 'a n l o s	 k o m b i ð 'a n d l o s 
convidant-la	k o m b i ð 'a n l a	 k o m b i ð 'a n d l a 
controlo	k o n t ɾ 'o l o	 k o n t ɾ 'ɔ l o 
continuessin	k o n t i n u 'e s i n	 k o n t i n u 'ɛ s i n 
contesto	k o n t 'e s t o	 k o n t 'ɛ s t o 
contemplant-li	k o n t e m p l 'a n l i	 k o n t e m p l 'a n d l i 
consta	k 'o n s t a	 k 'ɔ n s t a 
considero	k o n s i ð 'e ɾ o	 k o n s i ð 'ɛ ɾ o 
conques	k 'o ŋ k e s	 k 'ɔ ŋ k e s 
condueixi	k o n d u 'e j ʃ i	 k o n d u 'ɛ j ʃ i 
condemna	k o n d 'e m n a	 k o n d 'ɛ m n a 
completa-la	k o m p l 'e t a l a	 k o m p l e t 'a l a 
complauen	k o m p l 'a w e n	 k o m p l 'a e n 
cometre	k o m 'e t ɾ e	 k o m 'ɛ t ɾ e 
col·legues	k o l 'e ɣ e s	 k o l 'ɛ ɣ e s 
coloraines	k o l o ɾ 'a j n e s	 k o l o ɾ 'a i n e s 
cofoi	k o f 'ɔ j	 k o f 'o i 
coco	k 'o k o	 k 'ɔ k o 
cobren	k 'o β ɾ e n	 k 'ɔ β ɾ e n 
cobreixi	k o β ɾ 'e j ʃ i	 k o β ɾ 'ɛ j ʃ i 
clavant-li	k l a β 'a n l i	 k l a β 'a n d l i 
clauers	k l a w 'e s	 k l a u 'e s 
centígrads	s e n t 'i ɣ ɾ a t s	 s e n t i ɣ ɾ 'a ð s 
cec	s 'e k	 s 'ɛ k 
cauen	k 'a w e n	 k 'a e n 
carrego	k a r 'e ɣ o	 k a r 'ɛ ɣ o 
caribenya	k a ɾ i β 'e ɲ a	 k a ɾ i β 'ɛ ɲ a 
carai	k a ɾ 'a j	 k a ɾ 'a i 
caracteritzant-lo	k a ɾ a k t e ɾ i d z 'a n l o	 k a ɾ a k t e ɾ i d z 'a n d l o 
capbussar	k a b b u s 'a	 k a p b u s 'a 
bàdminton	b 'a d m i n t o n	 b a d m i n t 'o n 
buidor	b u j ð 'o	 b u i ð 'o 
brots	b ɾ 'o t s	 b ɾ 'ɔ t s 
brollen	b ɾ 'o ʎ e n	 b ɾ 'ɔ ʎ e n 
bot	b 'o t	 b 'ɔ t 
bombolles	b o m b 'o ʎ e s	 b o m b 'ɔ ʎ e s 
bolquen	b 'o l k e n	 b 'ɔ l k e n 
boirina	b o j ɾ 'i n a	 b o i ɾ 'i n a 
bodegues	b o ð 'e ɣ e s	 b o ð 'ɛ ɣ e s 
beuen	b 'e w e n	 b 'e e n 
bes	b 'e s	 b 'ɛ s 
basés	b a z 'e s	 b a s 'e s 
assímptotes	a s 'i m t o t e s	 a s 'i m p t o t e s 
asimètrica	a s i m 'ɛ t ɾ i k a	 a z i m 'ɛ t ɾ i k a 
arribessin	a r i β 'e s i n	 a r i β 'ɛ s i n 
aproven	a p ɾ 'o β e n	 a p ɾ 'ɔ β e n 
anècdota	a n 'ɛ g d o t a	 a n e g d 'ɔ t a 
antropòlegs	a n t ɾ o p 'ɔ l e k s	 a n t ɾ o p o l 'e k s 
anhelant-la	a n e l 'a n l a	 a n e l 'a n d l a 
angoixa	a ŋ g 'o j ʃ a	 a ŋ g o 'i tʃ a 
anessin	a n 'e s i n	 a n 'ɛ s i n 
amagant-li	a m a ɣ 'a n l i	 a m a ɣ 'a n d l i 
alts	'a l s	 'a l t s 
algebraic	a l dʒ e β ɾ 'a j k	 a l dʒ e β ɾ 'a i k 
alegre	a l 'e ɣ ɾ e	 a l 'ɛ ɣ ɾ e 
alcohòliques	a l k o 'ɔ l i k e s	 a l k o 'a l i k e s 
alauita	a l a w 'i t a	 a l a u 'i t a 
ajudant-la	a ʒ u ð 'a n l a	 a ʒ u ð 'a n d l a 
aixeco	a j ʃ 'e k o	 a j ʃ 'ɛ k o 
aixecant-li	a j ʃ e k 'a n l i	 a j ʃ e k 'a n d l i 
aixeca	a j ʃ 'e k a	 a j ʃ 'ɛ k a 
agrupa'ls	a ɣ ɾ 'u p a l s	 a ɣ ɾ u p 'a l s 
agafessin	a ɣ a f 'e s i n	 a ɣ a f 'ɛ s i n 
afruitat	a f ɾ u j t 'a t	 a f ɾ u i t 'a t 
afegeixi	a f e ʒ 'e j ʃ i	 a f e ʒ e 'i ʃ i 
adequa	a ð 'e k w a	 a ð 'ɛ k w a 
aconseguint	a k o n s e ɣ 'i n	 a k o n s e ɣ u 'i n 
acceptant-la	a k s e p t 'a n l a	 a k s e p t 'a n d l a 
a	'a	 a 
Zürich	z u ɾ 'i k	 z e ɾ 'i k 
Zagreb	z a ɣ ɾ 'e p	 z a ɣ 'ɛ p 
Xop	tʃ 'o p	 tʃ 'ɔ p 
Weissmann	b e j s m 'a n n	 b e i s m 'a n n 
Webs	b 'e p s	 b 'ɛ p s 
Vicent	b i s 'ɛ n	 b i k 'e n 
Ve	b 'e	 b 'ɛ 
Vailets	b a j l 'e t s	 b a i l 'e t s 
Unesco	u n 'e s k o	 u n 'ɛ s k o 
Trodheim	t ɾ o ð 'e j m	 t ɾ o ð e 'i m 
Trec	t ɾ 'e k	 t ɾ 'ɛ k 
Thyssen	t 'i s e n	 t e s 'e n 
Te'n	t 'e n	 t 'ɛ n 
Te	t 'e	 t e 
Taipei	t a j p 'e j	 t a i p 'ɛ i 
T'ho	t 'o	 t 'e 
T'estimo	t a s t 'i m o	 t e s t 'i m o 
Sobre	s 'o β ɾ e	 s 'ɔ β ɾ e 
Sistemes	s i s t 'e m e s	 s i s t 'ɛ m e s 
Setze	s 'e d z e	 s 'ɛ d z e 
Selvas	s 'ɛ l β a s	 s e l β 'a s 
Seguim	s e ɣ 'i m	 s e ɣ u 'i m 
Se'l	s 'e l	 s 'ɛ l 
Samland	s a m l 'a n	 s a m l 'a n i 
S'ho	s 'o	 s 'e 
S'entén	s a n t 'e n	 s e n t 'e n 
Rodolen	r o ð 'o l e n	 r o ð 'ɔ l e n 
Remei	r e m 'e j	 r e m 'ɛ i 
Reintegrament	r e i n t e ɣ ɾ a m 'e n	 r e i n t 'ɛ ɣ ɾ a m 'e n 
Quedo	k 'e ð o	 k 'ɛ ð o 
Pladellorens	p l a ð e ʎ o ɾ 'e n s	 p l a ð e ʎ o ɾ 'ɛ n s 
Pingu	p 'i ŋ g u	 p 'i ŋ g 
Perecamps	p e ɾ e k 'a m s	 p e ɾ e k 'a m p s 
Parisencs	p a ɾ i z 'e ŋ s	 p a ɾ i s 'e ŋ s 
Omple	'o m p l e	 'ɔ m p l e 
Nois	n 'ɔ j s	 n 'o i s 
Nogueira	n o ɣ 'e j ɾ a	 n o ɣ u 'ɛ 'i ɾ a 
Navega	n a β 'e ɣ a	 n a β 'ɛ ɣ a 
N'estripa	n a s t ɾ 'i p a	 n e s t ɾ 'i p a 
Mossos	m 'o s o s	 m 'ɔ s o s 
Montseny	m o n s 'e ɲ	 m o n s 'ɛ ɲ 
Menja	m 'e n dʒ a	 m 'ɛ n dʒ a 
M'has	m 'a s	 m 'e s 
Légolas	l 'e ɣ o l a s	 l e ɣ o l 'a s 
Lund	l 'u n	 l 'u n i 
Lo	l 'o	 l o 
Llevo	ʎ 'e β o	 ʎ 'ɛ β o 
Llegeix	ʎ e ʒ 'e j ʃ	 ʎ e ʒ 'e tʃ 
Lisboa	l i z β 'o a	 l i z β 'ɔ a 
Leopardi	l e o p 'a ɾ ð i	 l e o p 'a ɾ i i 
L'Òscar	l 'ɔ s k a	 l o s k 'a 
L'amiguisme	l a m i ɣ 'i z m e	 l a m i ɣ u 'i z m e 
L'Antoni	l a n t 'ɔ n i	 l a n t 'o n i 
Kinkel	k i ŋ k 'ɛ l	 s i n s 'ɛ l 
Killilea	k i ʎ i l 'e a	 s i ʎ i l 'e a 
Kenya	k 'e ɲ a	 k 'ɛ ɲ a 
Jofre	dʒ 'o f ɾ e	 dʒ 'ɔ f ɾ e 
Jeroni	dʒ e ɾ 'ɔ n i	 dʒ e ɾ 'o n i 
Ignoro	i g n 'o ɾ o	 i g n 'ɔ ɾ o 
Ibarretxe	i β a r 'e tʃ e	 i β a r 'ɛ tʃ e 
Hug	'u k	 'a g 
Haig	'a tʃ	 o 'i a 
Graset	g ɾ a z 'e t	 g ɾ a s 'e t 
Floraina	f l o ɾ 'a j n a	 f l o ɾ 'a i n a 
Finestres	f i n 'e s t ɾ e s	 f i n 'ɛ s t ɾ e s 
Festes	f 'e s t e s	 f 'ɛ s t e s 
Festa	f 'e s t a	 f 'ɛ s t a 
Explica'ls	e k s p l 'i k a l s	 e k s p l i k 'a l s 
Executa	e g z e k 'u t a	 e k s e k 'u t a 
Espera'm	a s p 'e ɾ a m	 a s p e ɾ 'a m 
Escolta'm	a s k 'o l t a m	 a s k o l t 'a m 
Elisenda	e l i z 'e n d a	 ɛ l i s 'ɛ n d a 
Elisabet	e l i z a β 'e t	 ɛ l i z a β 'e t 
Eindhoven	e j n d 'o β e n	 e j n d e β e n 
Ebre	'e β ɾ e	 'ɛ β ɾ e 
Ebre	'e β ɾ e	 'ɛ β ɾ e 
Diguem-ne	d i ɣ 'e m n e	 d i ɣ u 'ɛ m n e 
Detroit	d e t ɾ 'ɔ j t	 d e t ɾ o 'i t 
Detlef	d e d l 'e f	 d e t l 'ɛ f 
Deixi	d 'e j ʃ i	 d 'ɛ j ʃ i 
Darrere	d a r 'e ɾ e	 d a r 'ɛ ɾ e 
D'aleshores	d a l e s 'ɔ ɾ e s	 d a l e s 'o ɾ e s 
D'Holanda	d o l 'a n d a	 d e o l 'a n d a 
Copia-la	k o p 'i a l a	 k o p i 'a l a 
Copa	k 'o p a	 k 'ɔ p a 
Consta	k 'o n s t a	 k 'ɔ n s t a 
Comptes	k 'o m t e s	 k 'ɔ m p t e s 
Compta	k 'o m t a	 k 'ɔ m p t a 
Cleveland	k l e β e l 'a n	 k l e β e l 'a n i 
Chirac	tʃ i ɾ 'a k	 k i ɾ 'a k 
Cheng	tʃ 'e ŋ	 k o ŋ 
Carreras	k a r 'e ɾ a s	 k a r 'ɛ ɾ a s 
Carnero	k a ɾ n 'e ɾ o	 k a ɾ n 'ɛ ɾ o 
Canberra	k a m b 'ɛ r a	 k a n b 'ɛ r a 
Bohigas	b o 'i ɣ a s	 b o a ɣ 'a s 
Boeing	b o 'e j ŋ	 b o e 'i ŋ 
Bodes	b 'o ð e s	 b 'ɔ ð e s 
Bec	b 'e k	 b 'ɛ k 
Bagdad	b a g d 'a t	 b a g d 'a 
Avisa'm	a β 'i z a m	 a β i z 'a m 
Alfred	a l f ɾ 'e t	 a l f ɾ 'e 
Aixeca	a j ʃ 'e k a	 a j ʃ 'ɛ k a 
Ai	'a j	 'a i 
Agenda	a ʒ 'e n d a	 a ʒ 'ɛ n d a 
Acosta't	a k 'ɔ s t a t	 a k o s t 'a t 
el	'e l	 e l 
carrega	k a r 'e ɣ a	 k a r 'ɛ ɣ a 
úlceres	'u l s e ɾ e s	 u l s 'e ɾ e s 
oi	'ɔ j	 'o i 
es	'e s	 e s 
el	'e l	 e l 
a	'a	 a 
Totes	t 'o t e s	 t 'ɔ t e s 
Si	s 'i	 s i 
N'està	n a s t 'a	 n e s t 'a 
Madrid	m a ð ɾ 'i t	 m a ð ɾ 'i 
Li	l 'i	 l i 
I	'i	 i 
Ho	'o	 o 
He	'e	 'a 
Aquesta	a k 'e s t a	 a k 'ɛ s t a 
que	k 'e	 k e 
hi	'i	 i 
guerra	g 'ɛ r a	 g u 'ɛ r a 
Si	s 'i	 s i 
Queda	k 'e ð a	 k 'ɛ ð a 
I	'i	 i 
He	'e	 'a 
Compte	k 'o m t e	 k 'ɔ m p t e 
zero	z 'e ɾ o	 z 'ɛ ɾ o 
xilens	tʃ i l 'e n s	 tʃ i l 'ɛ n s 
xerrameca	tʃ e r a m 'e k a	 tʃ e r a m 'ɛ k a 
xecs	tʃ 'e k s	 tʃ 'ɛ k s 
web	b 'e p	 b 'ɛ p 
veto	b 'e t o	 b 'ɛ t o 
vendre'n	b 'e n d ɾ e n	 b e n d ɾ 'ɛ n 
venda	b 'e n d a	 b 'ɛ n d a 
udol	u ð 'o l	 u ð 'ɔ l 
túnels	t 'u n e l s	 t u n 'ɛ l s 
txeca	tʃ 'e k a	 tʃ 'ɛ k a 
tropes	t ɾ 'o p e s	 t ɾ 'ɔ p e s 
treva	t ɾ 'e β a	 t ɾ 'ɛ β a 
tradueixi	t ɾ a ð u 'e j ʃ i	 t ɾ a ð u 'ɛ j ʃ i 
tests	t 'e s t s	 t 'ɛ s t s 
temple	t 'e m p l e	 t 'ɛ m p l e 
tempestes	t e m p 'e s t e s	 t e m p 'ɛ s t e s 
tanquessin	t a ŋ k 'e s i n	 t a ŋ k 'ɛ s i n 
t'esquincen	t a s k 'i n s e n	 t e s k 'i n s e n 
t'espaviles	t a s p a β 'i l e s	 t e s p a β 'i l e s 
t'espantis	t a s p 'a n t i s	 t e s p 'a n t i s 
t'aixeques	t a j ʃ 'e k e s	 t a j ʃ 'ɛ k e s 
símbols	s 'i m b o l s	 s i m b 'ɔ l s 
sys	s 'i s	 s s 
suspens	s u s p 'e n s	 s u s p 'ɛ n s 
suec	s u 'e k	 s u 'ɛ k 
substitueixi	s u p s t i t u 'e j ʃ i	 s u p s t i t u 'ɛ j ʃ i 
sotmet	s o d m 'e t	 s o t m 'e t 
serenos	s e ɾ 'e n o s	 s e ɾ 'ɛ n o s 
senti	s 'e n t i	 s 'ɛ n t i 
s'opta	s 'o p t a	 s 'ɔ p t a 
s'exposa	s e k s p 'ɔ z a	 s e k s p 'o z a 
s'executa	s e g z e k 'u t a	 s e k s e k 'u t a 
s'esmuny	s a z m 'u ɲ	 s e z m 'u ɲ 
s'escriguin	s a s k ɾ 'i ɣ i n	 s e s k ɾ 'i ɣ i n 
s'escindís	s a s i n d 'i s	 s e s i n d 'i s 
s'escampa	s a s k 'a m p a	 s e s k 'a m p a 
s'entenien	s a n t e n 'i e n	 s e n t e n 'i e n 
s'encongia	s a ŋ k o n dʒ 'i a	 s e ŋ k o n dʒ 'i a 
s'encarregaria	s a ŋ k a r e ɣ a ɾ 'i a	 s e ŋ k a r e ɣ a ɾ 'i a 
s'encallava	s a ŋ k a ʎ 'a β a	 s e ŋ k a ʎ 'a β a 
s'empetiteix	s a m p e t i t 'e j ʃ	 s e m p e t i t 'e j ʃ 
s'aboquen	s a β 'o k e n	 s a β 'ɔ k e n 
ruixats	r u j ʃ 'a t s	 r i ʃ 'a t s 
retrec	r e t ɾ 'e k	 r e t ɾ 'ɛ k 
resseguim	r e s e ɣ 'i m	 r e s e ɣ u 'i m 
rentessin	r e n t 'e s i n	 r e n t 'ɛ s i n 
refreda	r e f ɾ 'e ð a	 r e f ɾ 'ɛ ð a 
rebérem	r e β 'e ɾ e m	 r e β e ɾ 'e m 
provoquen	p ɾ o β 'o k e n	 p ɾ o β 'ɔ k e n 
protesto	p ɾ o t 'e s t o	 p ɾ o t 'ɛ s t o 
protesta	p ɾ o t 'e s t a	 p ɾ o t 'ɛ s t a 
promig	p ɾ o m 'i tʃ	 p ɾ o m 'i 
promig	p ɾ o m 'i tʃ	 p ɾ o m 'i 
progressos	p ɾ o ɣ ɾ 'e s o s	 p ɾ o ɣ ɾ 'ɛ s o s 
presumptes	p ɾ e z 'u m t e s	 p ɾ e z 'u m p t e s 
presentessin	p ɾ e z e n t 'e s i n	 p ɾ e z e n t 'ɛ s i n 
presenta-me'l	p ɾ e z 'e n t a m e l	 p ɾ e z e n t a m 'ɛ l 
prenc	p ɾ 'e ŋ	 p ɾ 'e n s 
precoç	p ɾ e k 'ɔ s	 p ɾ e k 'o s 
polze	p 'o l z e	 p 'ɔ l z e 
podent-vos	p o ð 'e m b o s	 p o ð 'ɛ n d b o s 
ple	p l 'e	 p l 'ɛ 
picotegen	p i k o t 'e ʒ e n	 p i k o t 'e dʒ e n 
picant-li	p i k 'a n l i	 p i k 'a n d l i 
peto	p 'e t o	 p 'ɛ t o 
opten	'o p t e n	 'ɔ p t e n 
omplen	'o m p l e n	 'ɔ m p l e n 
obscenes	o p s 'e n e s	 o p s k 'e n e s 
obligant-la	o β l i ɣ 'a n l a	 o β l i ɣ 'a n d l a 
numero	n u m 'e ɾ o	 n u m 'ɛ ɾ o 
neixi	n 'e j ʃ i	 n 'ɛ j ʃ i 
n'estan	n a s t 'a n	 n e s t 'a n 
n'anessin	n a n 'e s i n	 n a n 'ɛ s i n 
mòdems	m 'ɔ ð e m s	 m o ð 'e m s 
motos	m 'o t o s	 m 'ɔ t o s 
milloren	m i ʎ 'o ɾ e n	 m i ʎ 'ɔ ɾ e n 
mescla	m 'e s k l a	 m 'ɛ s k l a 
mantega	m a n t 'e ɣ a	 m a n t 'ɛ ɣ a 
maleint-me	m a l e 'i m m e	 m a l 'ɛ i n d m e 
maharajàs	m a a ɾ a ʒ 'a s	 m a e ɾ a ʒ 'a s 
mad	m 'a t	 m 'a 
lluitaven	ʎ u j t 'a β e n	 ʎ u i t 'a β e n 
lletja	ʎ 'e dʒ a	 ʎ 'ɛ dʒ a 
llestos	ʎ 'e s t o s	 ʎ 'ɛ s t o s 
llesques	ʎ 'e s k e s	 ʎ 'ɛ s k e s 
llebre	ʎ 'e β ɾ e	 ʎ 'ɛ β ɾ e 
l'atlànticel	l a d l 'a n t i s e l	 l a d l a n t i s 'ɛ l 
l'anècdota	l a n 'ɛ g d o t a	 l a n e g d 'ɔ t a 
jazz	dʒ 'a s	 dʒ 'a z i 
ingressos	i ŋ g ɾ 'e s o s	 i ŋ g ɾ 'ɛ s o s 
ignoro	i g n 'o ɾ o	 i g n 'ɔ ɾ o 
hipocresia	i p o k ɾ e z 'i a	 i p o k ɾ e s 'i a 
hipnotitzant	i b n o t i d z 'a n	 i p n o t i d z 'a n 
guerres	g 'ɛ r e s	 g u 'ɛ r e s 
guerra	g 'ɛ r a	 g u 'ɛ r a 
gresca	g ɾ 'e s k a	 g ɾ 'ɛ s k a 
glops	g l 'o p s	 g l 'ɔ p s 
ginebra	dʒ i n 'e β ɾ a	 dʒ i n 'ɛ β ɾ a 
gemma	dʒ 'e m m a	 dʒ 'ɛ m m a 
fregues	f ɾ 'e ɣ e s	 f ɾ 'ɛ ɣ e s 
fondre's	f 'o n d ɾ e s	 f o n d ɾ 'ɛ s 
fixa't	f 'i k s a t	 f i k s 'a t 
fessin	f 'e s i n	 f 'ɛ s i n 
fent-los	f 'e n l o s	 f 'ɛ n d l o s 
fent-la	f 'e n l a	 f 'ɛ n d l a 
febre	f 'e β ɾ e	 f 'ɛ β ɾ e 
febles	f 'e β l e s	 f 'ɛ β l e s 
extremes	e k s t ɾ 'e m e s	 e k s t ɾ 'ɛ m e s 
existeixin	e g z i s t 'e j ʃ i n	 e g z i s t 'ɛ j ʃ i n 
exemple	e g z 'e m p l e	 e g z 'ɛ m p l e 
excés	e k s 'e s	 e k s k s 
excessos	e k s 'e s o s	 e k s k s o s 
etc	'e t k	 'ɛ t k 
estrateg	a s t ɾ a t 'e k	 a s t ɾ a t 'ɛ g 
estrangers	a s t ɾ a n dʒ 'e s	 a s t ɾ a ŋ 'e s 
estableixi	a s t a β l 'e j ʃ i	 a s t a β l 'ɛ j ʃ i 
eso	'e s o	 'ɛ z o 
escolten	a s k 'o l t e n	 a s k 'ɔ l t e n 
entendre'l	a n t 'e n d ɾ e l	 a n t e n d ɾ 'ɛ l 
ene	'e n e	 g n e 
endarrereixi	a n d a r e ɾ 'e j ʃ i	 a n d a r e ɾ 'ɛ j ʃ i 
endarrere	a n d a r 'e ɾ e	 a n d a r 'ɛ ɾ e 
encesos	a n s 'e z o s	 a ŋ 'e z o s 
empeny	a m p 'e ɲ	 a m p 'ɛ ɲ 
ego	'e ɣ o	 'ɛ ɣ o 
dutxant-me	d u tʃ 'a m m e	 d u tʃ 'a n d m e 
dolços	d 'o l s o s	 d 'ɔ l s o s 
distingeixo	d i s t i n dʒ 'e j ʃ o	 d i s t i ŋ g 'e j ʃ o 
dissuasiva	d i s u a z 'i β a	 d i s u a s 'i β a 
discorre	d i s k 'o r e	 d i s k 'ɔ r e 
devoro	d e β 'o ɾ o	 d e β 'ɔ ɾ o 
deshonest	d e s o n 'e s t	 d e s o n 'ɛ s t 
desdobla	d e z ð 'o β l a	 d e z ð 'ɔ β l a 
desapareguessin	d e z a p a ɾ e ɣ 'e s i n	 d e z a p a ɾ e ɣ u 'ɛ s i n 
deixant-lo	d e j ʃ 'a n l o	 d e j ʃ 'a n d l o 
dec	d 'e k	 d 'ɛ k 
daina	d 'a j n a	 d 'a i n a 
d'oasi	d o 'a z i	 d o 'a s i 
d'aleshores	d a l e s 'ɔ ɾ e s	 d a l e s 'o ɾ e s 
d'Or	d 'ɔ r	 d 'o 
cuinats	k u j n 'a t s	 k u i n 'a t s 
creï	k ɾ 'e i	 k ɾ 'ɛ i 
coses	k 'ɔ z e s	 k 'o z e s 
convenç	k o m b 'e n s	 k o m b 'ɛ n s 
contempla	k o n t 'e m p l a	 k o n t 'ɛ m p l a 
connecto	k o n n 'e k t o	 k o n n 'ɛ k t o 
comptant	k o m t 'a n	 k o m p t 'a n 
comprovi'l	k o m p ɾ 'ɔ β i l	 k o m p ɾ o β 'i l 
comprenc	k o m p ɾ 'e ŋ	 k o m p ɾ 'e n s 
compost	k o m p 'ɔ s t	 k o m p 'o s t 
compleixin	k o m p l 'e j ʃ i n	 k o m p l 'ɛ j ʃ i n 
clixés	k l i ʃ 'e s	 k l j ʃ 'e s 
cega	s 'e ɣ a	 s 'ɛ ɣ a 
calb	k 'a l p	 k 'a l i 
caiguts	k a j ɣ 'u t s	 k a i ɣ 'u t s 
caiguin	k 'a j ɣ i n	 k 'a i ɣ i n 
cabirol	k a β i ɾ 'o l	 k a β i ɾ 'ɔ l 
buidant	b u j ð 'a n	 b u i ð 'a n 
bomba	b 'o m b a	 b 'ɔ m b a 
bistecs	b i s t 'e k s	 b i s t 'ɛ k s 
be	b 'e	 b 'ɛ 
atendre'l	a t 'e n d ɾ e l	 a t e n d ɾ 'ɛ l 
ascens	a s 'e n s	 a s k 'ɛ n s 
arruinada	a r u j n 'a ð a	 a r u i n 'a ð a 
arenga	a ɾ 'e ŋ g a	 a ɾ 'ɛ ŋ g a 
aplec	a p l 'e k	 a p l 'ɛ k 
afronten	a f ɾ 'o n t e n	 a f ɾ 'ɔ n t e n 
advoquen	a d b 'o k e n	 a d b 'ɔ k e n 
adherits	a ð e ɾ 'i t s	 a ð e e ɾ 'i t s 
actuïn	a k t 'u i n	 a k t u 'i n 
Virrei	b i r 'e j	 b i r 'ɛ i 
Venc	b 'e ŋ	 b 'e n s 
Telefónica	t e l e f 'o n i k a	 t e l e f o n 'i k a 
Sens	s 'e n s	 s 'ɛ n s 
Se'n	s 'e n	 s 'ɛ n 
S'endinsen	s a n d 'i n s e n	 s e n d 'i n s e n 
S'aixeca	s a j ʃ 'e k a	 s a j ʃ 'ɛ k a 
Ruth	r 'u t	 r 'u t i 
Remeno	r e m 'e n o	 r e m 'ɛ n o 
Prenc	p ɾ 'e ŋ	 p ɾ 'e n s 
Parisien	p a ɾ i z 'i e n	 p a ɾ i s 'i e n 
N'Édgar	n 'e d g a	 n e d ɣ 'a 
N'està	n a s t 'a	 n e s t 'a 
Montmell	m o m m 'e ʎ	 m o n d m 'e ʎ 
Montevideo	m o n t e β i ð 'e o	 m o n t e β i ð 'ɛ o 
Mestre	m 'e s t ɾ e	 m 'ɛ s t ɾ e 
Mes	m 'e s	 m 'ɛ s 
Líban	l 'i β a n	 l i β 'a n 
Lègolas	l 'ɛ ɣ o l a s	 l e ɣ o l 'a s 
Le	l 'e	 l 'ɛ 
L'hora	l 'ɔ ɾ a	 l e ɾ a 
Janeiro	dʒ a n 'e j ɾ o	 dʒ a n e 'i ɾ o 
Hèlsinki	'ɛ l s i ŋ k i	 'ɛ l s i n s i 
Huc	'u k	 'a k 
Hisenda	i z 'e n d a	 i s 'ɛ n d a 
Grenoble	g ɾ e n 'o β l e	 g ɾ e n 'ɔ β l e 
Grand	g ɾ 'a n	 g ɾ 'a n i 
Endreço	a n d ɾ 'e s o	 a n d ɾ 'ɛ s o 
EUA	'ɛ w a	 'ɛ u a 
Dona'm	d 'ɔ n a m	 d o n 'a m 
Contra	k 'o n t ɾ a	 k 'ɔ n t ɾ a 
Contesta	k o n t 'e s t a	 k o n t 'ɛ s t a 
Condueixi	k o n d u 'e j ʃ i	 k o n d u 'ɛ j ʃ i 
Compto	k 'o m t o	 k 'ɔ m p t o 
Carrega	k a r 'e ɣ a	 k a r 'ɛ ɣ a 
Camp	k 'a m	 k 'a m p 
COCO	k 'o k o	 k 'ɔ k o 
Acosta-t'hi	a k 'ɔ s t a t i	 a k o s t 'a t i 
