A	'ə	ə
abaixarem	ə β ə ʃ ə ɾ 'ə m	ə β ə ʃ ə ɾ 'ɛ m
abaixem	ə β ə ʃ 'ə m	ə β ə ʃ 'ɛ m
abandonarem	ə β ə n d o n ə ɾ 'ə m	ə β ə n d o n ə ɾ 'ɛ m
abandonem	ə β ə n d o n 'ə m	ə β ə n d o n 'ɛ m
abandonis	ə β ə n d 'ɔ n i s	ə β ə n d 'o n i s
abatem	ə β ə t 'ə m	ə β ə t 'ɛ m
abordatge	ə β o ɾ ð 'a d ʒ ə	ə β o ɾ ð 'a dʒ ə
abordatges	ə β o ɾ ð 'a d ʒ ə s	ə β o ɾ ð 'a dʒ ə s
abraçarem	ə β ɾ ə s ə ɾ 'ə m	ə β ɾ ə s ə ɾ 'ɛ m
abracem	ə β ɾ ə s 'ə m	ə β ɾ ə s 'ɛ m
abreviarem	ə β ɾ ə v i ə ɾ 'ə m	ə β ɾ ə v i ə ɾ 'ɛ m
abreviem	ə β ɾ ə v i 'ə m	ə β ɾ ə v i 'ɛ m
absència	ə t s 'ɛ n s i ə	ə t s 'ə n s i ə
acabarem	ə k ə β ə ɾ 'ə m	ə k ə β ə ɾ 'ɛ m
acabem	ə k ə β 'ə m	ə k ə β 'ɛ m
acadèmic	ə k ə ð 'ɛ m i k	ə k ə ð 'ə m i k
acadèmica	ə k ə ð 'ɛ m i k ə	ə k ə ð 'ə m i k ə
acadèmics	ə k ə ð 'ɛ m i t s	ə k ə ð 'ə m i t s
acadèmiques	ə k ə ð 'ɛ m i k ə s	ə k ə ð 'ə m i k ə s
acariciarem	ə k ə ɾ i s i ə ɾ 'ə m	ə k ə ɾ i s i ə ɾ 'ɛ m
acariciem	ə k ə ɾ i s i 'ə m	ə k ə ɾ i s i 'ɛ m
acètic	ə s 'ɛ t i k	ə s 'ə t i k
acètica	ə s 'ɛ t i k ə	ə s 'ə t i k ə
acètics	ə s 'ɛ t i t s	ə s 'ə t i t s
acètiques	ə s 'ɛ t i k ə s	ə s 'ə t i k ə s
acostarem	ə k o s t ə ɾ 'ə m	ə k o s t ə ɾ 'ɛ m
acostem	ə k o s t 'ə m	ə k o s t 'ɛ m
acostumarem	ə k o s t u m ə ɾ 'ə m	ə k o s t u m ə ɾ 'ɛ m
acostumem	ə k o s t u m 'ə m	ə k o s t u m 'ɛ m
acotxador	ə k o t ʃ ə ð 'o	ə k o tʃ ə ð 'o
acotxaneta	ə k o t ʃ ə n 'ə t ə	ə k o tʃ ə n 'ə t ə
acotxar	ə k o t ʃ 'a	ə k o tʃ 'a
acreditarem	ə k ɾ ə ð i t ə ɾ 'ə m	ə k ɾ ə ð i t ə ɾ 'ɛ m
acreditem	ə k ɾ ə ð i t 'ə m	ə k ɾ ə ð i t 'ɛ m
actuarem	ə t t u ə ɾ 'ə m	ə t t u ə ɾ 'ɛ m
actuem	ə t t u 'ə m	ə t t u 'ɛ m
acudirem	ə k u ð i ɾ 'ə m	ə k u ð i ɾ 'ɛ m
acusarem	ə k u z ə ɾ 'ə m	ə k u z ə ɾ 'ɛ m
acusem	ə k u z 'ə m	ə k u z 'ɛ m
adherència	ə ð ə ɾ 'ɛ n s i ə	ə ð ə ɾ 'ə n s i ə
adherències	ə ð ə ɾ 'ɛ n s i ə s	ə ð ə ɾ 'ə n s i ə s
adjacent	ə d ʒ ə s 'e n t	ə dʒ ə s 'e n t
adjudica	ə d ʒ u ð 'i k ə	ə dʒ u ð 'i k ə
adjudicada	ə d ʒ u ð i k 'a ð ə	ə dʒ u ð i k 'a ð ə
adjudicades	ə d ʒ u ð i k 'a ð ə s	ə dʒ u ð i k 'a ð ə s
adjudicar	ə d ʒ u ð i k 'a	ə dʒ u ð i k 'a
adjudicarem	ə d ʒ u ð i k ə ɾ 'ə m	ə dʒ u ð i k ə ɾ 'ɛ m
adjudicares	ə d ʒ u ð i k 'a ɾ ə s	ə dʒ u ð i k 'a ɾ ə s
adjudicaria	ə d ʒ u ð i k ə ɾ 'i ə	ə dʒ u ð i k ə ɾ 'i ə
adjudicat	ə d ʒ u ð i k 'a t	ə dʒ u ð i k 'a t
adjudicats	ə d ʒ u ð i k 'a t s	ə dʒ u ð i k 'a t s
adjudicava	ə d ʒ u ð i k 'a v ə	ə dʒ u ð i k 'a v ə
adjudico	ə d ʒ u ð 'i k o	ə dʒ u ð 'i k o
adjudiquem	ə d ʒ u ð i k 'ə m	ə dʒ u ð i k 'ɛ m
adjudiques	ə d ʒ u ð 'i k ə s	ə dʒ u ð 'i k ə s
adjunt	ə d ʒ 'u n t	ə dʒ 'u n t
adjunta	ə d ʒ 'u n t ə	ə dʒ 'u n t ə
adjuntes	ə d ʒ 'u n t ə s	ə dʒ 'u n t ə s
adjunts	ə d ʒ 'u n s	ə dʒ 'u n t s
adjurada	ə d ʒ u ɾ 'a ð ə	ə dʒ u ɾ 'a ð ə
adjurades	ə d ʒ u ɾ 'a ð ə s	ə dʒ u ɾ 'a ð ə s
adjurar	ə d ʒ u ɾ 'a	ə dʒ u ɾ 'a
adjurat	ə d ʒ u ɾ 'a t	ə dʒ u ɾ 'a t
adjurats	ə d ʒ u ɾ 'a t s	ə dʒ u ɾ 'a t s
administrarem	ə m m i n i s t ɾ ə ɾ 'ə m	ə m m i n i s t ɾ ə ɾ 'ɛ m
administrem	ə m m i n i s t ɾ 'ə m	ə m m i n i s t ɾ 'ɛ m
adoptarem	ə ð o t t ə ɾ 'ə m	ə ð o t t ə ɾ 'ɛ m
adoptem	ə ð o t t 'ə m	ə ð o t t 'ɛ m
adorem	ə ð o ɾ 'ə m	ə ð o ɾ 'ɛ m
adscripció	ə s k ɾ i t s i 'o	ə t s k ɾ i t s i 'o
adscrit	ə s k ɾ 'i t	ə t s k ɾ 'i t
adscrita	ə s k ɾ 'i t ə	ə t s k ɾ 'i t ə
adscrites	ə s k ɾ 'i t ə s	ə t s k ɾ 'i t ə s
adscrits	ə s k ɾ 'i t s	ə t s k ɾ 'i t s
adscriure	ə s k ɾ 'i w ɾ ə	ə t s k ɾ 'i w ɾ ə
afanjs	ə f 'a j n s	ə f 'a ɲ s
afecta	ə f 'ɛ t t ə	ə f 'ə t t ə
afectarem	ə f ə t t ə ɾ 'ə m	ə f ə t t ə ɾ 'ɛ m
afecte	ə f 'ɛ t t ə	ə f 'ə t t ə
afectem	ə f ə t t 'ə m	ə f ə t t 'ɛ m
afectes	ə f 'ɛ t t ə s	ə f 'ə t t ə s
afèmic	ə f 'ɛ m i k	ə f 'ə m i k
afèmica	ə f 'ɛ m i k ə	ə f 'ə m i k ə
afèmics	ə f 'ɛ m i t s	ə f 'ə m i t s
afèmiques	ə f 'ɛ m i k ə s	ə f 'ə m i k ə s
afèresi	ə f 'ɛ ɾ ə z i	ə f 'ə ɾ ə z i
afilarem	ə f i l ə ɾ 'ə m	ə f i l ə ɾ 'ɛ m
afilem	ə f i l 'ə m	ə f i l 'ɛ m
afirmarem	ə f i ɾ m ə ɾ 'ə m	ə f i ɾ m ə ɾ 'ɛ m
afirmem	ə f i ɾ m 'ə m	ə f i ɾ m 'ɛ m
aflorarem	ə f l o ɾ ə ɾ 'ə m	ə f l o ɾ ə ɾ 'ɛ m
aflorem	ə f l o ɾ 'ə m	ə f l o ɾ 'ɛ m
aflores	ə f l 'ɔ ɾ ə s	ə f l 'o ɾ ə s
afronta	ə f ɾ 'o n t ə	ə f ɾ 'ɔ n t ə
afrontarem	ə f ɾ o n t ə ɾ 'ə m	ə f ɾ o n t ə ɾ 'ɛ m
afrontem	ə f ɾ o n t 'ə m	ə f ɾ o n t 'ɛ m
agència	ə ʒ 'ɛ n s i ə	ə ʒ 'ə n s i ə
agències	ə ʒ 'ɛ n s i ə s	ə ʒ 'ə n s i ə s
agenda	ə ʒ 'e n d ə	ə ʒ 'ə n d ə
alatxa	ə l 'a t ʃ ə	ə l 'a tʃ ə
alçament	ə l s ə m 'e n t	a l s ə m 'e n t
alçaprem	ə l s ə p ɾ 'ə m	ə l s ə p ɾ 'ɛ m
alegre	ə l 'e ɣ ɾ ə	ə l 'ə ɣ ɾ ə
alfabètic	ə l f ə β 'ɛ t i k	ə l f ə β 'ə t i k
alfabètica	ə l f ə β 'ɛ t i k ə	ə l f ə β 'ə t i k ə
alfabètics	ə l f ə β 'ɛ t i t s	ə l f ə β 'ə t i t s
alfabètiques	ə l f ə β 'ɛ t i k ə s	ə l f ə β 'ə t i k ə s
alfanumèric	ə l f ə n u m 'ɛ ɾ i k	ə l f ə n u m 'ə ɾ i k
alfanumèrica	ə l f ə n u m 'ɛ ɾ i k ə	ə l f ə n u m 'ə ɾ i k ə
alfanumèrics	ə l f ə n u m 'ɛ ɾ i t s	ə l f ə n u m 'ə ɾ i t s
alfanumèriques	ə l f ə n u m 'ɛ ɾ i k ə s	ə l f ə n u m 'ə ɾ i k ə s
algèbric	ə l ʒ 'ɛ β ɾ i k	ə l ʒ 'ə β ɾ i k
algèbrica	ə l ʒ 'ɛ β ɾ i k ə	ə l ʒ 'ə β ɾ i k ə
algèbrics	ə l ʒ 'ɛ β ɾ i t s	ə l ʒ 'ə β ɾ i t s
algèbriques	ə l ʒ 'ɛ β ɾ i k ə s	ə l ʒ 'ə β ɾ i k ə s
aliatge	ə l i 'a d ʒ ə	ə l i 'a dʒ ə
alienarem	ə l i ə n ə ɾ 'ə m	ə l i ə n ə ɾ 'ɛ m
alienem	ə l i ə n 'ə m	ə l i ə n 'ɛ m
alieni	ə l i 'ɛ n i	ə l i 'ə n i
aliment	ə l i m 'e n t	a l i m 'e n t
alimentarem	ə l i m ə n t ə ɾ 'ə m	ə l i m ə n t ə ɾ 'ɛ m
alimentem	ə l i m ə n t 'ə m	ə l i m ə n t 'ɛ m
alineament	ə l i n e ə m 'e n t	ə l i n ə ə m 'e n t
almirallessa	ə l m i ɾ ə ʎ 'ə s ə	ə l m i ɾ ə ʎ 'e s ə
altea	ə l t 'ɛ ə	ə l t 'e ə
altrament	ə l t ɾ ə m 'e n t	a l t ɾ ə m 'e n t
amaguem	ə m ə ɣ 'ə m	ə m ə ɣ 'ɛ m
amaratge	ə m ə ɾ 'a d ʒ ə	ə m ə ɾ 'a dʒ ə
amaratges	ə m ə ɾ 'a d ʒ ə s	ə m ə ɾ 'a dʒ ə s
amarratge	ə m ə r 'a d ʒ ə	ə m ə r 'a dʒ ə
ambigu	ə m b 'i ɣ u	ə m b 'i ɣ
amens	ə m 'ə n s	ə m 'e n s
Amèrica	ə m 'ɛ ɾ i k ə	ə m 'ə ɾ i k ə
ametler	ə m ə l l 'e	ə m ə t l 'e
ametller	ə m ə ʎ ʎ 'e	ə m ə l l 'e
ampolla	ə m p 'o ʎ ə	ə m p 'ɔ ʎ ə
analgèsic	ə n ə l ʒ 'ɛ z i k	ə n ə l ʒ 'ə z i k
analgèsics	ə n ə l ʒ 'ɛ z i t s	ə n ə l ʒ 'ə z i t s
ancorarem	ə ŋ k o ɾ ə ɾ 'ə m	ə ŋ k o ɾ ə ɾ 'ɛ m
Andreu	ə n d ɾ 'e w	ə n d ɾ 'ɛ w
androgènic	ə n d ɾ o ʒ 'ɛ n i k	ə n d ɾ o ʒ 'ə n i k
androgènica	ə n d ɾ o ʒ 'ɛ n i k ə	ə n d ɾ o ʒ 'ə n i k ə
androgènics	ə n d ɾ o ʒ 'ɛ n i t s	ə n d ɾ o ʒ 'ə n i t s
androgèniques	ə n d ɾ o ʒ 'ɛ n i k ə s	ə n d ɾ o ʒ 'ə n i k ə s
anèmic	ə n 'ɛ m i k	ə n 'ə m i k
anèmica	ə n 'ɛ m i k ə	ə n 'ə m i k ə
anèmics	ə n 'ɛ m i t s	ə n 'ə m i t s
anèmiques	ə n 'ɛ m i k ə s	ə n 'ə m i k ə s
anestèsia	ə n ə s t 'ɛ z i ə	ə n ə s t 'ə z i ə
anestèsic	ə n ə s t 'ɛ z i k	ə n ə s t 'ə z i k
anestèsica	ə n ə s t 'ɛ z i k ə	ə n ə s t 'ə z i k ə
anestèsics	ə n ə s t 'ɛ z i t s	ə n ə s t 'ə z i t s
anestèsies	ə n ə s t 'ɛ z i ə s	ə n ə s t 'ə z i ə s
anestèsiques	ə n ə s t 'ɛ z i k ə s	ə n ə s t 'ə z i k ə s
angèlic	ə n ʒ 'ɛ l i k	ə n ʒ 'ə l i k
angèlica	ə n ʒ 'ɛ l i k ə	ə n ʒ 'ə l i k ə
angèlics	ə n ʒ 'ɛ l i t s	ə n ʒ 'ə l i t s
angèliques	ə n ʒ 'ɛ l i k ə s	ə n ʒ 'ə l i k ə s
animarem	ə n i m ə ɾ 'ə m	ə n i m ə ɾ 'ɛ m
animem	ə n i m 'ə m	ə n i m 'ɛ m
anorèxia	ə n o ɾ 'ɛ t s i ə	ə n o ɾ 'ə t s i ə
antimoni	ə n t i m 'ɔ n i	ə n t i m 'o n i
Antoni	ə n t 'ɔ n i	ə n t 'o n i
antropocèntric	ə n t ɾ o p o s 'ɛ n t ɾ i k	ə n t ɾ o p o s 'ə n t ɾ i k
Apalatxes	ə p ə l 'a t ʃ ə s	ə p ə l 'a tʃ ə s
aparèixer	ə p ə ɾ 'ə ʃ ə	ə p ə ɾ 'ɛ ʃ ə
aparell	ə p ə ɾ 'ə ʎ	ə p ə ɾ 'e ʎ
apèndix	ə p 'ɛ n d i t s	ə p 'ə n d ʃ
apirènia	ə p i ɾ 'ɛ n i ə	ə p i ɾ 'ə n i ə
apitxar	ə p i t ʃ 'a	ə p i tʃ 'a
apitxat	ə p i t ʃ 'a t	ə p i tʃ 'a t
apòcrifs	ə p 'ɔ k ɾ i t s	ə p 'ɔ k ɾ i s
apologètic	ə p o l o ʒ 'ɛ t i k	ə p o l o ʒ 'ə t i k
aprenentatge	ə p ɾ ə n ə n t 'a d ʒ ə	ə p ɾ ə n ə n t 'a dʒ ə
aprenentatges	ə p ɾ ə n ə n t 'a d ʒ ə s	ə p ɾ ə n ə n t 'a dʒ ə s
apurarem	ə p u ɾ ə ɾ 'ə m	ə p u ɾ ə ɾ 'ɛ m
apurem	ə p u ɾ 'ə m	ə p u ɾ 'ɛ m
aquell	ə k 'ə ʎ	ə k 'e ʎ
aqüicultura	ə k w i k u l t 'u ɾ ə	ə k i k u l t 'u ɾ ə
arborètum	ə ɾ β o ɾ 'ɛ t u m	ə ɾ β o ɾ 'ə t u m
argument	ə ɾ ɣ u m 'e n t	a ɾ ɣ u m 'e n t
arítjol	ə ɾ 'i d ʒ o l	ə ɾ 'i dʒ o l
aritmètic	ə ɾ i m m 'ɛ t i k	ə ɾ i m m 'ə t i k
aritmètica	ə ɾ i m m 'ɛ t i k ə	ə ɾ i m m 'ə t i k ə
armament	ə ɾ m ə m 'e n t	a ɾ m ə m 'e n t
armarem	ə ɾ m ə ɾ 'ə m	ə ɾ m ə ɾ 'ɛ m
armem	ə ɾ m 'ə m	ə ɾ m 'ɛ m
Armènia	ə ɾ m 'ɛ n i ə	ə ɾ m 'ə n i ə
arrambatge	ə r ə m b 'a d ʒ ə	ə r ə m b 'a dʒ ə
arrambatges	ə r ə m b 'a d ʒ ə s	ə r ə m b 'a dʒ ə s
arsènic	ə ɾ s 'ɛ n i k	ə ɾ s 'ə n i k
artèries	ə ɾ t 'ɛ ɾ i ə s	ə ɾ t 'ə ɾ i ə s
arts	'a ɾ s	'a ɾ t s
arxiduquessa	ə ɾ ʃ i ð u k 'ə s ə	ə ɾ ʃ i ð u k 'e s ə
asafètida	ə z ə f 'ɛ t i ð ə	ə z ə f 'ə t i ð ə
ascendència	ə t s ə n d 'ɛ n s i ə	ə t s ə n d 'ə n s i ə
asfíxia	ə s f 'i t s i ə	ə s f 'i ʃ i ə
asimètric	ə s i m 'ɛ t ɾ i k	ə z i m 'ə t ɾ i k
assaig	ə s 'a t ʃ	ə s 'a tʃ
assassinarem	ə s ə s i n ə ɾ 'ə m	ə s ə s i n ə ɾ 'ɛ m
assassinem	ə s ə s i n 'ə m	ə s ə s i n 'ɛ m
assetjada	ə s ə d ʒ 'a ð ə	ə s ə dʒ 'a ð ə
assetjades	ə s ə d ʒ 'a ð ə s	ə s ə dʒ 'a ð ə s
assetjament	ə s ə d ʒ ə m 'e n t	ə s ə dʒ ə m 'e n t
assetjant	ə s ə d ʒ 'a n t	ə s ə dʒ 'a n t
assetjar	ə s ə d ʒ 'a	ə s ə dʒ 'a
assetjat	ə s ə d ʒ 'a t	ə s ə dʒ 'a t
assetjats	ə s ə d ʒ 'a t s	ə s ə dʒ 'a t s
assistència	ə s i s t 'ɛ n s i ə	ə s i s t 'ə n s i ə
assistències	ə s i s t 'ɛ n s i ə s	ə s i s t 'ə n s i ə s
astènia	ə s t 'è n i ə	ə s t 'ə n i ə
astènic	ə s t 'è n i k	ə s t 'ə n i k
atendre	ə t 'e n d ɾ ə	ə t 'ə n d ɾ ə
aterratge	ə t ə r 'a d ʒ ə	ə t ə r 'a dʒ ə
atlàntic	ə l l 'a n t i k	ə t l 'a n t i k
atles	'a l l ə s	'a b b l ə s
Atles	'a l l ə s	'a b b l ə s
atmosfèric	ə m m o s f 'ɛ ɾ i k	ə m m o s f 'ə ɾ i k
atmosfèrica	ə m m o s f 'ɛ ɾ i k ə	ə m m o s f 'ə ɾ i k ə
atmosfèrics	ə m m o s f 'ɛ ɾ i t s	ə m m o s f 'ə ɾ i t s
atmosfèriques	ə m m o s f 'ɛ ɾ i k ə s	ə m m o s f 'ə ɾ i k ə s
atrèsia	ə t ɾ 'ɛ z i ə	ə t ɾ 'ə z i ə
atrèsies	ə t ɾ 'ɛ z i ə s	ə t ɾ 'ə z i ə s
atrofiarem	ə t ɾ o f i ə ɾ 'ə m	ə t ɾ o f i ə ɾ 'ɛ m
atrofiem	ə t ɾ o f i 'ə m	ə t ɾ o f i 'ɛ m
atxes	'a t ʃ ə s	'a tʃ ə s
audiència	ə w ð i 'ɛ n s i ə	ə w ð i 'ə n s i ə
audiències	ə w ð i 'ɛ n s i ə s	ə w ð i 'ə n s i ə s
aurèola	ə w ɾ 'ɛ o l ə	ə w ɾ 'ə o l ə
austronèsic	ə w s t ɾ o n 'ɛ z i k	ə w s t ɾ o n 'ə z i k
autèntic	ə w t 'è n t i k	ə w t 'ə n t i k
autoretrat	ə w t o r ə t ɾ 'a t	ə w t o ɾ ə t ɾ 'a t
autoretrats	ə w t o r ə t ɾ 'a t s	ə w t o ɾ ə t ɾ 'a t s
autosuficiència	ə w t o s u f i s i 'ɛ n s i ə	ə w t o z u f i s i 'ə n s i ə
autosuficient	ə w t o s u f i s i 'e n t	ə w t o z u f i s i 'e n t
avançarem	ə v ə n s ə ɾ 'ə m	ə v ə n s ə ɾ 'ɛ m
avancem	ə v ə n s 'ə m	ə v ə n s 'ɛ m
avantatge	ə v ə n t 'a d ʒ ə	ə v ə n t 'a dʒ ə
avantatja	ə v ə n t 'a d ʒ ə	ə v ə n t 'a dʒ ə
avantatjada	ə v ə n t ə d ʒ 'a ð ə	ə v ə n t ə dʒ 'a ð ə
avantatjades	ə v ə n t ə d ʒ 'a ð ə s	ə v ə n t ə dʒ 'a ð ə s
avantatjant	ə v ə n t ə d ʒ 'a n t	ə v ə n t ə dʒ 'a n t
avantatjat	ə v ə n t ə d ʒ 'a t	ə v ə n t ə dʒ 'a t
avantatjats	ə v ə n t ə d ʒ 'a t s	ə v ə n t ə dʒ 'a t s
avantatjós	ə v ə n t ə d ʒ 'o s	ə v ə n t ə dʒ 'o s
avantbraç	ə v ə m b ɾ 'a s	ə v ə n b ɾ 'a s
avantpassat	ə v ə m p ə s 'a t	ə v ə n p ə s 'a t
avantpassats	ə v ə m p ə s 'a t s	ə v ə n p ə s 'a t s
avèstic	ə v 'ɛ s t i k	ə v 'ə s t i k
aviarem	ə v i ə ɾ 'ə m	ə v i ə ɾ 'ɛ m
aviem	ə v i 'ə m	ə v i 'ɛ m
avisarem	ə v i z ə ɾ 'ə m	ə v i z ə ɾ 'ɛ m
avisem	ə v i z 'ə m	ə v i z 'ɛ m
baromètric	b ə ɾ o m 'ɛ t ɾ i k	b ə ɾ o m 'ə t ɾ i k
baromètrica	b ə ɾ o m 'ɛ t ɾ i k ə	b ə ɾ o m 'ə t ɾ i k ə
baromètrics	b ə ɾ o m 'ɛ t ɾ i t s	b ə ɾ o m 'ə t ɾ i t s
baromètriques	b ə ɾ o m 'ɛ t ɾ i k ə s	b ə ɾ o m 'ə t ɾ i k ə s
bastarem	b ə s t ə ɾ 'ə m	b ə s t ə ɾ 'ɛ m
bastem	b ə s t 'ə m	b ə s t 'ɛ m
batimètric	b ə t i m 'ɛ t ɾ i k	b ə t i m 'ə t ɾ i k
batlle	b 'a ʎ ʎ ə	b 'a l l ə
batlles	b 'a ʎ ʎ ə s	b 'a l l ə s
batlles	b 'a ʎ ʎ ə s	b 'a l l ə s
Batlló	b ə ʎ ʎ 'o	b ə l l 'o
beix	b 'e ʃ	b 'ɛ ʃ
benèfic	b ə n 'ɛ f i k	b ə n 'ə f i k
benèfica	b ə n 'ɛ f i k ə	b ə n 'ə f i k ə
beneficència	b ə n ə f i s 'ɛ n s i ə	b ə n ə f i s 'ə n s i ə
beneficiarem	b ə n ə f i s i ə ɾ 'ə m	b ə n ə f i s i ə ɾ 'ɛ m
beneficiem	b ə n ə f i s i 'ə m	b ə n ə f i s i 'ɛ m
beneficiosa	b ə n ə f i s i 	b ə n ə f i s i 'o z ə
benèfics	b ə n 'ɛ f i t s	b ə n 'ə f i t s
benèfiques	b ə n 'ɛ f i k ə s	b ə n 'ə f i k ə s
benèvol	b ə n 'ɛ v o l	b ə n 'ə v o l
benèvola	b ə n 'ɛ v o l ə	b ə n 'ə v o l ə
benevolència	b ə n ə v o l 'ɛ n s i ə	b ə n ə v o l 'ə n s i ə
benèvoles	b ə n 'ɛ v o l ə s	b ə n 'ə v o l ə s
benèvols	b ə n 'ɛ v o l s	b ə n 'ə v o l s
berberetxo	b ə ɾ β ə ɾ 'ɛ t ʃ o	b ə ɾ β ə ɾ 'ɛ tʃ o
besnebot	b ə z n ə β 'o t	b ə z n ə β 'ɔ t
bèstia	b 'ɛ s t i ə	b 'ə s t i ə
bèsties	b 'ɛ s t i ə s	b 'ə s t i ə s
Bigorra	b i ɣ 'ɔ r ə	b i ɣ 'o r ə
bioètica	b i o 'ɛ t i k ə	b i o 'ə t i k ə
biogènesi	b i o ʒ 'ɛ n ə z i	b i o ʒ 'ə n ə z i
bioluminescència	b i o l u m i n ə t s 'ɛ n s i ə	b i o l u m i n ə t s 'ə n s i ə
bioma	b i 'ɔ m ə	b i 'o m ə
bisexual	b i s ə t s u 'a l	b i z ə t s u 'a l
bisexualitat	b i s ə t s u ə l i t 'a t	b i z ə t s u ə l i t 'a t
bisexuals	b i s ə t s u 'a l s	b i z ə t s u 'a l s
bitlles	b 'i ʎ ʎ ə s	b 'i tʃ ʎ l ə s
bitlet	b i l l 'ə t	b i l 'ə t
bitlles	b 'i l l ə s	b 'i tʃ ʎ l ə s
bitlet	b i l l 'ə t	b i l 'ə t
bitxo	b 'i t ʃ o	b 'i tʃ o
bitxos	b 'i t ʃ o s	b 'i tʃ o s
blasfem	b l ə s f 'ə m	b l ə s f 'ɛ m
blens	b l 'ə n s	b l 'e n s
blindatge	b l i n d 'a d ʒ ə	b l i n d 'a dʒ ə
blindatges	b l i n d 'a d ʒ ə s	b l i n d 'a dʒ ə s
boa	b 'ɔ ə	b 'o ə
boc	b 'o k	b 'ɔ k
boca	b 'o k ə	b 'ɔ k ə
bocs	b 'o t s	b 'ɔ t s
boda	b 'o ð ə	b 'ɔ ð ə
bodes	b 'o ð ə s	b 'ɔ ð ə s
boes	b 'ɔ ə s	b 'o ə s
boirina	b o j ɾ 'i n ə	b o i ɾ 'i n ə
bolca	b 'o l k ə	b 'ɔ l k ə
bolquen	b 'o l k ə n	b 'ɔ l k ə n
bomba	b 'o m b ə	b 'ɔ m b ə
bombes	b 'o m b ə s	b 'ɔ m b ə s
bombo	b 'o m b o	b 'ɔ m b o
bombolla	b o m b 'o ʎ ə	b o m b 'ɔ ʎ ə
bonze	b 'ɔ n z ə	b 'o n z ə
bonzessa	b o n z 'ə s ə	b o n z 'e s ə
boques	b 'o k ə s	b 'ɔ k ə s
borda	b 'o ɾ ð ə	b 'ɔ ɾ ð ə
bordo	b 'o ɾ ð o	b 'ɔ ɾ ð o
borratja	b o r 'a d ʒ ə	b o r 'a dʒ ə
borratxera	b o r ə t ʃ 'e ɾ ə	b o r ə tʃ 'e ɾ ə
borratxo	b o r 'a t ʃ o	b o r 'a tʃ o
borsa	b 'o ɾ s ə	b 'ɔ ɾ s ə
borses	b 'o ɾ s ə s	b 'ɔ ɾ s ə s
boscatge	b o s k 'a d ʒ ə	b o s k 'a dʒ ə
bossa	b 'o s ə	b 'ɔ s ə
bosses	b 'o s ə s	b 'ɔ s ə s
botem	b o t 'ə m	b o t 'ɛ m
botxí	b o t ʃ 'i	b o tʃ 'i
boxa	b 'o t s ə	b 'ɔ t s ə
boxes	b 'o t s ə s	b 'ɔ t s ə s
brètol	b ɾ 'ɛ t o l	b ɾ 'ə t o l
brètola	b ɾ 'ɛ t o l ə	b ɾ 'ə t o l ə
brètoles	b ɾ 'ɛ t o l ə s	b ɾ 'ə t o l ə s
brètols	b ɾ 'ɛ t o ls	b ɾ 'ə t o l s
bretxa	b ɾ 'e t ʃ ə	b ɾ 'ɛ tʃ ə
bricolatge	b ɾ i k o l 'a d ʒ ə	b ɾ i k o l 'a dʒ ə
brindarem	b ɾ i n d ə ɾ 'ə m	b ɾ i n d ə ɾ 'ɛ m
broda	b ɾ 'o ð ə	b ɾ 'ɔ ð ə
brolla	b ɾ 'o ʎ ə	b ɾ 'ɔ ʎ ə
brollen	b ɾ 'o ʎ ə n	b ɾ 'ɔ ʎ ə n
brotxa	b ɾ 'ɔ t ʃ ə	b ɾ 'ɔ tʃ ə
brotxes	b ɾ 'ɔ t ʃ ə s	b ɾ 'ɔ tʃ ə s
buidatge	b u j ð 'a d ʒ ə	b u j ð 'a dʒ ə
butlla	b 'u ʎ ʎ ə	b 'u l l ə
butla	b 'u l l ə	b 'u l ə
butlles	b 'u ʎ ʎ ə s	b 'u l l ə s
butles	b 'u l l ə s	b 'u dʒ ə s
butlletins	b u ʎ ʎ ə t 'i n s	b u l l ə t 'i n s
butllofa	b u ʎ ʎ 'ɔ f ə	b u l l 'ɔ f ə
butxaca	b u t ʃ 'a k ə	b u tʃ 'a k ə
butxacada	b u t ʃ ə k 'a ð ə	b u tʃ ə k 'a ð ə
butxacades	b u t ʃ ə k 'a ð ə s	b u tʃ ə k 'a ð ə s
butxaques	b u t ʃ 'a k ə s	b u tʃ 'a k ə s
caçarem	k ə s ə ɾ 'ə m	k ə s ə ɾ 'ɛ m
cacem	k ə s 'ə m	k ə s 'ɛ m
cadavèric	k ə ð ə v 'ɛ ɾ i k	k ə ð ə v 'ə ɾ i k
cadavèrica	k ə ð ə v 'ɛ ɾ i k ə	k ə ð ə v 'ə ɾ i k ə
cadavèrics	k ə ð ə v 'ɛ ɾ i t s	k ə ð ə v 'ə ɾ i t s
cadavèriques	k ə ð ə v 'ɛ ɾ i k ə s	k ə ð ə v 'ə ɾ i k ə s
cadència	k ə ð 'ɛ n s i ə	k ə ð 'ə n s i ə
cadències	k ə ð 'ɛ n s i ə s	k ə ð 'ə n s i ə s
Calabuig	k ə l ə β 'u t ʃ	k ə l ə β 'u tʃ
calarem	k ə l ə ɾ 'ə m	k ə l ə ɾ 'ɛ m
calatge	k ə l 'a d ʒ ə	k ə l 'a dʒ ə
calcularem	k ə l k u l ə ɾ 'ə m	k ə l k u l ə ɾ 'ɛ m
calculem	k ə l k u l 'ə m	k ə l k u l 'ɛ m
calem	k ə l 'ə m	k ə l 'ɛ m
caler	k ə l 'ə	k ə l 'e
calitja	k ə l 'i d ʒ ə	k ə l 'i dʒ ə
calorimètric	k ə l o ɾ i m 'ɛ t ɾ i k	k ə l o ɾ i m 'ə t ɾ i k
calorimètrica	k ə l o ɾ i m 'ɛ t ɾ i k ə	k ə l o ɾ i m 'ə t ɾ i k ə
calorimètrics	k ə l o ɾ i m 'ɛ t ɾ i t s	k ə l o ɾ i m 'ə t ɾ i t s
calorimètriques	k ə l o ɾ i m 'ɛ t ɾ i k ə s	k ə l o ɾ i m 'ə t ɾ i k ə s
camuflatge	k ə m u f l 'a d ʒ ə	k ə m u f l 'a dʒ ə
camuflatges	k ə m u f l 'a d ʒ ə s	k ə m u f l 'a dʒ ə s
capritx	k ə p ɾ 'i t ʃ	k ə p ɾ 'i tʃ
capritxos	k ə p ɾ 'i t ʃ o s	k ə p ɾ 'i tʃ o s
capsa	k 'a t s ə	k 'a s ə
capseta	k ə t s 'ə t ə	k ə p s 'ə t ə
captarem	k ə t t ə ɾ 'ə m	k ə t t ə ɾ 'ɛ m
captem	k ə t t 'ə m	k ə t t 'ɛ m
caputxa	k ə p 'u t ʃ ə	k ə p 'u tʃ ə
caputxeta	k ə p u t ʃ 'ə t ə	k ə p u tʃ 'ə t ə
caputxí	k ə p u t ʃ 'i	k ə p u tʃ 'i
caputxina	k ə p u t ʃ 'i n ə	k ə p u tʃ 'i n ə
caputxino	k ə p u t ʃ 'i n o	k ə p u tʃ 'i n o
caputxins	k ə p u t ʃ 'i n s	k ə p u tʃ 'i n s
caputxó	k ə p u t ʃ 'o	k ə p u tʃ 'o
carboni	k ə ɾ β 'ɔ n i	k ə ɾ β 'o n i
carbonis	k ə ɾ β 'ɔ n i s	k ə ɾ β 'o n i s
carència	k ə ɾ 'ɛ n s i ə	k ə ɾ 'ə n s i ə
carruatge	k ə r u 'a d ʒ ə	k ə r u 'a dʒ ə
carruatges	k ə r u 'a d ʒ ə s	k ə r u 'a dʒ ə s
carrutxa	k ə r 'u t ʃ ə	k ə r 'u tʃ ə
carrutxes	k ə r 'u t ʃ ə s	k ə r 'u tʃ ə s
cars	k 'a s	k 'a ɾ s
cartutx	k ə ɾ t 'u t ʃ	k ə ɾ t 'u tʃ
cartutxos	k ə ɾ t 'u t ʃ o s	k ə ɾ t 'u tʃ o s
casarem	k ə z ə ɾ 'ə m	k ə z ə ɾ 'ɛ m
casem	k ə z 'ə m	k ə z 'ɛ m
catorze	k ə t 'o ɾ z ə	k ə t 'ɔ ɾ z ə
catxap	k ə t ʃ 'a p	k ə tʃ 'a p
catxel	k ə t ʃ 'ɛ l	k ə tʃ 'ɛ l
causarem	k ə w z ə ɾ 'ə m	k ə w z ə ɾ 'ɛ m
causem	k ə w z 'ə m	k ə w z 'ɛ m
cautxú	k ə w t ʃ 'u	k ə w tʃ 'u
cèdula	s 'ɛ ð u l ə	s 'ə ð u l ə
cèdules	s 'ɛ ð u l ə s	s 'ə ð u l ə s
cèlebre	s 'ɛ l ə β ɾ ə	s 'ə l ə β ɾ ə
cella	s 'ə ʎ ə	s 'e ʎ ə
celles	s 'ə ʎ ə s	s 'e ʎ ə s
celtibèric	s ə l t i β 'ɛ ɾ i k	s ə l t i β 'ə ɾ i k
cens	s 'ə n s	s 'e n s
censurarem	s ə n s u ɾ ə ɾ 'ə m	s ə n s u ɾ ə ɾ 'ɛ m
censurem	s ə n s u ɾ 'ə m	s ə n s u ɾ 'ɛ m
centèsim	s ə n t 'ɛ z i m	s ə n t 'ə z i m
centre	s 'e n t ɾ ə	s 'ə n t ɾ ə
centren	s 'e n t ɾ ə n	s 'ə n t ɾ ə n
centres	s 'e n t ɾ ə s	s 'ə n t ɾ ə s
cèntrica	s 'è n t ɾ i k ə	s 'ə n t ɾ i k ə
cèntriques	s 'è n t ɾ i k ə s	s 'ə n t ɾ i k ə s
centro	s 'e n t ɾ o	s 'ə n t ɾ o
ceptre	s 'e t t ɾ ə	s 'ə t t ɾ ə
cerca	s 'ɛ ɾ k ə	s 'ə ɾ k ə
cercarem	s ə ɾ k ə ɾ 'ə m	s ə ɾ k ə ɾ 'ɛ m
cerco	s 'ɛ ɾ k o	s 'ə ɾ k o
cèrcol	s 'ɛ ɾ k o l	s 'ə ɾ k o l
cèrcols	s 'ɛ ɾ k o l s	s 'ə ɾ k o l s
cerquem	s ə ɾ k 'ə m	s ə ɾ k 'ɛ m
cessen	s 'e s ə n	s 'ə s ə n
ciència	s i 'ɛ n s i ə	s i 'ə n s i ə
ciències	s i 'ɛ n s i ə s	s i 'ə n s i ə s
cinegètic	s i n ə ʒ 'ɛ t i k	s i n ə ʒ 'ə t i k
cinegètica	s i n ə ʒ 'ɛ t i k ə	s i n ə ʒ 'ə t i k ə
circularem	s i ɾ k u l ə ɾ 'ə m	s i ɾ k u l ə ɾ 'ɛ m
circumcisió	s i ɾ k u n s i z i 'o	s i ɾ k u t s i z i 'o
citarem	s i t ə ɾ 'ə m	s i t ə ɾ 'ɛ m
citem	s i t 'ə m	s i t 'ɛ m
classificarem	k l ə s i f i k ə ɾ 'ə m	k l ə s i f i k ə ɾ 'ɛ m
classifiquem	k l ə s i f i k 'ə m	k l ə s i f i k 'ɛ m
clona	k l 'ɔ n ə	k l 'o n ə
clones	k l 'ɔ n ə s	k l 'o n ə s
cloni	k l 'ɔ n i	k l 'o n i
clonin	k l 'ɔ n i n	k l 'o n i n
clonis	k l 'ɔ n i s	k l 'o n i s
clono	k l 'ɔ n o	k l 'o n o
clora	k l 'ɔ ɾ ə	k l 'o ɾ ə
clores	k l 'ɔ ɾ ə s	k l 'o ɾ ə s
closes	k l 'ɔ z ə s	k l 'o z ə s
clotxa	k l 'ɔ t ʃ ə	k l 'ɔ tʃ ə
coa	k 'ɔ ə	k 'o ə
cobles	k 'o b b l ə s	k 'ɔ b b l ə s
cobrarem	k o β ɾ ə ɾ 'ə m	k o β ɾ ə ɾ 'ɛ m
coco	k 'o k o	k 'ɔ k o
codificarem	k o ð i f i k ə ɾ 'ə m	k o ð i f i k ə ɾ 'ɛ m
codifiquem	k o ð i f i k 'ə m	k o ð i f i k 'ɛ m
coem	k o 'ə m	k o 'ɛ m
cofoi	k o f 'ɔ j	k o f 'o i
cogoma	k o ɣ 'ɔ m ə	k o ɣ 'o m ə
cogombre	k o ɣ 'o m b ɾ ə	k o ɣ 'ɔ m b ɾ ə
coherències	k o ə ɾ 'ɛ n s i ə s	k o ə ɾ 'ə n s i ə s
coincidència	k o i n s i ð 'ɛ n s i ə	k o i n s i ð 'ə n s i ə
coincidirem	k o i n s i ð i ɾ 'ə m	k o i n s i ð i ɾ 'ɛ m
colèric	k o l 'ɛ ɾ i k	k o l 'ə ɾ i k
colèrica	k o l 'ɛ ɾ i k ə	k o l 'ə ɾ i k ə
colèrics	k o l 'ɛ ɾ i t s	k o l 'ə ɾ i t s
colèriques	k o l 'ɛ ɾ i k ə s	k o l 'ə ɾ i k ə s
colesteatoma	k o l ə s t e ə t 'ɔ m ə	k o l ə s t e ə t 'o m ə
colesteatomes	k o l ə s t e ə t 'ɔ m ə s	k o l ə s t e ə t 'o m ə s
colitx	k o l 'i t ʃ	k o l 'i tʃ
colossos	k o l 'o s o s	k o l 'ɔ s o s
colze	k 'o l z ə	k 'ɔ l z ə
com	k 'ɔ m	k 'o m
comandarem	k o m ə n d ə ɾ 'ə m	k o m ə n d ə ɾ 'ɛ m
comandem	k o m ə n d 'ə m	k o m ə n d 'ɛ m
combinarem	k o m b i n ə ɾ 'ə m	k o m b i n ə ɾ 'ɛ m
combinem	k o m b i n 'ə m	k o m b i n 'ɛ m
comboi	k o m b 'ɔ j	k o m b 'o i
comèdies	k o m 'ɛ ð i ə s	k o m 'ə ð i ə s
cometi	k o m 'ɛ t i	k o m 'ə t i
comparèixer	k o m p ə ɾ 'ə ʃ ə	k o m p ə ɾ 'ɛ ʃ ə
compensem	k o m p ə n s 'ə m	k o m p ə n s 'ɛ m
competència	k o m p ə t 'ɛ n s i ə	k o m p ə t 'ə n s i ə
competències	k o m p ə t 'ɛ n s i ə s	k o m p ə t 'ə n s i ə s
complerts	k o m p l 'ɛ ɾ s	k o m p l 'ɛ ɾ t s
complicarem	k o m p l i k ə ɾ 'ə m	k o m p l i k ə ɾ 'ɛ m
compliquem	k o m p l i k 'ə m	k o m p l i k 'ɛ m
compra	k 'o m p ɾ ə	k 'ɔ m p ɾ ə
comprarem	k o m p ɾ ə ɾ 'ə m	k o m p ɾ ə ɾ 'ɛ m
comprem	k o m p ɾ 'ə m	k o m p ɾ 'ɛ m
compren	k 'o m p ɾ ə n	k 'ɔ m p ɾ ə n
compres	k 'o m p ɾ ə s	k 'ɔ m p ɾ ə s
compro	k 'o m p ɾ o	k 'ɔ m p ɾ o
comprometem	k o m p ɾ o m ə t 'ə m	k o m p ɾ o m ə t 'ɛ m
comprometi	k o m p ɾ o m 'ɛ t i	k o m p ɾ o m 'ə t i
compta	k 'o m t ə	k 'ɔ m t ə
compte	k 'o m t ə	k 'ɔ m t ə
compten	k 'o m t ə n	k 'ɔ m t ə n
comptes	k 'o m t ə s	k 'ɔ m t ə s
computarem	k o m p u t ə ɾ 'ə m	k o m p u t ə ɾ 'ɛ m
computem	k o m p u t 'ə m	k o m p u t 'ɛ m
comtat	k o n t 'a t	k o m 'a t
comtats	k o n t 'a t s	k o m 'a t s
comte	k 'o n t ə	k 'ɔ m ə
comtes	k 'o n t ə s	k 'ɔ m ə s
conca	k 'o ŋ k ə	k 'ɔ ŋ k ə
concepte	k o n s 'ɛ t t ə	k o n s 'ə t t ə
concloses	k o ŋ k l 'ɔ z ə s	k o ŋ k l 'o z ə s
concurrència	k o ŋ k u r 'ɛ n s i ə	k o ŋ k u r 'ə n s i ə
conèixer	k o n 'ə ʃ ə	k o n 'ɛ ʃ ə
congènit	k o n ʒ 'ɛ n i t	k o n ʒ 'ə n i t
congènita	k o n ʒ 'ɛ n i t ə	k o n ʒ 'ə n i t ə
congènites	k o n ʒ 'ɛ n i t ə s	k o n ʒ 'ə n i t ə s
congènits	k o n ʒ 'ɛ n i t s	k o n ʒ 'ə n i t s
conques	k 'o ŋ k ə s	k 'ɔ ŋ k ə s
conquesta	k o ŋ k 'e s t ə	k o ŋ k 'ə s t ə
consciència	k o n t s i 'ɛ n s i ə	k o n t s i 'ə n s i ə
consell	k o n s 'ə ʎ	k o n s 'e ʎ
consens	k o n s 'ə n s	k o n s 'e n s
conseqüència	k o n s ə k w 'ɛ n s i ə	k o n s ə k w 'ə n s i ə
conseqüències	k o n s ə k w 'ɛ n s i ə s	k o n s ə k w 'ə n s i ə s
consistència	k o n s i s t 'ɛ n s i ə	k o n s i s t 'ə n s i ə
consistències	k o n s i s t 'ɛ n s i ə s	k o n s i s t 'ə n s i ə s
consta	k 'o n s t ə	k 'ɔ n s t ə
constatarem	k o n s t ə t ə ɾ 'ə m	k o n s t ə t ə ɾ 'ɛ m
constatem	k o n s t ə t 'ə m	k o n s t ə t 'ɛ m
conte	k 'o n t ə	k 'ɔ n t ə
contem	k o n t 'ə m	k o n t 'ɛ m
conten	k 'o n t ə n	k 'ɔ n t ə n
contes	k 'o n t ə s	k 'ɔ n t ə s
contigu	k o n t 'i ɣ u	k o n t 'i ɣ
contra	k 'o n t ɾ ə	k 'ɔ n t ɾ ə
copa	k 'o p ə	k 'ɔ p ə
copes	k 'o p ə s	k 'ɔ p ə s
copiarem	k o p i ə ɾ 'ə m	k o p i ə ɾ 'ɛ m
copiem	k o p i 'ə m	k o p i 'ɛ m
copsa	k 'o t s ə	k 'ɔ t s ə
copsar	k o t s 'a	k o p s 'a
copsat	k o t s 'a t	k o s 'a t
coquessa	k o k 'ə s ə	k o k 'e s ə
cora	k 'ɔ ɾ ə	k 'o ɾ ə
coratge	k o ɾ 'a d ʒ ə	k o ɾ 'a dʒ ə
coratges	k o ɾ 'a d ʒ ə s	k o ɾ 'a dʒ ə s
coratjós	k o ɾ ə d ʒ 'o s	k o ɾ ə dʒ 'o s
coratjosa	k o ɾ ə d ʒ 'o z ə	k o ɾ ə dʒ 'o z ə
corre	k 'o r ə	k 'ɔ r ə
corren	k 'o r ə n	k 'ɔ r ə n
correspondències	k o r ə s p o n d 'ɛ n s i ə s	k o r ə s p o n d 'ə n s i ə s
corretgeta	k o r ə d ʒ 'ə t ə	k o r ə dʒ 'ə t ə
corretjola	k o r ə d ʒ 'ɔ l ə	k o r ə dʒ 'ɔ l ə
corretjós	k o r ə d ʒ 'o s	k o r ə dʒ 'o s
corretjut	k o r ə d ʒ 'u t	k o r ə dʒ 'u t
corro	k 'o r o	k 'ɔ r o
corrompre	k o r 'o m p ɾ ə	k o r 'ɔ m p ɾ ə
corsa	k 'o ɾ s ə	k 'ɔ ɾ s ə
corses	k 'o ɾ s ə s	k 'ɔ ɾ s ə s
cosa	k 'ɔ z ə	k 'o z ə
coses	k 'ɔ z ə s	k 'o z ə s
cosmètic	k o z m 'ɛ t i k	k o z m 'ə t i k
cosmètics	k o z m 'ɛ t i t s	k o z m 'ə t i t s
cosmos	k 'o z m o s	k 'ɔ z m o s
cotxe	k 'o t ʃ o	k 'ɔ tʃ ə
cotxes	k 'o t ʃ ə s	k 'ɔ tʃ ə s
cotxet	k o t ʃ 'ə t	k o tʃ 'ə t
creen	k ɾ 'e ə n	k ɾ 'ɛ ə n
creixen	k ɾ 'e ʃ ə n	k ɾ 'ɛ ʃ ə n
crema	k ɾ 'e m ə	k ɾ 'ɛ m ə
cremen	k ɾ 'e m ə n	k ɾ 'ɛ m ə n
cremes	k ɾ 'e m ə s	k ɾ 'ɛ m ə s
cribratge	k ɾ i β ɾ 'a d ʒ ə	k ɾ i β ɾ 'a dʒ ə
cribratges	k ɾ i β ɾ 'a d ʒ ə s	k ɾ i β ɾ 'a dʒ ə s
crisantem	k ɾ i z ə n t 'ə m	k ɾ i z ə n t 'ɛ m
cuidarem	k u j ð ə ɾ 'ə m	k u j ð ə ɾ 'ɛ m
curts	k 'u ɾ s	k 'u ɾ t s
cutxo	k 'u t ʃ o	k 'u tʃ o
darrere	d ə r 'e ɾ ə	d ə r 'ə ɾ ə
datarem	d ə t ə ɾ 'ə m	d ə t ə ɾ 'ɛ m
datem	d ə t 'ə m	d ə t 'ɛ m
datxa	d 'a t ʃ ə	d 'a tʃ ə
de	d 'ə	d ə
decadència	d ə k ə ð 'ɛ n s i ə	d ə k ə ð 'ə n s i ə
decència	d ə s 'ɛ n s i ə	d ə s 'ə n s i ə
decències	d ə s 'ɛ n s i ə s	d ə s 'ə n s i ə s
decenni	d ə s 'ɛ n n i	d ə s 'ə n n i
declararem	d ə k l ə ɾ ə ɾ 'ə m	d ə k l ə ɾ ə ɾ 'ɛ m
declarem	d ə k l ə ɾ 'ə m	d ə k l ə ɾ 'ɛ m
dedicarem	d ə ð i k ə ɾ 'ə m	d ə ð i k ə ɾ 'ɛ m
dediquem	d ə ð i k 'ə m	d ə ð i k 'ɛ m
deficiència	d ə f i s i 'ɛ n s i ə	d ə f i s i 'ə n s i ə
definirem	d ə f i n i ɾ 'ə m	d ə f i n i ɾ 'ɛ m
defora	d ə f 'ɔ ɾ ə	d ə f 'o ɾ ə
degui	d 'ɛ ɣ i	d 'ə ɣ i
deix	d 'e ʃ	d 'ɛ ʃ
deixeble	d ə ʃ 'e b b l ə	d ə ʃ 'ə b b l ə
delinqüència	d ə l i ŋ k w 'ɛ n s i ə	d ə l i ŋ k w 'ə n s i ə
demència	d ə m 'ɛ n s i ə	d ə m 'ə n s i ə
demències	d ə m 'ɛ n s i ə s	d ə m 'ə n s i ə s
denotarem	d ə n o t ə ɾ 'ə m	d ə n o t ə ɾ 'ɛ m
denotem	d ə n o t 'ə m	d ə n o t 'ɛ m
dens	d 'ə n s	d 'e n s
dependència	d ə p ə n d 'ɛ n s i ə	d ə p ə n d 'ə n s i ə
derbi	d 'ɛ ɾ β i	d 'ə ɾ β i
dèria	d 'ɛ ɾ i ə	d 'ə ɾ i ə
desaparèixer	d ə z ə p ə ɾ 'ə ʃ ə	d ə z ə p ə ɾ 'ɛ ʃ ə
desatendre	d ə z ə t 'e n d ɾ ə	d ə z ə t 'ə n d ɾ ə
desavantatge	d ə z ə v ə n t 'a d ʒ ə	d ə z ə v ə n t 'a dʒ ə
descartarem	d ə s k ə ɾ t ə ɾ 'ə m	d ə s k ə ɾ t ə ɾ 'ɛ m
descartem	d ə s k ə ɾ t 'ə m	d ə s k ə ɾ t 'ɛ m
descompte	d ə s k 'o m t ə	d ə s k 'ɔ m t ə
desconèixer	d ə s k o n 'ə ʃ ə	d ə s k o n 'ɛ ʃ ə
descontentarem	d ə s k o n t ə n t ə ɾ 'ə m	d ə s k o n t ə n t ə ɾ 'ɛ m
descontentem	d ə s k o n t ə n t 'ə m	d ə s k o n t ə n t 'ɛ m
descoratge	d ə s k o ɾ 'a d ʒ ə	d ə s k o ɾ 'a dʒ ə
descoratjada	d ə s k o ɾ ə d ʒ 'a ð ə	d ə s k o ɾ ə dʒ 'a ð ə
descoratjades	d ə s k o ɾ ə d ʒ 'a ð ə s	d ə s k o ɾ ə dʒ 'a ð ə s
descoratjar	d ə s k o ɾ ə d ʒ 'a	d ə s k o ɾ ə dʒ 'a
descoratjat	d ə s k o ɾ ə d ʒ 'a t	d ə s k o ɾ ə dʒ 'a t
descoratjats	d ə s k o ɾ ə d ʒ 'a t s	d ə s k o ɾ ə dʒ 'a t s
desembre	d ə z 'e m b ɾ ə	d ə z 'ɛ m b ɾ ə
desencoratjar	d ə z ə ŋ k o ɾ ə d ʒ 'a	d ə z ə ŋ k o ɾ ə dʒ 'a
desfet	d ə s f 'e t	d ə s f 'ə t
desfeta	d ə s f 'e t ə	d ə s f 'ə t ə
desguàs	d ə z ɣ w 'a s	d ə z ɣ 'a s
desig	d ə z 'i t ʃ	d ə z 'i k
desigs	d ə z 'i t ʃ s	d ə z 'i s
desin	d 'ɛ z i n	d 'ə z i n
desinència	d ə z i n 'ɛ n s i ə	d ə z i n 'ə n s i ə
desintegrarem	d ə z i n t ə ɣ ɾ ə ɾ 'ə m	d ə z i n t ə ɣ ɾ ə ɾ 'ɛ m
desintegrem	d ə z i n t ə ɣ ɾ 'ə m	d ə z i n t ə ɣ ɾ 'ɛ m
desis	d 'ɛ z i s	d 'ə z i s
desitjable	d ə z i d ʒ 'a b b l ə	d ə z i dʒ 'a b b l ə
desitjada	d ə z i d ʒ 'a ð ə	d ə z i dʒ 'a ð ə
desitjades	d ə z i d ʒ 'a ð ə s	d ə z i dʒ 'a ð ə s
desitjar	d ə z i d ʒ 'a	d ə z i dʒ 'a
desitjat	d ə z i d ʒ 'a t	d ə z i dʒ 'a t
desitjats	d ə z i d ʒ 'a t s	d ə z i dʒ 'a t s
desitjos	d ə z 'i d ʒ o s	d ə z 'i dʒ o s
desmuntatge	d ə z m u n t 'a d ʒ ə	d ə z m u n t 'a dʒ ə
deso	d 'e z o	d 'ə z o
desordre	d ə z 'o ɾ ð ɾ ə	d ə z 'ɔ ɾ ð ɾ ə
despatx	d ə s p 'a t ʃ	d ə s p 'a tʃ
despatxada	d ə s p ə t ʃ 'a ð ə	d ə s p ə tʃ 'a ð ə
despatxades	d ə s p ə t ʃ 'a ð ə s	d ə s p ə tʃ 'a ð ə s
despatxar	d ə s p ə t ʃ 'a	d ə s p ə tʃ 'a
despatxat	d ə s p ə t ʃ 'a t	d ə s p ə tʃ 'a t
despatxats	d ə s p ə t ʃ 'a t s	d ə s p ə tʃ 'a t s
despatxos	d ə s p 'a t ʃ o s	d ə s p 'a tʃ o s
Despuig	d ə s p 'u t ʃ	d ə s p 'u tʃ
destra	d 'e s t ɾ ə	d 'ə s t ɾ ə
destres	d 'e s t ɾ ə s	d 'ə s t ɾ ə s
desvetlada	d ə z v ə l l 'a ð ə	d ə z v ə ʎ 'a ð ə
desvetlades	d ə z v ə l l 'a ð ə s	d ə z v ə ʎ 'a ð ə s
desvetlament	d ə z v ə l l ə m 'e n t	d ə z v ə ʎ ə m 'e n t
desvetlar	d ə z v ə l l 'a	d ə z v ə ʎ 'a
desvetlat	d ə z v ə l l 'a t	d ə z v ə ʎ 'a t
desvetlats	d ə z v ə l l 'a t s	d ə z v ə ʎ 'a t s
desvetllada	d ə z v ə ʎ ʎ 'a ð ə	d ə z v ə l l 'a ð ə
desvetllades	d ə z v ə ʎ ʎ 'a ð ə s	d ə z v ə l l 'a ð ə s
desvetllament	d ə z v ə ʎ ʎ ə m 'e n t	d ə z v ə l l ə m 'e n t
desvetllar	d ə z v ə ʎ ʎ 'a	d ə z v ə l l 'a
desvetllat	d ə z v ə ʎ ʎ 'a t	d ə z v ə l l 'a t
desvetllats	d ə z v ə ʎ ʎ 'a t s	d ə z v ə l l 'a t s
determinarem	d ə t ə ɾ m i n ə ɾ 'ə m	d ə t ə ɾ m i n ə ɾ 'ɛ m
determinem	d ə t ə ɾ m i n 'ə m	d ə t ə ɾ m i n 'ɛ m
detona	d ə t 'ɔ n ə	d ə t 'o n ə
detonarem	d ə t o n ə ɾ 'ə m	d ə t o n ə ɾ 'ɛ m
detonem	d ə t o n 'ə m	d ə t o n 'ɛ m
detones	d ə t 'ɔ n ə s	d ə t 'o n ə s
detono	d ə t 'ɔ n o	d ə t 'o n o
diabetis	d i ə β 'ɛ t i s	d i ə β 'ə t i s
diarrea	d i ə r 'ɛ ə	d i ə r 'e ə
diatomea	d i ə t o m 'ɛ ə	d i ə t o m 'e ə
dietètic	d i ə t 'ɛ t i k	d i ə t 'ə t i k
dietètica	d i ə t 'ɛ t i k ə	d i ə t 'ə t i k ə
dietètics	d i ə t 'ɛ t i t s	d i ə t 'ə t i t s
dietètiques	d i ə t 'ɛ t i k ə s	d i ə t 'ə t i k ə s
diferència	d i f ə ɾ 'ɛ n s i ə	d i f ə ɾ 'ə n s i ə
difondre	d i f 'o n d ɾ ə	d i f 'ɔ n d ɾ ə
dijous	d i ʒ 'ɔ w s	d i ʒ 'o w s
diligència	d i l i ʒ 'ɛ n s i ə	d i l i ʒ 'ə n s i ə
dimecres	d i m 'e k ɾ ə s	d i m 'ə k ɾ ə s
dirigirem	d i ɾ i ʒ i ɾ 'ə m	d i ɾ i ʒ i ɾ 'ɛ m
disentèric	d i z ə n t 'ɛ ɾ i k	d i z ə n t 'ə ɾ i k
disentèrica	d i z ə n t 'ɛ ɾ i k ə	d i z ə n t 'ə ɾ i k ə
dismenorrea	d i z m ə n o r 'ɛ ə	d i z m ə n o r 'e ə
disposes	d i s p 'ɔ z ə s	d i s p 'o z ə s
dissecarem	d i s ə k ə ɾ 'ə m	d i s ə k ə ɾ 'ɛ m
disseminarem	d i s ə m i n ə ɾ 'ə m	d i s ə m i n ə ɾ 'ɛ m
disseminem	d i s ə m i n 'ə m	d i s ə m i n 'ɛ m
dissequem	d i s ə k 'ə m	d i s ə k 'ɛ m
dissort	d i s 'ɔ ɾ t	d i s 'o ɾ t
distendre	d i s t 'e n d ɾ ə	d i s t 'ə n d ɾ ə
distreta	d i s t ɾ 'e t ə	d i s t ɾ 'ə t ə
diverses	d i v 'ɛ ɾ s ə s	d i v 'ə ɾ s ə s
dividend	d i v i ð 'e n t	d i v i ð 'ə n t
dividirem	d i v i ð i ɾ 'ə m	d i v i ð i ɾ 'ɛ m
doble	d 'o b b l ə	d 'ɔ b b l ə
dobles	d 'o b b l ə s	d 'ɔ b b l ə s
docència	d o s 'ɛ n s i ə	d o s 'ə n s i ə
dogma	d 'o m m ə	d 'ɔ m m ə
dogmes	d 'o m m ə s	d 'ɔ m m ə s
dolça	d 'o l s ə	d 'ɔ l s ə
dolces	d 'o l s ə s	d 'ɔ l s ə s
dolços	d 'o l s o s	d 'ɔ l s o s
doler	d o l 'ə	d o l 'e
domarem	d o m ə ɾ 'ə m	d o m ə ɾ 'ɛ m
domem	d o m 'ə m	d o m 'ɛ m
domèstic	d o m 'ɛ s t i k	d o m 'ə s t i k
domèstica	d o m 'ɛ s t i k ə	d o m 'ə s t i k ə
domèstics	d o m 'ɛ s t i t s	d o m 'ə s t i t s
domèstiques	d o m 'ɛ s t i k ə s	d o m 'ə s t i k ə s
donen	d 'o n ə n	d 'ɔ n ə n
dopa	d 'o p ə	d 'ɔ p ə
dopatge	d o p 'a d ʒ ə	d o p 'a dʒ ə
dotze	d 'o d z ə	d 'ɔ d z ə
dreces	d ɾ 'ə s ə s	d ɾ 'e s ə s
drenatge	d ɾ ə n 'a d ʒ ə	d ɾ ə n 'a dʒ ə
dutxa	d 'u t ʃ ə	d 'u tʃ ə
dutxada	d u t ʃ 'a ð ə	d u tʃ 'a ð ə
dutxades	d u t ʃ 'a ð ə s	d u tʃ 'a ð ə s
dutxar	d u t ʃ 'a	d u tʃ 'a
Ebre	'e β ɾ ə	'ə β ɾ ə
ebri	'ɛ β ɾ i	'ə β ɾ i
eclèctic	ə k l 'ə t t i k	ə k l 'ɛ t t i k
eclipsa	ə k l 'i t s ə	ə k l 'i s ə
eclipsarem	ə k l i t s ə ɾ 'ə m	ə k l i t s ə ɾ 'ɛ m
ecosistema	ə k o s i s t 'e m ə	ə k o z i s t 'ɛ m ə
efemèride	ə f ə m 'ɛ ɾ i ð ə	ə f ə m 'ə ɾ i ð ə
eficiència	ə f i s i 'ɛ n s i ə	ə f i s i 'ə n s i ə
ègida	'ə ʒ i ð ə	'ɛ ʒ i ð ə
ego	'e ɣ o	'ə ɣ o
egocèntric	ə ɣ o s 'ɛ n t ɾ i k	ə ɣ o s 'ə n t ɾ i k
Eivissa	ə j v 'i s ə	ə i v 'i s ə
eivissenc	ə j v i s 'ə ŋ k	ə i v i s 'ə ŋ k
eix	'e ʃ	'ɛ ʃ
eixe	'e ʃ ə	'ɛ ʃ ə
elaborarem	ə l ə β o ɾ ə ɾ 'ə m	ə l ə β o ɾ ə ɾ 'ɛ m
elaborem	ə l ə β o ɾ 'ə m	ə l ə β o ɾ 'ɛ m
Eloi	ə l 'ɔ j	ə l 'o i
elxans	ə l ʃ 'a n s	ə l s 'a n s
em	'ə m	ə m
embalatge	ə m b ə l 'a d ʒ ə	ə m b ə l 'a dʒ ə
emborratxar	ə m b o r ə t ʃ 'a	ə m b o r ə tʃ 'a
embragatge	ə m b ɾ ə ɣ 'a d ʒ ə	ə m b ɾ ə ɣ 'a dʒ ə
embutxacada	ə m b u t ʃ ə k 'a ð ə	ə m b u tʃ ə k 'a ð ə
embutxacades	ə m b u t ʃ ə k 'a ð ə s	ə m b u tʃ ə k 'a ð ə s
embutxacar	ə m b u t ʃ ə k 'a	ə m b u tʃ ə k 'a
embutxacat	ə m b u t ʃ ə k 'a t	ə m b u tʃ ə k 'a t
embutxacats	ə m b u t ʃ ə k 'a t s	ə m b u tʃ ə k 'a t s
emergència	ə m ə ɾ ʒ 'ɛ n s i ə	ə m ə ɾ ʒ 'ə n s i ə
emèrit	ə m 'ɛ ɾ i t	ə m 'ə ɾ i t
emèrita	ə m 'ɛ ɾ i t ə	ə m 'ə ɾ i t ə
emèrites	ə m 'ɛ ɾ i t ə s	ə m 'ə ɾ i t ə s
emèrits	ə m 'ɛ ɾ i t s	ə m 'ə ɾ i t s
emètic	ə m 'ɛ t i k	ə m 'ə t i k
emigrem	ə m i ɣ ɾ 'ə m	ə m i ɣ ɾ 'ɛ m
emmagatzematge	ə m m ə ɣ ə d z ə m 'a d ʒ ə	ə m m ə ɣ ə d z ə m 'a dʒ ə
empatx	ə m p 'a t ʃ	ə m p 'a tʃ
empatxar	ə m p ə t ʃ 'a	ə m p ə tʃ 'a
empitjorar	ə m p i d ʒ o ɾ 'a	ə m p i dʒ o ɾ 'a
empra	'e m p ɾ ə	'ɛ m p ɾ ə
empremta	ə m p ɾ 'e n t ə	ə m p ɾ 'ɛ m ə
empren	'e m p ɾ ə n	'ɛ m p ɾ ə n
emularem	ə m u l ə ɾ 'ə m	ə m u l ə ɾ 'ɛ m
emulem	ə m u l 'ə m	ə m u l 'ɛ m
ena	'e n ə	'ə n ə
encantarem	ə ŋ k ə n t ə ɾ 'ə m	ə ŋ k ə n t ə ɾ 'ɛ m
encapritxar	ə ŋ k ə p ɾ i t ʃ 'a	ə ŋ k ə p ɾ i tʃ 'a
encaputxar	ə ŋ k ə p u t ʃ 'a	ə ŋ k ə p u tʃ 'a
encaputxat	ə ŋ k ə p u t ʃ 'a t	ə ŋ k ə p u tʃ 'a t
encendre	ə n s 'e n d ɾ ə	ə n s 'ə n d ɾ ə
encoratjada	ə ŋ k o ɾ ə d ʒ 'a ð ə	ə ŋ k o ɾ ə dʒ 'a ð ə
encoratjades	ə ŋ k o ɾ ə d ʒ 'a ð ə s	ə ŋ k o ɾ ə dʒ 'a ð ə s
encoratjador	ə ŋ k o ɾ ə d ʒ ə ð 'o	ə ŋ k o ɾ ə dʒ ə ð 'o
encoratjar	ə ŋ k o ɾ ə d ʒ 'a	ə ŋ k o ɾ ə dʒ 'a
encoratjat	ə ŋ k o ɾ ə d ʒ 'a t	ə ŋ k o ɾ ə dʒ 'a t
encoratjats	ə ŋ k o ɾ ə d ʒ 'a t s	ə ŋ k o ɾ ə dʒ 'a t s
endarrere	ə n d ə r 'e ɾ ə	ə n d ə r 'ə ɾ ə
endèmic	ə n d 'ɛ m i k	ə n d 'ə m i k
endèmica	ə n d 'ɛ m i k ə	ə n d 'ə m i k ə
endèmics	ə n d 'ɛ m i t s	ə n d 'ə m i t s
endèmiques	ə n d 'ɛ m i k ə s	ə n d 'ə m i k ə s
ene	'e n ə	'ə n ə
engatjar	ə ŋ g ə d ʒ 'a	ə ŋ g ə dʒ 'a
enlletgir	ə n ʎ ə d ʒ 'i	ə n ʎ ə dʒ 'i
enmig	ə m m 'i t ʃ	ə m m 'i k
enorme	ə n 'o ɾ m ə	ə n 'ɔ ɾ m ə
enormes	ə n 'o ɾ m ə s	ə n 'ɔ ɾ m ə s
enquesta	ə ŋ k 'e s t ə	ə ŋ k 'ə s t ə
ensitjada	ə n s i d ʒ 'a ð ə	ə n s i dʒ 'a ð ə
ensitjades	ə n s i d ʒ 'a ð ə s	ə n s i dʒ 'a ð ə s
ensitjar	ə n s i d ʒ 'a	ə n s i dʒ 'a
ensitjarà	ə n s i d ʒ ə ɾ 'a	ə n s i dʒ ə ɾ 'a
ensitjat	ə n s i d ʒ 'a t	ə n s i dʒ 'a t
ensitjats	ə n s i d ʒ 'a t s	ə n s i dʒ 'a t s
entelèquia	ə n t ə l 'ə k i ə	ə n t ə l 'ɛ k i ə
entendre	ə n t 'e n d ɾ ə	ə n t 'ə n d ɾ ə
èntesi	'ɛ n t ə z i	'ə n t ə z i
entre	'e n t ɾ ə	'ə n t ɾ ə
entren	'e n t ɾ ə n	'ə n t ɾ ə n
entres	'e n t ɾ ə s	'ə n t ɾ ə s
entro	'e n t ɾ o	'ə n t ɾ o
enuig	ə n 'u t ʃ	ə n 'u tʃ
enutjada	ə n u d ʒ 'a ð ə	ə n u dʒ 'a ð ə
enutjades	ə n u d ʒ 'a ð ə s	ə n u dʒ 'a ð ə s
enutjar	ə n u d ʒ 'a	ə n u dʒ 'a
enutjat	ə n u d ʒ 'a t	ə n u dʒ 'a t
enutjats	ə n u d ʒ 'a t s	ə n u dʒ 'a t s
enutjós	ə n u d ʒ 'o s	ə n u dʒ 'o s
epèntesi	ə p 'ɛ n t ə z i	ə p 'ə n t ə z i
epicens	ə p i s 'ə n s	ə p i s 'e n s
epitèlic	ə p i t 'ɛ l i k	ə p i t 'ə l i k
epitèlica	ə p i t 'ɛ l i k ə	ə p i t 'ə l i k ə
epitèlics	ə p i t 'ɛ l i t s	ə p i t 'ə l i t s
epitèliques	ə p i t 'ɛ l i k ə s	ə p i t 'ə l i k ə s
eqüestre	ə k w 'e s t ɾ ə	ə k w 'ə s t ɾ ə
equiparem	ə k i p ə ɾ 'ə m	ə k i p ə ɾ 'ɛ m
equipatge	ə k i p 'a d ʒ ə	ə k i p 'a dʒ ə
equivaler	ə k i v ə l 'ə	ə k i v ə l 'e
equivoco	ə k i v 'o k o	ə k i v 'ɔ k o
erèctil	ə ɾ 'ə t t i l	ə ɾ 'ɛ t t i l
eren	'e ɾ ə n	'ɛ ɾ ə n
erroni	ə r 'ɔ n i	ə r 'o n i
escaguitxar	ə s k ə ɣ i t ʃ 'a	ə s k ə ɣ i tʃ 'a
escaig	ə s k 'a t ʃ	ə s k 'a tʃ
escalens	ə s k ə l 'ə n s	ə s k ə l 'e n s
escaparem	ə s k ə p ə ɾ 'ə m	ə s k ə p ə ɾ 'ɛ m
escapem	ə s k ə p 'ə m	ə s k ə p 'ɛ m
escènic	ə t s 'ɛ n i k	ə t s 'ə n i k
escènica	ə t s 'ɛ n i k ə	ə t s 'ə n i k ə
escènics	ə t s 'ɛ n i t s	ə t s 'ə n i t s
escèniques	ə t s 'ɛ n i k ə s	ə t s 'ə n i k ə s
esclavatge	ə s k l ə v 'a d ʒ ə	ə s k l ə v 'a dʒ ə
escletxa	ə s k l 'e t ʃ ə	ə s k l 'ə tʃ ə
escolta	ə s k 'o l t ə	ə s k 'ɔ l t ə
escombra	ə s k 'o m b ɾ ə	ə s k 'ɔ m b ɾ ə
escreix	ə s k ɾ 'e ʃ	ə s k ɾ 'ɛ ʃ
escrot	ə s k ɾ 'o t	ə s k ɾ 'ɔ t
esfèric	ə s f 'ɛ ɾ i k	ə s f 'ə ɾ i k
esfèrica	ə s f 'ɛ ɾ i k ə	ə s f 'ə ɾ i k ə
Eslovènia	ə z l o v 'ɛ n i ə	ə z l o v 'ə n i ə
esment	ə z m 'e n t	e z m 'e n t
espadatxí	ə s p ə ð ə t ʃ 'i	ə s p ə ð ə tʃ 'i
espagueti	ə s p ə ɣ 'ɛ t i	ə s p ə ɣ 'ə t i
espatla	ə s p 'a l l ə	ə s p 'a l ə
espatlar	ə s p ə l l 'a	ə s p ə t l 'a
espatles	ə s p 'a l l ə s	ə s p 'a dʒ ə s
espatlla	ə s p 'a ʎ ʎ ə	ə s p 'a l l ə
espatllada	ə s p ə ʎ ʎ 'a ð ə	ə s p ə l l 'a ð ə
espatllades	ə s p ə ʎ ʎ 'a ð ə s	ə s p ə l l 'a ð ə s
espatllar	ə s p ə ʎ ʎ 'a	ə s p ə l l 'a
espatllat	ə s p ə ʎ ʎ 'a t	ə s p ə l l 'a t
espatllats	ə s p ə ʎ ʎ 'a t s	ə s p ə l l 'a t s
espatlles	ə s p 'a ʎ ʎ ə s	ə s p 'a l l ə s
espatllut	ə s p ə ʎ ʎ 'u t	ə s p ə l l 'u t
espectre	ə s p 'e t t ɾ ə	ə s p 'ɛ t t ɾ ə
espigarem	ə s p i ɣ ə ɾ 'ə m	ə s p i ɣ ə ɾ 'ɛ m
espiguem	ə s p i ɣ 'ə m	ə s p i ɣ 'ɛ m
espinavessa	ə s p i n ə v 'ə s ə	ə s p i n ə v 'e s ə
espionatge	ə s p i o n 'a d ʒ ə	ə s p i o n 'a dʒ ə
espona	ə s p 'ɔ n ə	ə s p 'o n ə
esquelètic	ə s k ə l 'ɛ t i k	ə s k ə l 'ə t i k
esquetx	ə s k 'e t ʃ	ə s k 'ɛ tʃ
esquitllar	ə s k i ʎ ʎ 'a	ə s k i l l 'a
esquitx	ə s k 'i t ʃ	ə s k 'i tʃ
esquitxada	ə s k i t ʃ 'a ð ə	ə s k i tʃ 'a ð ə
esquitxades	ə s k i t ʃ 'a ð ə s	ə s k i tʃ 'a ð ə s
esquitxar	ə s k i t ʃ 'a	ə s k i tʃ 'a
esquitxat	ə s k i t ʃ 'a t	ə s k i tʃ 'a t
esquitxats	ə s k i t ʃ 'a t s	ə s k i tʃ 'a t s
esquitxó	ə s k i t ʃ 'o	ə s k i tʃ 'o
esquizofrènia	ə s k i z o f ɾ 'ɛ n i ə	ə s k i z o f ɾ 'ə n i ə
essa	'ə s ə	'e s ə
esser	ə s 'ə	ə s 'e
esta	'e s t ə	'ə s t ə
estacarem	ə s t ə k ə ɾ 'ə m	ə s t ə k ə ɾ 'ɛ m
estaquem	ə s t ə k 'ə m	ə s t ə k 'ɛ m
estendre	ə s t 'e n d ɾ ə	ə s t 'ə n d ɾ ə
estèril	ə s t 'ɛ ɾ i l	ə s t 'ə ɾ i l
estètic	ə s t 'ɛ t i k	ə s t 'ə t i k
estiatge	ə s t i 'a d ʒ ə	ə s t i 'a dʒ ə
estofa	ə s t 'o f ə	ə s t 'ɔ f ə
estoig	ə s t 'ɔ t ʃ	ə s t 'ɔ tʃ
estotjar	ə s t o d ʒ 'a	ə s t o dʒ 'a
estramoni	ə s t ɾ ə m 'ɔ n i	ə s t ɾ ə m 'o n i
estrateg	ə s t ɾ ə t 'e k	ə s t ɾ ə t 'ɛ ʒ
estratègia	ə s t ɾ ə t 'ə ʒ i ə	ə s t ɾ ə t 'ɛ ʒ i ə
estropiarem	ə s t ɾ o p i ə ɾ 'ə m	ə s t ɾ o p i ə ɾ 'ɛ m
estropiem	ə s t ɾ o p i 'ə m	ə s t ɾ o p i 'ɛ m
ètica	'ɛ t i k ə	'ə t i k ə
etiquetatge	ə t i k ə t 'a d ʒ ə	ə t i k ə t 'a dʒ ə
etiquetatges	ə t i k ə t 'a d ʒ ə s	ə t i k ə t 'a dʒ ə s
eufoni	ə w f 'ɔ n i	ə w f 'o n i
eurocèntric	ə w ɾ o s 'ɛ n t ɾ i k	ə w ɾ o s 'ə n t ɾ i k
evangèlic	ə v ə n ʒ 'ɛ l i k	ə v ə n ʒ 'ə l i k
evangèlica	ə v ə n ʒ 'ɛ l i k ə	ə v ə n ʒ 'ə l i k ə
evangèlics	ə v ə n ʒ 'ɛ l i t s	ə v ə n ʒ 'ə l i t s
evangèliques	ə v ə n ʒ 'ɛ l i k ə s	ə v ə n ʒ 'ə l i k ə s
evidència	ə v i ð 'ɛ n s i ə	ə v i ð 'ə n s i ə
evolucionis	ə v o l u s i 'ɔ n i s	ə v o l u s i 'o n i s
exsenador	ə t s ə n ə ð 'o	ə s ə n ə ð 'o
exsoviètica	ə t s o v i 'ɛ t i k ə	ə s o v i 'ə t i k ə
fagosoma	f ə ɣ o z 'ɔ m ə	f ə ɣ o z 'o m ə
faltarem	f ə l t ə ɾ 'ə m	f ə l t ə ɾ 'ɛ m
faltem	f ə l t 'ə m	f ə l t 'ɛ m
fantasia	f ə n t ə z 'i ə	f ə n t ə s 'i ə
fantasies	f ə n t ə z 'i ə s	f ə n t ə s 'i ə s
fardatxo	f ə ɾ ð 'a t ʃ o	f ə ɾ ð 'a tʃ o
farmacèutic	f ə ɾ m ə s 'ə w t i k	f ə ɾ m ə s 'ɛ w t i k
farmacèutica	f ə ɾ m ə s 'ə w t i k ə	f ə ɾ m ə s 'ɛ w t i k ə
farmacèutics	f ə ɾ m ə s 'ə w t i t s	f ə ɾ m ə s 'ɛ w t i t s
farmacèutiques	f ə ɾ m ə s 'ə w t i k ə s	f ə ɾ m ə s 'ɛ w t i k ə s
farratge	f ə r 'a d ʒ ə	f ə r 'a dʒ ə
farratjar	f ə r ə d ʒ 'a	f ə r ə dʒ 'a
farratjó	f ə r ə d ʒ 'o	f ə r ə dʒ 'o
farts	f 'a ɾ s	f 'a ɾ t s
fatxada	f ə t ʃ 'a ð ə	f ə tʃ 'a ð ə
fatxades	f ə t ʃ 'a ð ə s	f ə tʃ 'a ð ə s
feble	f 'e b b l ə	f 'ə b b l ə
febles	f 'e b b l ə s	f 'ə b b l ə s
febre	f 'e β ɾ ə	f 'ə β ɾ ə
febres	f 'e β ɾ ə s	f 'ə β ɾ ə s
feix	f 'e ʃ	f 'ɛ ʃ
fen	f 'e n	f 'ə n
fenomènic	f ə n o m 'ɛ n i k	f ə n o m 'ə n i k
fens	f 'ə n s	f 'e n s
feren	f 'e ɾ ə n	f 'ɛ ɾ ə n
fèretre	f 'ɛ ɾ ə t ɾ ə	f 'ə ɾ ə t ɾ ə
fermentarem	f ə ɾ m ə n t ə ɾ 'ə m	f ə ɾ m ə n t ə ɾ 'ɛ m
fermentem	f ə ɾ m ə n t 'ə m	f ə ɾ m ə n t 'ɛ m
fermes	f 'ɛ ɾ m ə s	f 'ə ɾ m ə s
Fes	f 'e s	f 'ə s
festa	f 'e s t ə	f 'ə s t ə
festes	f 'e s t ə s	f 'ə s t ə s
feta	f 'e t ə	f 'ə t ə
fetes	f 'e t ə s	f 'ə t ə s
fetge	f 'e d ʒ ə	f 'ə dʒ ə
fètida	f 'ɛ t i ð ə	f 'ə t i ð ə
fetitxe	f ə t 'i t ʃ ə	f ə t 'i tʃ ə
fetjó	f ə d ʒ 'o	f ə dʒ 'o
ficarem	f i k ə ɾ 'ə m	f i k ə ɾ 'ɛ m
Filadèlfia	f i l ə ð 'ɛ l f i ə	f i l ə ð 'ə l f i ə
finestra	f i n 'e s t ɾ ə	f i n 'ə s t ɾ ə
fitxa	f 'i t ʃ ə	f 'i tʃ ə
fitxada	f i t ʃ 'a ð ə	f i tʃ 'a ð ə
fitxades	f i t ʃ 'a ð ə s	f i tʃ 'a ð ə s
fitxar	f i t ʃ 'a	f i tʃ 'a
fitxatge	f i t ʃ 'a d ʒ ə	f i tʃ 'a dʒ ə
fitxer	f i t ʃ 'e	f i tʃ 'e
fixa	f 'i t s ə	f 'i ʃ ə
fixar	f i t s 'a	f i ʃ 'a
fletxa	f l 'e t ʃ ə	f l 'ɛ tʃ ə
fletxes	f l 'e t ʃ ə s	f l 'ə tʃ ə s
Florència	f l o ɾ 'ɛ n s i ə	f l o ɾ 'ə n s i ə
fluorescència	f l u o ɾ ə t s 'ɛ n s i ə	f l u o ɾ ə t s 'ə n s i ə
foca	f 'o k ə	f 'ɔ k ə
folla	f 'o ʎ ə	f 'ɔ ʎ ə
folles	f 'o ʎ ə s	f 'ɔ ʎ ə s
fonda	f 'o n d ə	f 'ɔ n d ə
fondes	f 'o n d ə s	f 'ɔ n d ə s
fondo	f 'o n d o	f 'ɔ n d o
fondos	f 'o n d o s	f 'ɔ n d o s
fondre	f 'o n d ɾ ə	f 'ɔ n d ɾ ə
fonen	f 'o n ə n	f 'ɔ n ə n
fonètic	f o n 'ɛ t i k	f o n 'ə t i k
fonètica	f o n 'ɛ t i k ə	f o n 'ə t i k ə
fonètics	f o n 'ɛ t i t s	f o n 'ə t i t s
fonètiques	f o n 'ɛ t i k ə s	f o n 'ə t i k ə s
foques	f 'o k ə s	f 'ɔ k ə s
forca	f 'o ɾ k ə	f 'ɔ ɾ k ə
foren	f 'o ɾ ə n	f 'ɔ ɾ ə n
forma	f 'o ɾ m ə	f 'ɔ ɾ m ə
formatge	f o ɾ m 'a d ʒ ə	f o ɾ m 'a dʒ ə
formatgeria	f o ɾ m ə d ʒ ə ɾ 'i ə	f o ɾ m ə dʒ ə ɾ 'i ə
formatget	f o ɾ m ə d ʒ 'ə t	f o ɾ m ə dʒ 'ə t
formen	f 'o ɾ m ə n	f 'ɔ ɾ m ə n
formes	f 'o ɾ m ə s	f 'ɔ ɾ m ə s
formo	f 'o ɾ m o	f 'ɔ ɾ m o
fornicarem	f o ɾ n i k ə ɾ 'ə m	f o ɾ n i k ə ɾ 'ɛ m
forniquem	f o ɾ n i k 'ə m	f o ɾ n i k 'ɛ m
forques	f 'o ɾ k ə s	f 'ɔ ɾ k ə s
fort	f 'ɔ ɾ t	f 'o ɾ t
fosca	f 'o s k ə	f 'ɔ s k ə
foscos	f 'o s k o s	f 'ɔ s k o s
fosques	f 'o s k ə s	f 'ɔ s k ə s
foten	f 'o t ə n	f 'ɔ t ə n
fotjar	f o d ʒ 'a	f o dʒ 'a
fotjo	f 'ɔ d ʒ o	f 'ɔ dʒ o
foto	f 'o t o	f 'ɔ t o
fotos	f 'o t o s	f 'ɔ t o s
fotre	f 'o t ɾ ə	f 'ɔ t ɾ ə
frenen	f ɾ 'e n ə n	f ɾ 'ə n ə n
frenètic	f ɾ ə n 'ɛ t i k	f ɾ ə n 'ə t i k
frenètica	f ɾ ə n 'ɛ t i k ə	f ɾ ə n 'ə t i k ə
frenètics	f ɾ ə n 'ɛ t i t s	f ɾ ə n 'ə t i t s
frenètiques	f ɾ ə n 'ɛ t i k ə s	f ɾ ə n 'ə t i k ə s
frènica	f ɾ 'ɛ n i k ə	f ɾ 'ə n i k ə
frèniques	f ɾ 'ɛ n i k ə s	f ɾ 'ə n i k ə s
frens	f ɾ 'ə n s	f ɾ 'e n s
freqüència	f ɾ ə k w 'ɛ n s i ə	f ɾ ə k w 'ə n s i ə
fresi	f ɾ 'ɛ z i	f ɾ 'ə z i
fresin	f ɾ 'ɛ z i n	f ɾ 'ə z i n
fresis	f ɾ 'ɛ z i s	f ɾ 'ə z i s
frustrarem	f ɾ u s t ɾ ə ɾ 'ə m	f ɾ u s t ɾ ə ɾ 'ɛ m
frustrem	f ɾ u s t ɾ 'ə m	f ɾ u s t ɾ 'ɛ m
fumatge	f u m 'a d ʒ ə	f u m 'a dʒ ə
fuselatge	f u z ə l 'a d ʒ ə	f u z ə l 'a dʒ ə
gaèlic	g ə 'ɛ l i k	g ə 'ə l i k
gaèlica	g ə 'ɛ l i k ə	g ə 'ə l i k ə
gaèlics	g ə 'ɛ l i t s	g ə 'ə l i t s
galilea	g ə l i l 'ɛ ə	g ə l i l 'e ə
galotxa	g ə l 'ɔ t ʃ ə	g ə l 'ɔ tʃ ə
garatge	g ə ɾ 'a d ʒ ə	g ə ɾ 'a dʒ ə
gardènia	g ə ɾ ð 'ɛ n i ə	g ə ɾ ð 'ə n i ə
garnatxa	g ə ɾ n 'a t ʃ ə	g ə ɾ n 'a tʃ ə
garrotxí	g ə r o t ʃ 'i	g ə r o tʃ 'i
gasoil	g ə z 'ɔ j l	g ə z 'o i l
gaspatxo	g ə s p 'a t ʃ o	g ə s p 'a tʃ o
gelarem	ʒ ə l ə ɾ 'ə m	ʒ ə l ə ɾ 'ɛ m
gelem	ʒ ə l 'ə m	ʒ ə l 'ɛ m
gemec	ʒ ə m 'e k	ʒ ə m 'ɛ k
gemma	ʒ 'e m m ə	ʒ 'ɛ m m ə
Gemma	ʒ 'e m m ə	ʒ 'ɛ m m ə
gènere	ʒ 'ɛ n ə ɾ ə	ʒ 'ə n ə ɾ ə
genèric	ʒ ə n 'ɛ ɾ i k	ʒ ə n 'ə ɾ i k
genèrica	ʒ ə n 'ɛ ɾ i k ə	ʒ ə n 'ə ɾ i k ə
genèrics	ʒ ə n 'ɛ ɾ i t s	ʒ ə n 'ə ɾ i t s
genèriques	ʒ ə n 'ɛ ɾ i k ə s	ʒ ə n 'ə ɾ i k ə s
Gènesi	ʒ 'ɛ n ə z i	ʒ 'ə n ə z i
gènesi	ʒ 'ɛ n ə z i	ʒ 'ə n ə z i
genètic	ʒ ə n 'ɛ t i k	ʒ ə n 'ə t i k
genètica	ʒ ə n 'ɛ t i k ə	ʒ ə n 'ə t i k ə
genètics	ʒ ə n 'ɛ t i t s	ʒ ə n 'ə t i t s
genètiques	ʒ ə n 'ɛ t i k ə s	ʒ ə n 'ə t i k ə s
geni	ʒ 'ɛ n i	ʒ 'ə n i
genis	ʒ 'ɛ n i s	ʒ 'ə n i s
gespa	ʒ 'e s p ə	ʒ 'ə s p ə
gest	ʒ 'e s t	ʒ 'ə s t
gesta	ʒ 'e s t ə	ʒ 'ə s t ə
gestes	ʒ 'e s t ə s	ʒ 'ə s t ə s
gesti	ʒ 'ɛ s t i	ʒ 'ə s t i
gestin	ʒ 'ɛ s t i n	ʒ 'ə s t i n
gestis	ʒ 'ɛ s t i s	ʒ 'ə s t i s
gestos	ʒ 'e s t o s	ʒ 'ə s t o s
gimcana	ʒ i ŋ k 'a n ə	ʒ i m k 'a n ə
ginebra	ʒ i n 'e β ɾ ə	ʒ i n 'ə β ɾ ə
Ginebra	ʒ i n 'e β ɾ ə	ʒ i n 'ə β ɾ ə
ginesta	ʒ i n 'e s t ə	ʒ i n 'ə s t ə
glosa	g l 'ɔ z ə	g l 'o z ə
gloses	g l 'ɔ z ə s	g l 'o z ə s
golfa	g 'o l f ə	g 'ɔ l f ə
golfes	g 'o l f ə s	g 'ɔ l f ə s
gorg	g 'o ɾ k	g 'ɔ ɾ s
gossa	g 'o s ə	g 'ɔ s ə
gossos	g 'o s o s	g 'ɔ s o s
gota	g 'o t ə	g 'ɔ t ə
gotes	g 'o t ə s	g 'ɔ t ə s
governarem	g o v ə ɾ n ə ɾ 'ə m	g o v ə ɾ n ə ɾ 'ɛ m
governem	g o v ə ɾ n 'ə m	g o v ə ɾ n 'ɛ m
granuloma	g ɾ ə n u l 'ɔ m ə	g ɾ ə n u l 'o m ə
grega	g ɾ 'ə ɣ ə	g ɾ 'ɛ ɣ ə
gregues	g ɾ 'ə ɣ ə s	g ɾ 'ɛ ɣ ə s
greix	g ɾ 'e ʃ	g ɾ 'ɛ ʃ
greuge	g ɾ 'e w ʒ ə	g ɾ 'ɛ w ʒ ə
grèvol	g ɾ 'ɛ v o l	g ɾ 'ə v o l
gronxa	g ɾ 'o n ʃ ə	g ɾ 'ɔ n ʃ ə
guatlla	g w 'a ʎ ʎ ə	g w 'a l l ə
guatla	g w 'a l l ə	g w 'a l ə
guèiser	g 'ə j z ə	g w 'ə j z ə
Guillem	g i ʎ 'ə m	g i ʎ 'ɛ m
guinda	g 'i n d ə	g w 'i n d ə
Guissona	g i s 'ɔ n ə	g i s 'o n ə
guspira	g u s p 'i ɾ ə	g s p 'i ɾ ə
gutxo	g 'u t ʃ o	g 'u tʃ o
habitatge	ə β i t 'a d ʒ ə	ə β i t 'a dʒ ə
Haia	'a j ə	ə j ə
haixix	ə ʃ 'i ʃ	ə ʃ 'i s
harem	ə ɾ 'ə m	ə ɾ 'ɛ m
haver	ə v 'ə	ə v 'e
Hècate	'ə k ə t ə	ə k ə t ə
hemangioma	ə m ə n ʒ i 'ɔ m ə	ə m ə n ʒ i 'o m ə
Hèrcules	'ɛ ɾ k u l ə s	'ə ɾ k u l ə s
herència	ə ɾ 'ɛ n s i ə	ə ɾ 'ə n s i ə
heretgia	ə ɾ ə d ʒ 'i ə	ə ɾ ə dʒ 'i ə
herètic	ə ɾ 'ɛ t i k	ə ɾ 'ə t i k
herètica	ə ɾ 'ɛ t i k ə	ə ɾ 'ə t i k ə
herètics	ə ɾ 'ɛ t i t s	ə ɾ 'ə t i t s
herètiques	ə ɾ 'ɛ t i k ə s	ə ɾ 'ə t i k ə s
hermètic	ə ɾ m 'ɛ t i k	ə ɾ m 'ə t i k
heroi	ə ɾ 'ɔ j	ə ɾ 'o i
heroic	ə ɾ 'ɔ j k	ə ɾ 'o i k
hèrptil	'ɛ ɾ t t i l	'ə ɾ t t i l
heterogeni	ə t ə ɾ o ʒ 'ɛ n i	ə t ə ɾ o ʒ 'ə n i
heure	'ə w ɾ ə	'ɛ w ɾ ə
hevea	ə v 'ɛ ə	ə v 'e ə
hexàgon	ə t s 'a ɣ o n	ə d z 'a ɣ o n
hidromassatge	i ð ɾ o m ə s 'a d ʒ ə	i ð ɾ o m ə s 'a dʒ ə
hieràtic	j ə ɾ 'a t i k	i ə ɾ 'a t i k
hieràtics	j ə ɾ 'a t i t s	i ə ɾ 'a t i t s
higiene	i ʒ i 'e n ə	i ʒ i 'ə n ə
higiènic	i ʒ i 'ɛ n i k	i ʒ i 'ə n i k
higiènica	i ʒ i 'ɛ n i k ə	i ʒ i 'ə n i k ə
higiènics	i ʒ i 'ɛ n i t s	i ʒ i 'ə n i t s
higièniques	i ʒ i 'ɛ n i k ə s	i ʒ i 'ə n i k ə s
hipèrbaton	i p 'ɛ ɾ β ə t o n	i p 'ə ɾ β ə t o n
hipèrbola	i p 'ɛ ɾ β o l ə	i p 'ə ɾ β o l ə
hipèrbole	i p 'ɛ ɾ β o l ə	i p 'ə ɾ β o l ə
hipotètic	i p o t 'ɛ t i k	i p o t 'ə t i k
hipotètica	i p o t 'ɛ t i k ə	i p o t 'ə t i k ə
histèrica	i s t 'ɛ ɾ i k ə	i s t 'ə ɾ i k ə
hitlerià	i l l ə ɾ i 'a	i b b l ə ɾ i 'a
hola	'ɔ l ə	ə l ə
home	'ɔ m o	'ɔ m ə
homenatge	o m ə n 'a d ʒ ə	o m ə n 'a dʒ ə
homenatjada	o m ə n ə d ʒ 'a ð ə	o m ə n ə dʒ 'a ð ə
homenatjades	o m ə n ə d ʒ 'a ð ə s	o m ə n ə dʒ 'a ð ə s
homenatjar	o m ə n ə d ʒ 'a	o m ə n ə dʒ 'a
homenatjat	o m ə n ə d ʒ 'a t	o m ə n ə dʒ 'a t
homenatjats	o m ə n ə d ʒ 'a t s	o m ə n ə dʒ 'a t s
homes	'ɔ m ə s	'o m ə s
homogeni	o m o ʒ 'ɛ n i	o m o ʒ 'ə n i
hora	'ɔ ɾ ə	ə ɾ ə
hores	'ɔ ɾ ə s	'o ɾ ə s
hort	'ɔ ɾ t	ə ɾ t
hortènsia	o ɾ t 'ɛ n s i ə	o ɾ t 'ə n s i ə
hostatge	o s t 'a d ʒ ə	o s t 'a dʒ ə
hostatjar	o s t ə d ʒ 'a	o s t ə dʒ 'a
i	'i	i
iaia	j 'a j ə	i 'a j ə
iaies	j 'a j ə s	i 'a j ə s
iaio	j 'a j o	i 'a j o
iarda	j 'a ɾ ð ə	i 'a ɾ ð ə
ibèric	i β 'ɛ ɾ i k	i β 'ə ɾ i k
ibèrica	i β 'ɛ ɾ i k ə	i β 'ə ɾ i k ə
ibèrics	i β 'ɛ ɾ i t s	i β 'ə ɾ i t s
ibèriques	i β 'ɛ ɾ i k ə s	i β 'ə ɾ i k ə s
idea	i ð 'ɛ ə	i ð 'e ə
idiosincràsia	i ð i o s i ŋ k ɾ 'a z i ə	i ð i o z i ŋ k ɾ 'a z i ə
iemenita	j ə m ə n 'i t ə	i ə m ə n 'i t ə
imatge	i m 'a d ʒ ə	i m 'a dʒ ə
imàtgens	i m 'a d ʒ ə n s	i m 'a dʒ ə n s
immens	i m m 'ə n s	i m m 'e n s
imminència	i m m i n 'ɛ n s i ə	i m m i n 'ə n s i ə
immunodeficiència	i m m u n o ð ə f i s i 'ɛ n s i ə	i m m u n o ð ə f i s i 'ə n s i ə
impaciència	i m p ə s i 'ɛ n s i ə	i m p ə s i 'ə n s i ə
imparell	i m p ə ɾ 'ə ʎ	i m p ə ɾ 'e ʎ
imperfecte	i m p ə ɾ f 'ɛ t t ə	i m p ə ɾ f 'ə t t ə
imperfectes	i m p ə ɾ f 'ɛ t t ə s	i m p ə ɾ f 'ə t t ə s
imposes	i m p 'ɔ z ə s	i m p 'o z ə s
imprudència	i m p ɾ u ð 'ɛ n s i ə	i m p ɾ u ð 'ə n s i ə
impudència	i m p u ð 'ɛ n s i ə	i m p u ð 'ə n s i ə
incidència	i n s i ð 'ɛ n s i ə	i n s i ð 'ə n s i ə
incoherència	i ŋ k o ə ɾ 'ɛ n s i ə	i ŋ k o ə ɾ 'ə n s i ə
incompetència	i ŋ k o m p ə t 'ɛ n s i ə	i ŋ k o m p ə t 'ə n s i ə
inconsistència	i ŋ k o n s i s t 'ɛ n s i ə	i ŋ k o n s i s t 'ə n s i ə
independència	i n d ə p ə n d 'ɛ n s i ə	i n d ə p ə n d 'ə n s i ə
indicarem	i n d i k ə ɾ 'ə m	i n d i k ə ɾ 'ɛ m
indiferència	i n d i f ə ɾ 'ɛ n s i ə	i n d i f ə ɾ 'ə n s i ə
indonèsia	i n d o n 'ɛ z i ə	i n d o n 'ə z i ə
Indonèsia	i n d o n 'ɛ z i ə	i n d o n 'ə z i ə
inèrcia	i n 'ɛ ɾ s i ə	i n 'ə ɾ s i ə
inerts	i n 'ɛ ɾ s	i n 'ɛ ɾ t s
iniciarem	i n i s i ə ɾ 'ə m	i n i s i ə ɾ 'ɛ m
iniciem	i n i s i 'ə m	i n i s i 'ɛ m
innocència	i n n o s 'ɛ n s i ə	i n n o s 'ə n s i ə
insistència	i n s i s t 'ɛ n s i ə	i n s i s t 'ə n s i ə
insolència	i n s o l 'ɛ n s i ə	i n s o l 'ə n s i ə
insuficiència	i n s u f i s i 'ɛ n s i ə	i n s u f i s i 'ə n s i ə
insulinoma	i n s u l i n 'ɔ m ə	i n s u l i n 'o m ə
insultarem	i n s u l t ə ɾ 'ə m	i n s u l t ə ɾ 'ɛ m
insurgència	i n s u ɾ ʒ 'ɛ n s i ə	i n s u ɾ ʒ 'ə n s i ə
intempèrie	i n t ə m p 'ɛ ɾ i ə	i n t ə m p 'ə ɾ i ə
intens	i n t 'ə n s	i n t 'e n s
interrompre	i n t ə r 'o m p ɾ ə	i n t ə r 'ɔ m p ɾ ə
iònica	j 'ɔ n i k ə	i 'ɔ n i k ə
irrogarem	i r o ɣ ə ɾ 'ə m	i r o ɣ ə ɾ 'ɛ m
irroguem	i r o ɣ 'ə m	i r o ɣ 'ɛ m
isomètric	i z o m 'ɛ t ɾ i k	i z o m 'ə t ɾ i k
isomètrica	i z o m 'ɛ t ɾ i k ə	i z o m 'ə t ɾ i k ə
isomètrics	i z o m 'ɛ t ɾ i t s	i z o m 'ə t ɾ i t s
isomètriques	i z o m 'ɛ t ɾ i k ə s	i z o m 'ə t ɾ i k ə s
jazz	ʒ 'a s	ʒ 'a z
Jerusalem	ʒ ə ɾ u z ə l 'ə m	ʒ ə ɾ u z ə l 'ɛ m
jou	ʒ 'ɔ w	ʒ 'o w
jove	ʒ 'o v ə	ʒ 'ɔ v ə
jueu	ʒ u 'e w	ʒ u 'ɛ w
junts	ʒ 'u n s	ʒ 'u n t s
jutge	ʒ 'u d ʒ ə	ʒ 'u dʒ ə
jutjada	ʒ u d ʒ 'a ð ə	ʒ u dʒ 'a ð ə
jutjades	ʒ u d ʒ 'a ð ə s	ʒ u dʒ 'a ð ə s
jutjar	ʒ u d ʒ 'a	ʒ u dʒ 'a
jutjat	ʒ u d ʒ 'a t	ʒ u dʒ 'a t
jutjats	ʒ u d ʒ 'a t s	ʒ u dʒ 'a t s
la	l 'ə	l ə
laberints	l ə β ə ɾ 'i n s	l ə β ə ɾ 'i n t s
lacrosse	l ə k ɾ 'o s ə	l ə k ɾ 'ɔ s ə
lamentarem	l ə m ə n t ə ɾ 'ə m	l ə m ə n t ə ɾ 'ɛ m
lamentem	l ə m ə n t 'ə m	l ə m ə n t 'ɛ m
lepra	l 'e p ɾ ə	l 'ə p ɾ ə
les	l 'ə s	l ə s
lideratge	l i ð ə ɾ 'a d ʒ ə	l i ð ə ɾ 'a dʒ ə
lisosoma	l i z o z 'ɔ m ə	l i z o z 'o m ə
llagosta	ʎ ə ɣ 'o s t ə	ʎ ə ɣ 'ɔ s t ə
llambritja	ʎ ə m b ɾ 'i d ʒ ə	ʎ ə m b ɾ 'i dʒ ə
llebre	ʎ 'e β ɾ ə	ʎ 'ə β ɾ ə
llega	ʎ 'e ɣ ə	ʎ 'ə ɣ ə
llegenda	ʎ ə ʒ 'e n d ə	ʎ ə ʒ 'ə n d ə
llegendes	ʎ ə ʒ 'e n d ə s	ʎ ə ʒ 'ə n d ə s
Lleida	ʎ 'e j ð ə	ʎ 'ə j ð ə
lleixa	ʎ 'e ʃ ə	ʎ 'ɛ ʃ ə
llenci	ʎ 'ɛ n s i	ʎ 'ə n s i
llencin	ʎ 'ɛ n s i n	ʎ 'ə n s i n
llencis	ʎ 'ɛ n s i s	ʎ 'ə n s i s
llenços	ʎ 'e n s o s	ʎ 'ɛ n s o s
llenguatge	ʎ ə ŋ g w 'a d ʒ ə	ʎ ə ŋ g w 'a dʒ ə
llenja	ʎ 'e ɲ ə	ʎ 'ə ɲ ə
llepa	ʎ 'e p ə	ʎ 'ə p ə
llepen	ʎ 'e p ə n	ʎ 'ə p ə n
llesta	ʎ 'e s t ə	ʎ 'ə s t ə
llestes	ʎ 'e s t ə s	ʎ 'ə s t ə s
llestos	ʎ 'e s t o s	ʎ 'ə s t o s
lletges	ʎ 'e d ʒ ə s	ʎ 'ə dʒ ə s
lletja	ʎ 'e d ʒ ə	ʎ 'ə dʒ ə
lletjor	ʎ ə d ʒ 'o	ʎ ə dʒ 'o
lletjos	ʎ 'e d ʒ o s	ʎ 'ə dʒ o s
lleva	ʎ 'e v ə	ʎ 'ə v ə
lleves	ʎ 'e v ə s	ʎ 'ə v ə s
llevo	ʎ 'e v o	ʎ 'ə v o
llicència	ʎ i s 'ɛ n s i ə	ʎ i s 'ə n s i ə
llinatge	ʎ i n 'a d ʒ ə	ʎ i n 'a dʒ ə
lloba	ʎ 'o β ə	ʎ 'ɔ β ə
Llobregat	ʎ o β ɾ ə ɣ 'a t	ʎ u β ɾ ə ɣ 'a t
Londres	l 'o n d ɾ ə s	l 'ɔ n d ɾ ə s
luminescència	l u m i n ə t s 'ɛ n s i ə	l u m i n ə t s 'ə n s i ə
ma	m 'ə	m ə
Macaronèsia	m ə k ə ɾ o n 'ɛ z i ə	m ə k ə ɾ o n 'ə z i ə
macedoni	m ə s ə ð 'ɔ n i	m ə s ə ð 'o n i
magatzem	m ə ɣ ə d z 'ə m	m ə ɣ ə d z 'ɛ m
magnesi	m ə n n 'ɛ z i	m ə n n 'ə z i
magnèsica	m ə n n 'ɛ z i k ə	m ə n n 'ə z i k ə
magnèsics	m ə n n 'ɛ z i t s	m ə n n 'ə z i t s
magnèsiques	m ə n n 'ɛ z i k ə s	m ə n n 'ə z i k ə s
magnètic	m ə n n 'ɛ t i k	m ə n n 'ə t i k
magnètica	m ə n n 'ɛ t i k ə	m ə n n 'ə t i k ə
magnètics	m ə n n 'ɛ t i t s	m ə n n 'ə t i t s
magnètiques	m ə n n 'ɛ t i k ə s	m ə n n 'ə t i k ə s
Mahoma	m ə 'ɔ m ə	m ə 'o m ə
malèfic	m ə l 'ɛ f i k	m ə l 'ə f i k
malèfica	m ə l 'ɛ f i k ə	m ə l 'ə f i k ə
malèvol	m ə l 'ɛ v o l	m ə l 'ə v o l
malèvola	m ə l 'ɛ v o l ə	m ə l 'ə v o l ə
malevolència	m ə l ə v o l 'ɛ n s i ə	m ə l ə v o l 'ə n s i ə
malèvoles	m ə l 'ɛ v o l ə s	m ə l 'ə v o l ə s
malèvols	m ə l 'ɛ v o l s	m ə l 'ə v o l s
malgrat	m ə l ɣ ɾ 'a t	m ə l g ɾ 'a t
malvendre	m ə l v 'e n d ɾ ə	m ə l v 'ə n d ɾ ə
malvolença	m ə l v o l 'ɛ n s ə	m ə l v o l 'ə n s ə
mamarem	m ə m ə ɾ 'ə m	m ə m ə ɾ 'ɛ m
manifest	m ə n i f 'e s t	m ə n i f 'ə s t
manomètric	m ə n o m 'ɛ t ɾ i k	m ə n o m 'ə t ɾ i k
manomètrica	m ə n o m 'ɛ t ɾ i k ə	m ə n o m 'ə t ɾ i k ə
manomètrics	m ə n o m 'ɛ t ɾ i t s	m ə n o m 'ə t ɾ i t s
manomètriques	m ə n o m 'ɛ t ɾ i k ə s	m ə n o m 'ə t ɾ i k ə s
marcarem	m ə ɾ k ə ɾ 'ə m	m ə ɾ k ə ɾ 'ɛ m
maridatge	m ə ɾ i ð 'a d ʒ ə	m ə ɾ i ð 'a dʒ ə
marquem	m ə ɾ k 'ə m	m ə ɾ k 'ɛ m
massatge	m ə s 'a d ʒ ə	m ə s 'a dʒ ə
mastegatatxes	m ə s t ə ɣ ə t 'a t ʃ ə s	m ə s t ə ɣ ə t 'a tʃ ə s
matarem	m ə t ə ɾ 'ə m	m ə t ə ɾ 'ɛ m
mateix	m ə t 'e ʃ	m ə t 'ɛ ʃ
matem	m ə t 'ə m	m ə t 'ɛ m
matèria	m ə t 'ɛ ɾ i ə	m ə t 'ə ɾ i ə
Mateu	m ə t 'e w	m ə t 'ɛ w
matxet	m ə t ʃ 'ə t	m ə tʃ 'ə t
matxucar	m ə t ʃ u k 'a	m ə tʃ u k 'a
me	m 'ə	m ə
mecenatge	m ə s ə n 'a d ʒ ə	m ə s ə n 'a dʒ ə
mefistofèlic	m ə f i s t o f 'ɛ l i k	m ə f i s t o f 'ə l i k
melanesi	m ə l ə n 'ɛ z i	m ə l ə n 'ə z i
mem	m 'ə m	m 'ɛ m
membre	m 'e m b ɾ ə	m 'ɛ m b ɾ ə
membres	m 'e m b ɾ ə s	m 'ɛ m b ɾ ə s
mencionarem	m ə n s i o n ə ɾ 'ə m	m ə n s i o n ə ɾ 'ɛ m
mencionem	m ə n s i o n 'ə m	m ə n s i o n 'ɛ m
mencionis	m ə n s i 'ɔ n i s	m ə n s i 'o n i s
mengen	m 'e n ʒ ə n	m 'ə n ʒ ə n
menges	m 'e n ʒ ə s	m 'ə n ʒ ə s
meni	m 'ɛ n i	m 'ə n i
menja	m 'e n ʒ ə	m 'ə n ʒ ə
menjo	m 'e n ʒ o	m 'ə n ʒ o
mentre	m 'e n t ɾ ə	m 'ə n t ɾ ə
merèixer	m ə ɾ 'ə ʃ ə	m ə ɾ 'ɛ ʃ ə
Mèrida	m 'ɛ ɾ i ð ə	m 'ə ɾ i ð ə
mesi	m 'ɛ z i	m 'ə z i
Mèsia	m 'ɛ z i ə	m 'ə z i ə
mesin	m 'ɛ z i n	m 'ə z i n
mesis	m 'ɛ z i s	m 'ə z i s
metem	m ə t 'ə m	m ə t 'ɛ m
metge	m 'e d ʒ ə	m 'ə dʒ ə
metges	m 'e d ʒ ə s	m 'ə dʒ ə s
meti	m 'ɛ t i	m 'ə t i
metin	m 'ɛ t i n	m 'ə t i n
metis	m 'ɛ t i s	m 'ə t i s
metratge	m ə t ɾ 'a d ʒ ə	m ə t ɾ 'a dʒ ə
mètrica	m 'ɛ t ɾ i k ə	m 'ə t ɾ i k ə
mètriques	m 'ɛ t ɾ i k ə s	m 'ə t ɾ i k ə s
metxa	m 'e t ʃ ə	m 'ɛ tʃ ə
meua	m 'e w ə	m 'ə w ə
meus	m 'e w s	m 'ɛ w s
meva	m 'e v ə	m 'ə v ə
meves	m 'e v ə s	m 'ɛ v ə s
miastènia	m i ə s t 'ɛ n i ə	m i ə s t 'ə n i ə
miastènies	m i ə s t 'ɛ n i ə s	m i ə s t 'ə n i ə s
Micronèsia	m i k ɾ o n 'ɛ z i ə	m i k ɾ o n 'ə z i ə
milionèsima	m i l i o n 'ɛ z i m ə	m i l i o n 'ə z i m ə
milotxa	m i l 'ɔ t ʃ ə	m i l 'ɔ tʃ ə
miratge	m i ɾ 'a d ʒ ə	m i ɾ 'a dʒ ə
missatge	m i s 'a d ʒ ə	m i s 'a dʒ ə
missatger	m i s ə d ʒ 'e	m i s ə dʒ 'e
mitges	m 'i d ʒ ə s	m 'i dʒ ə s
mitja	m 'i d ʒ ə	m 'i dʒ ə
mitjana	m i d ʒ 'a n ə	m i dʒ 'a n ə
mitjançant	m i d ʒ ə n s 'a n t	m i dʒ ə n s 'a n t
mitjançar	m i d ʒ ə n s 'a	m i dʒ ə n s 'a
mitjancer	m i d ʒ ə n s 'e	m i dʒ ə n s 'e
mitjanit	m i d ʒ ə n 'i t	m i dʒ ə n 'i t
moc	m 'o k	m 'ɔ k
modèlic	m o ð 'ɛ l i k	m o ð 'ə l i k
modèlica	m o ð 'ɛ l i k ə	m o ð 'ə l i k ə
modèlics	m o ð 'ɛ l i t s	m o ð 'ə l i t s
modèliques	m o ð 'ɛ l i k ə s	m o ð 'ə l i k ə s
modèstia	m o ð 'ɛ s t i ə	m o ð 'ə s t i ə
molècula	m o l 'ə k u l ə	m o l 'ɛ k u l ə
molèstia	m o l 'ɛ s t i ə	m o l 'ə s t i ə
molèsties	m o l 'ɛ s t i ə s	m o l 'ə s t i ə s
molsa	m 'o l s ə	m 'ɔ l s ə
molts	m 'o l s	m 'o l t s
monocroma	m o n o k ɾ 'ɔ m ə	m o n o k ɾ 'o m ə
monocromes	m o n o k ɾ 'ɔ m ə s	m o n o k ɾ 'o m ə s
monofilètic	m o n o f i l 'ɛ t i k	m o n o f i l 'ə t i k
monomètric	m o n o m 'ɛ t ɾ i k	m o n o m 'ə t ɾ i k
monomètrica	m o n o m 'ɛ t ɾ i k ə	m o n o m 'ə t ɾ i k ə
monomètrics	m o n o m 'ɛ t ɾ i t s	m o n o m 'ə t ɾ i t s
monomètriques	m o n o m 'ɛ t ɾ i k ə s	m o n o m 'ə t ɾ i k ə s
Montse	m 'o n s ə	m 'ɔ n s ə
Montsenj	m o n s 'ə ɲ	m o n t s 'ə ɲ
Montserrat	m o n s ə r 'a t	m o n t s ə r 'a t
morfogènic	m o ɾ f o ʒ 'ɛ n i k	m o ɾ f o ʒ 'ə n i k
morro	m 'o r o	m 'ɔ r o
morros	m 'o r o s	m 'ɔ r o s
mort	m 'ɔ ɾ t	m 'o ɾ t
mosca	m 'o s k ə	m 'ɔ s k ə
mosques	m 'o s k ə s	m 'ɔ s k ə s
mosso	m 'o s o	m 'ɔ s o
mostatxo	m o s t 'a t ʃ o	m o s t 'a tʃ o
mostatxut	m o s t ə t ʃ 'u t	m o s t ə tʃ 'u t
mot	m 'o t	m 'ɔ t
motllura	m o ʎ ʎ 'u ɾ ə	m o l l 'u ɾ ə
motllurada	m o ʎ ʎ u ɾ 'a ð ə	m o l l u ɾ 'a ð ə
motllurades	m o ʎ ʎ u ɾ 'a ð ə s	m o l l u ɾ 'a ð ə s
motllurar	m o ʎ ʎ u ɾ 'a	m o l l u ɾ 'a
motllurat	m o ʎ ʎ u ɾ 'a t	m o l l u ɾ 'a t
motllurats	m o ʎ ʎ u ɾ 'a t s	m o l l u ɾ 'a t s
motlura	m o ʎ ʎ 'u ɾ ə	m o t l 'u ɾ ə
motlurada	m o l l u ɾ 'a ð ə	m o t l u ɾ 'a ð ə
motlurades	m o l l u ɾ 'a ð ə s	m o t l u ɾ 'a ð ə s
motlurar	m o l l u ɾ 'a	m o t l u ɾ 'a
motlurat	m o l l u ɾ 'a t	m o t l u ɾ 'a t
motlurats	m o l l u ɾ 'a t s	m o t l u ɾ 'a t s
moto	m 'o t o	m 'ɔ t o
motos	m 'o t o s	m 'ɔ t o s
motxo	m 'ɔ t ʃ o	m 'ɔ tʃ o
mudèjar	m u ð 'ə ʒ ə	m u ð 'ɛ ʒ ə
multarem	m u l t ə ɾ 'ə m	m u l t ə ɾ 'ɛ m
multem	m u l t 'ə m	m u l t 'ɛ m
muntatge	m u n t 'a d ʒ ə	m u n t 'a dʒ ə
Muntènia	m u n t 'ɛ n i ə	m u n t 'ə n i ə
Mutxamel	m u t ʃ ə m 'ɛ l	m u tʃ ə m 'ɛ l
natja	n 'a d ʒ ə	n 'a dʒ ə
natjada	n ə d ʒ 'a ð ə	n ə dʒ 'a ð ə
natjar	n ə d ʒ 'a	n ə dʒ 'a
neboda	n ə β 'o ð ə	n ə β 'ɔ ð ə
nebot	n ə β 'o t	n ə β 'ɔ t
neda	n 'e ð ə	n 'ə ð ə
neden	n 'e ð ə n	n 'ɛ ð ə n
nedes	n 'e ð ə s	n 'ə ð ə s
nega	n 'e ɣ ə	n 'ə ɣ ə
negligència	n ə ɣ l i ʒ 'ɛ n s i ə	n ə ɣ l i ʒ 'ə n s i ə
neguem	n ə ɣ 'ə m	n ə ɣ 'ɛ m
neguen	n 'e ɣ ə n	n 'ə ɣ ə n
negues	n 'e ɣ ə s	n 'ə ɣ ə s
nens	n 'ə n s	n 'e n s
neurastènia	n ə w ɾ ə s t 'ɛ n i ə	n ə w ɾ ə s t 'ə n i ə
neva	n 'e v ə	n 'ə v ə
nicens	n i s 'ə n s	n i s 'e n s
nimfea	n i m f 'ɛ ə	n i m f 'e ə
nombre	n 'o m b ɾ ə	n 'ɔ m b ɾ ə
nombres	n 'o m b ɾ ə s	n 'ɔ m b ɾ ə s
Nombres	n 'o m b ɾ ə s	n 'ɔ m b ɾ ə s
nores	n 'ɔ ɾ ə s	n 'o ɾ ə s
novembre	n o v 'e m b ɾ ə	n o v 'ɛ m b ɾ ə
numèrica	n u m 'ɛ ɾ i k ə	n u m 'ə ɾ i k ə
numèriques	n u m 'ɛ ɾ i k ə s	n u m 'ə ɾ i k ə s
o	'ɔ	'o
obediència	o β ə ð i 'ɛ n s i ə	o β ə ð i 'ə n s i ə
odissea	o ð i s 'ɛ ə	o ð i s 'e ə
ofegarem	o f ə ɣ ə ɾ 'ə m	o f ə ɣ ə ɾ 'ɛ m
ofeguem	o f ə ɣ 'ə m	o f ə ɣ 'ɛ m
Oltènia	o l t 'ɛ n i ə	o l t 'ə n i ə
ombra	'o m b ɾ ə	'ɔ m b ɾ ə
ombratge	o m b ɾ 'a d ʒ ə	o m b ɾ 'a dʒ ə
ombres	'o m b ɾ ə s	'ɔ m b ɾ ə s
omple	'o m p l ə	'ɔ m p l ə
omplen	'o m p l ə n	'ɔ m p l ə n
omples	'o m p l ə s	'ɔ m p l ə s
omplo	'o m p l o	'ɔ m p l o
oncle	'o ŋ k l ə	'ɔ ŋ k l ə
oncles	'o ŋ k l ə s	'ɔ ŋ k l ə s
onzes	'o n z ə s	'ɔ n z ə s
opta	'o t t ə	'ɔ t t ə
opten	'o t t ə n	'ɔ t t ə n
opto	'o t t o	'ɔ t t o
opulència	o p u l 'ɛ n s i ə	o p u l 'ə n s i ə
oratge	o ɾ 'a d ʒ ə	o ɾ 'a dʒ ə
oratjós	o ɾ ə d ʒ 'o s	o ɾ ə dʒ 'o s
orca	'o ɾ k ə	'ɔ ɾ k ə
orde	'o ɾ ð ə	'ɔ ɾ ð ə
ordes	'o ɾ ð ə s	'ɔ ɾ ð ə s
ordre	'o ɾ ð ɾ ə	'ɔ ɾ ð ɾ ə
ordres	'o ɾ ð ɾ ə s	'ɔ ɾ ð ɾ ə s
orella	o ɾ 'ə ʎ ə	o ɾ 'e ʎ ə
ornament	o ɾ n ə m 'e n t	ɔ ɾ n ə m 'e n t
orques	'o ɾ k ə s	'ɔ ɾ k ə s
ortodoxa	o ɾ t o ð 'o t s ə	o ɾ t o ð 'ɔ t s ə
ortopèdic	o ɾ t o p 'ɛ ð i k	o ɾ t o p 'ə ð i k
osmomètric	o z m o m 'ɛ t ɾ i k	o z m o m 'ə t ɾ i k
osmomètrica	o z m o m 'ɛ t ɾ i k ə	o z m o m 'ə t ɾ i k ə
osmomètrics	o z m o m 'ɛ t ɾ i t s	o z m o m 'ə t ɾ i t s
osmomètriques	o z m o m 'ɛ t ɾ i k ə s	o z m o m 'ə t ɾ i k ə s
ostatge	o s t 'a d ʒ ə	o s t 'a dʒ ə
ou	'ɔ w	'o w
ovella	o v 'ə ʎ ə	o v 'e ʎ ə
ovelles	o v 'ə ʎ ə s	o v 'e ʎ ə s
paciència	p ə s i 'ɛ n s i ə	p ə s i 'ə n s i ə
paisatge	p ə j z 'a d ʒ ə	p ə j z 'a dʒ ə
Palència	p ə l 'ɛ n s i ə	p ə l 'ə n s i ə
pandèmic	p ə n d 'ɛ m i k	p ə n d 'ə m i k
pandèmica	p ə n d 'ɛ m i k ə	p ə n d 'ə m i k ə
pandèmics	p ə n d 'ɛ m i t s	p ə n d 'ə m i t s
pandèmiques	p ə n d 'ɛ m i k ə s	p ə n d 'ə m i k ə s
pandemoni	p ə n d ə m 'ɔ n i	p ə n d ə m 'o n i
panotxo	p ə n 'ɔ t ʃ o	p ə n 'ɔ tʃ o
parafilètic	p ə ɾ ə f i l 'ɛ t i k	p ə ɾ ə f i l 'ə t i k
paranoic	p ə ɾ ə n 'ɔ j k	p ə ɾ ə n 'o i k
pararem	p ə ɾ ə ɾ 'ə m	p ə ɾ ə ɾ 'ɛ m
paratge	p ə ɾ 'a d ʒ ə	p ə ɾ 'a dʒ ə
parell	p ə ɾ 'ə ʎ	p ə ɾ 'e ʎ
parella	p ə ɾ 'ə ʎ ə	p ə ɾ 'e ʎ ə
parem	p ə ɾ 'ə m	p ə ɾ 'ɛ m
parèntesi	p ə ɾ 'ɛ n t ə z i	p ə ɾ 'ə n t ə z i
parer	p ə ɾ 'ə	p ə ɾ 'e
parlarem	p ə ɾ l ə ɾ 'ə m	p ə ɾ l ə ɾ 'ɛ m
parlem	p ə ɾ l 'ə m	p ə ɾ l 'ɛ m
parlessin	p ə ɾ l 'e s i n	p ə ɾ l 'ə s i n
partirem	p ə ɾ t i ɾ 'ə m	p ə ɾ t i ɾ 'ɛ m
passaport	p ə s ə p 'ɔ ɾ t	p ə s ə p 'o ɾ t
passaports	p ə s ə p 'ɔ ɾ s	p ə s ə p 'o ɾ t s
passatge	p ə s 'a d ʒ ə	p ə s 'a dʒ ə
passatger	p ə s ə d ʒ 'e	p ə s ə dʒ 'e
pastitx	p ə s t 'i t ʃ	p ə s t 'i tʃ
pastitxo	p ə s t 'i t ʃ o	p ə s t 'i tʃ o
patatxap	p ə t ə t ʃ 'a p	p ə t ə tʃ 'a p
patinatge	p ə t i n 'a d ʒ ə	p ə t i n 'a dʒ ə
patrimoni	p ə t ɾ i m 'ɔ n i	p ə t ɾ i m 'o n i
patrocinarem	p ə t ɾ o s i n ə ɾ 'ə m	p ə t ɾ o s i n ə ɾ 'ɛ m
patrocinem	p ə t ɾ o s i n 'ə m	p ə t ɾ o s i n 'ɛ m
patronatge	p ə t ɾ o n 'a d ʒ ə	p ə t ɾ o n 'a dʒ ə
peatge	p e 'a d ʒ ə	p e 'a dʒ ə
pedra	p 'e ð ɾ ə	p 'ə ð ɾ ə
pedres	p 'e ð ɾ ə s	p 'ə ð ɾ ə s
pegarem	p ə ɣ ə ɾ 'ə m	p ə ɣ ə ɾ 'ɛ m
pego	p 'e ɣ o	p 'ə ɣ o
peguem	p ə ɣ 'ə m	p ə ɣ 'ɛ m
peguen	p 'e ɣ ə n	p 'ə ɣ ə n
peix	p 'e ʃ	p 'ɛ ʃ
peixos	p 'e ʃ o s	p 'ɛ ʃ o s
pèl	p 'ə l	p 'ɛ l
pelatge	p ə l 'a d ʒ ə	p ə l 'a dʒ ə
pelegrinatge	p ə l ə ɣ ɾ i n 'a d ʒ ə	p ə l ə ɣ ɾ i n 'a dʒ ə
peloponesi	p ə l o p o n 'ɛ z i	p ə l o p o n 'ə z i
pendeloc	p ə n d ə l 'o k	p ə n d ə l 'ɔ k
penetra	p ə n 'e t ɾ ə	p ə n 'ə t ɾ ə
pengen	p 'e n ʒ ə n	p 'ə n ʒ ə n
penges	p 'e n ʒ ə s	p 'ə n ʒ ə s
penja	p 'e n ʒ ə	p 'ə n ʒ ə
penombra	p ə n 'o m b ɾ ə	p ə n 'ɔ m b ɾ ə
pens	p 'ə n s	p 'e n s
pensi	p 'ɛ n s i	p 'ə n s i
pensin	p 'ɛ n s i n	p 'ə n s i n
pensis	p 'ɛ n s i s	p 'ə n s i s
pequem	p ə k 'ə m	p ə k 'ɛ m
pequen	p 'e k ə n	p 'ɛ k ə n
pera	p 'ə ɾ ə	p 'e ɾ ə
percentatge	p ə ɾ s ə n t 'a d ʒ ə	p ə ɾ s ə n t 'a dʒ ə
Pere	p 'e ɾ ə	p 'ə ɾ ə
perenne	p ə ɾ 'e n n ə	p ə ɾ 'ə n n ə
peres	p 'ə ɾ ə s	p 'e ɾ ə s
perfecte	p ə ɾ f 'ɛ t t ə	p ə ɾ f 'ə t t ə
perfectes	p ə ɾ f 'ɛ t t ə s	p ə ɾ f 'ə t t ə s
perifèric	p ə ɾ i f 'ɛ ɾ i k	p ə ɾ i f 'ə ɾ i k
pèrita	p 'ɛ ɾ i t ə	p 'ə ɾ i t ə
peritatge	p ə ɾ i t 'a d ʒ ə	p ə ɾ i t 'a dʒ ə
peritatges	p ə ɾ i t 'a d ʒ ə s	p ə ɾ i t 'a dʒ ə s
pèrites	p 'ɛ ɾ i t ə s	p 'ə ɾ i t ə s
perles	p 'ɛ ɾ l ə s	p 'ə ɾ l ə s
permanència	p ə ɾ m ə n 'ɛ n s i ə	p ə ɾ m ə n 'ə n s i ə
perpetu	p ə ɾ p 'ɛ t u	p ə ɾ p 'ə t u
perses	p 'ɛ ɾ s ə s	p 'ə ɾ s ə s
personatge	p ə ɾ s o n 'a d ʒ ə	p ə ɾ s o n 'a dʒ ə
perxes	p 'ɛ ɾ ʃ ə s	p 'ɛ ɾ s ə s
pesa	p 'e z ə	p 'ə z ə
pesen	p 'e z ə n	p 'ə z ə n
peses	p 'e z ə s	p 'ə z ə s
pesin	p 'ɛ z i n	p 'ə z i n
pesis	p 'ɛ z i s	p 'ə z i s
pessebre	p ə s 'e β ɾ ə	p ə s 'ə β ɾ ə
pestilència	p ə s t i l 'ɛ n s i ə	p ə s t i l 'ə n s i ə
petges	p 'e d ʒ ə s	p 'ə dʒ ə s
peti	p 'ɛ t i	p 'ə t i
petin	p 'ɛ t i n	p 'ə t i n
petis	p 'ɛ t i s	p 'ə t i s
petja	p 'e d ʒ ə	p 'ə dʒ ə
petjada	p ə d ʒ 'a ð ə	p ə dʒ 'a ð ə
petjar	p ə d ʒ 'a	p ə dʒ 'a
petxina	p ə t ʃ 'i n ə	p ə tʃ 'i n ə
picarem	p i k ə ɾ 'ə m	p i k ə ɾ 'ɛ m
pistatxo	p i s t 'a t ʃ o	p i s t 'a tʃ o
pitjar	p i d ʒ 'a	p i dʒ 'a
pitjor	p i d ʒ 'o	p i dʒ 'o
pitxolí	p i t ʃ o l 'i	p i tʃ o l 'i
plaer	p l ə 'ə	p l ə 'e
plantatge	p l ə n t 'a d ʒ ə	p l ə n t 'a dʒ ə
platja	p l 'a d ʒ ə	p l 'a dʒ ə
platjola	p l ə d ʒ 'ɔ l ə	p l ə dʒ 'ɔ l ə
plegatge	p l ə ɣ 'a d ʒ ə	p l ə ɣ 'a dʒ ə
plens	p l 'ə n s	p l 'e n s
pliocènic	p l i o s 'ɛ n i k	p l i o s 'ə n i k
pliocènica	p l i o s 'ɛ n i k ə	p l i o s 'ə n i k ə
pliocènics	p l i o s 'ɛ n i t s	p l i o s 'ə n i t s
pliocèniques	p l i o s 'ɛ n i k ə s	p l i o s 'ə n i k ə s
plomatge	p l o m 'a d ʒ ə	p l o m 'a dʒ ə
plomatges	p l o m 'a d ʒ ə s	p l o m 'a dʒ ə s
plomo	p l 'o m o	p l 'ɔ m o
plores	p l 'ɔ ɾ ə s	p l 'o ɾ ə s
pneumàtic	n ə w m 'a t i k	n n ə w m 'a t i k
pneumàtica	n ə w m 'a t i k ə	n n ə w m 'a t i k ə
pneumàtics	n ə w m 'a t i t s	n n ə w m 'a t i t s
pneumònia	n ə w m 'ɔ n i ə	n n ə w m 'ɔ n i ə
poètic	p o 'ɛ t i k	p o 'ə t i k
polèmic	p o l 'ɛ m i k	p o l 'ə m i k
poligènica	p o l i ʒ 'ɛ n i k ə	p o l i ʒ 'ə n i k ə
poligènics	p o l i ʒ 'ɛ n i t s	p o l i ʒ 'ə n i t s
poligèniques	p o l i ʒ 'ɛ n i k ə s	p o l i ʒ 'ə n i k ə s
polinesi	p o l i n 'ɛ z i	p o l i n 'ə z i
Polinèsia	p o l i n 'ɛ z i ə	p o l i n 'ə z i ə
politja	p o l 'i d ʒ ə	p o l 'i dʒ ə
polla	p 'o ʎ ə	p 'ɔ ʎ ə
poloni	p o l 'ɔ n i	p o l 'o n i
polpa	p 'o l p ə	p 'ɔ l p ə
poltre	p 'o l t ɾ ə	p 'ɔ l t ɾ ə
polze	p 'o l z ə	p 'ɔ l z ə
poncem	p o n s 'ə m	p o n s 'ɛ m
ponsètia	p o n s 'ɛ t i ə	p o n s 'ə t i ə
porpra	p 'o ɾ p ɾ ə	p 'ɔ ɾ p ɾ ə
porro	p 'o r o	p 'ɔ r o
porros	p 'o r o s	p 'ɔ r o s
port	p 'ɔ ɾ t	p 'o ɾ t
potatge	p o t 'a d ʒ ə	p o t 'a dʒ ə
potència	p o t 'ɛ n s i ə	p o t 'ə n s i ə
precepte	p ɾ ə s 'ɛ t t ə	p ɾ ə s 'ə t t ə
prefecte	p ɾ ə f 'ɛ t t ə	p ɾ ə f 'ə t t ə
prefix	p ɾ ə f 'i t s	p ɾ ə f 'i ʃ
prega	p ɾ 'e ɣ ə	p ɾ 'ə ɣ ə
prego	p ɾ 'e ɣ o	p ɾ 'ə ɣ o
premiarem	p ɾ ə m i ə ɾ 'ə m	p ɾ ə m i ə ɾ 'ɛ m
premiem	p ɾ ə m i 'ə m	p ɾ ə m i 'ɛ m
premsa	p ɾ 'e n s ə	p ɾ 'ɛ n s ə
prens	p ɾ 'ə n s	p ɾ 'e n s
prepararem	p ɾ ə p ə ɾ ə ɾ 'ə m	p ɾ ə p ə ɾ ə ɾ 'ɛ m
preparem	p ɾ ə p ə ɾ 'ə m	p ɾ ə p ə ɾ 'ɛ m
presciència	p ɾ ə t s i 'ɛ n s i ə	p ɾ ə t s i 'ə n s i ə
presència	p ɾ ə z 'ɛ n s i ə	p ɾ ə z 'ə n s i ə
presidència	p ɾ ə z i ð 'ɛ n s i ə	p ɾ ə z i ð 'ə n s i ə
presta	p ɾ 'e s t ə	p ɾ 'ə s t ə
prestarem	p ɾ ə s t ə ɾ 'ə m	p ɾ ə s t ə ɾ 'ɛ m
prestatge	p ɾ ə s t 'a d ʒ ə	p ɾ ə s t 'a dʒ ə
prestatgeria	p ɾ ə s t ə d ʒ ə ɾ 'i ə	p ɾ ə s t ə dʒ ə ɾ 'i ə
prestem	p ɾ ə s t 'ə m	p ɾ ə s t 'ɛ m
presten	p ɾ 'e s t ə n	p ɾ 'ə s t ə n
prestes	p ɾ 'e s t ə s	p ɾ 'ə s t ə s
presto	p ɾ 'e s t o	p ɾ 'ə s t o
presumpció	p ɾ ə z u m s i 'o	p ɾ ə z u m t s i 'o
pretendre	p ɾ ə t 'e n d ɾ ə	p ɾ ə t 'ə n d ɾ ə
pretèrit	p ɾ ə t 'ɛ ɾ i t	p ɾ ə t 'ə ɾ i t
primogènit	p ɾ i m o ʒ 'ɛ n i t	p ɾ i m o ʒ 'ə n i t
procedència	p ɾ o s ə ð 'ɛ n s i ə	p ɾ o s ə ð 'ə n s i ə
procurarem	p ɾ o k u ɾ ə ɾ 'ə m	p ɾ o k u ɾ ə ɾ 'ɛ m
procurem	p ɾ o k u ɾ 'ə m	p ɾ o k u ɾ 'ɛ m
progènie	p ɾ o ʒ 'ɛ n i ə	p ɾ o ʒ 'ə n i ə
projecte	p ɾ o ʒ 'ɛ t t ə	p ɾ o ʒ 'ə t t ə
prona	p ɾ 'ɔ n ə	p ɾ 'o n ə
prones	p ɾ 'ɔ n ə s	p ɾ 'o n ə s
pronunciarem	p ɾ o n u n s i ə ɾ 'ə m	p ɾ o n u n s i ə ɾ 'ɛ m
pronunciem	p ɾ o n u n s i 'ə m	p ɾ o n u n s i 'ɛ m
prosceni	p ɾ o t s 'ɛ n i	p ɾ o t s 'ə n i
protesta	p ɾ o t 'e s t ə	p ɾ o t 'ə s t ə
Prudència	p ɾ u ð 'ɛ n s i ə	p ɾ u ð 'ə n s i ə
prudència	p ɾ u ð 'ɛ n s i ə	p ɾ u ð 'ə n s i ə
punirem	p u n i ɾ 'ə m	p u n i ɾ 'ɛ m
quadragèsim	k w ə ð ɾ ə ʒ 'ɛ z i m	k w ə ð ɾ ə ʒ 'ə z i m
queixa	k 'e ʃ ə	k 'ɛ ʃ ə
queixo	k 'e ʃ o	k 'ɛ ʃ o
quilomètric	k i l o m 'ɛ t ɾ i k	k i l o m 'ə t ɾ i k
quítxua	k 'i t ʃ u ə	k 'i tʃ u ə
racèmic	r ə s 'ɛ m i k	r ə s 'ə m i k
radiomètric	r ə ð i o m 'ɛ t ɾ i k	r ə ð i o m 'ə t ɾ i k
radiomètrica	r ə ð i o m 'ɛ t ɾ i k ə	r ə ð i o m 'ə t ɾ i k ə
radiomètrics	r ə ð i o m 'ɛ t ɾ i t s	r ə ð i o m 'ə t ɾ i t s
radiomètriques	r ə ð i o m 'ɛ t ɾ i k ə s	r ə ð i o m 'ə t ɾ i k ə s
ratlla	r 'a ʎ ʎ ə	r 'a l l ə
ratllador	r ə ʎ ʎ ə ð 'o	r ə l l ə ð 'o
ratllar	r ə ʎ ʎ 'a	r ə l l 'a
ratxa	r 'a t ʃ ə	r 'a tʃ ə
ratxada	r ə t ʃ 'a ð ə	r ə tʃ 'a ð ə
ratxar	r ə t ʃ 'a	r ə tʃ 'a
ratxós	r ə t ʃ 'o s	r ə tʃ 'o s
re	r 'ə	r ə
reaparèixer	r e ə p ə ɾ 'ə ʃ ə	r e ə p ə ɾ 'ɛ ʃ ə
rebuig	r ə β 'u t ʃ	r ə β 'u tʃ
rebutjada	r ə β u d ʒ 'a ð ə	r ə β u dʒ 'a ð ə
rebutjades	r ə β u d ʒ 'a ð ə s	r ə β u dʒ 'a ð ə s
rebutjar	r ə β u d ʒ 'a	r ə β u dʒ 'a
rebutjat	r ə β u d ʒ 'a t	r ə β u dʒ 'a t
rebutjats	r ə β u d ʒ 'a t s	r ə β u dʒ 'a t s
rebutjos	r ə β 'u d ʒ o s	r ə β 'u dʒ o s
reca	r 'e k ə	r 'ɛ k ə
recepta	r ə s 'ɛ t t ə	r ə s 'ə t t ə
recerca	r ə s 'ɛ ɾ k ə	r ə s 'ə ɾ k ə
reciclatge	r ə s i k l 'a d ʒ ə	r ə s i k l 'a dʒ ə
recompte	r ə k 'o m t ə	r ə k 'ɔ m t ə
reconèixer	r ə k o n 'ə ʃ ə	r ə k o n 'ɛ ʃ ə
recorre	r ə k 'o r ə	r ə k 'ɔ r ə
rees	r 'ɛ ə s	r 'e ə s
refet	r ə f 'e t	r ə f 'ə t
refeta	r ə f 'e t ə	r ə f 'ə t ə
reforma	r ə f 'o ɾ m ə	r ə f 'ɔ ɾ m ə
refulgència	r ə f u l ʒ 'ɛ n s i ə	r ə f u l ʒ 'ə n s i ə
règim	r 'ə ʒ i m	r 'ɛ ʒ i m
regla	r 'e g g l ə	r 'ə ɣ l ə
regles	r 'e g g l ə s	r 'ə ɣ l ə s
regna	r 'e n n ə	r 'ə n n ə
regne	r 'e n n ə	r 'ə n n ə
regnen	r 'e n n ə n	r 'ə n n ə n
regnes	r 'e n n ə s	r 'ə n n ə s
reixa	r 'e ʃ ə	r 'ɛ ʃ ə
rella	r 'ə ʎ ə	r 'e ʎ ə
relles	r 'ə ʎ ə s	r 'e ʎ ə s
relleu	r ə ʎ 'e w	r ə ʎ 'ɛ w
rem	r 'ə m	r 'ɛ m
remarem	r ə m ə ɾ 'ə m	r ə m ə ɾ 'ɛ m
remem	r ə m 'ə m	r ə m 'ɛ m
remo	r 'e m o	r 'ɛ m o
remolatxa	r ə m o l 'a t ʃ ə	r ə m o l 'a tʃ ə
renda	r 'e n d ə	r 'ə n d ə
rendes	r 'e n d ə s	r 'ə n d ə s
renebot	r ə n ə β 'o t	r ə n ə β 'ɔ t
renec	r ə n 'e k	r ə n 'ɛ k
renou	r ə n 'ɔ w	r ə n 'o w
renten	r 'e n t ə n	r 'ə n t ə n
repararem	r ə p ə ɾ ə ɾ 'ə m	r ə p ə ɾ ə ɾ 'ɛ m
reparem	r ə p ə ɾ 'ə m	r ə p ə ɾ 'ɛ m
reprotxar	r ə p ɾ o t ʃ 'a	r ə p ɾ o tʃ 'a
reprotxe	r ə p ɾ 'ɔ t ʃ ə	r ə p ɾ 'ɔ tʃ ə
repte	r 'ɛ t t ə	r 'ə t t ə
rere	r 'e ɾ ə	r 'ə ɾ ə
resa	r 'e z ə	r 'ə z ə
resclosa	r ə s k l 'ɔ z ə	r ə s k l 'o z ə
resen	r 'e z ə n	r 'ə z ə n
residència	r ə z i ð 'ɛ n s i ə	r ə z i ð 'ə n s i ə
resiliència	r ə z i l i 'ɛ n s i ə	r ə z i l i 'ə n s i ə
resistència	r ə z i s t 'ɛ n s i ə	r ə z i s t 'ə n s i ə
reso	r 'e z o	r 'ə z o
respatller	r ə s p ə ʎ ʎ 'e	r ə s p ə l l 'e
respatler	r ə s p ə l l 'e	r ə s p ə t l 'e
resquitllar	r ə s k i ʎ ʎ 'a	r ə s k i l l 'a
resta	r 'e s t ə	r 'ə s t ə
restaurarem	r ə s t ə w ɾ ə ɾ 'ə m	r ə s t ə w ɾ ə ɾ 'ɛ m
restaurem	r ə s t ə w ɾ 'ə m	r ə s t ə w ɾ 'ɛ m
resten	r 'e s t ə n	r 'ə s t ə n
restes	r 'e s t ə s	r 'ə s t ə s
reticència	r ə t i s 'ɛ n s i ə	r ə t i s 'ə n s i ə
reverència	r ə v ə ɾ 'ɛ n s i ə	r ə v ə ɾ 'ə n s i ə
reverend	r ə v ə ɾ 'e n t	r ə v ə ɾ 'ə n t
revetlla	r ə v 'e ʎ ʎ ə	r ə v 'ə l l ə
revetla	r ə v 'e l l ə	r ə v 'ə ʎ ə
rèvola	r 'ɛ v o l ə	r 'ə v o l ə
Ribagorça	r i β ə ɣ 'o ɾ s ə	r i β ə ɣ 'ɔ ɾ s ə
ribatge	r i β 'a d ʒ ə	r i β 'a dʒ ə
rodatge	r o ð 'a d ʒ ə	r o ð 'a dʒ ə
rombe	r 'o m b ə	r 'ɔ m b ə
rombes	r 'o m b ə s	r 'ɔ m b ə s
romiatge	r o m i 'a d ʒ ə	r o m i 'a dʒ ə
rompre	r 'o m p ɾ ə	r 'ɔ m p ɾ ə
ronca	r 'o ŋ k ə	r 'ɔ ŋ k ə
ronda	r 'o n d ə	r 'ɔ n d ə
rondes	r 'o n d ə s	r 'ɔ n d ə s
rossos	r 'o s o s	r 'ɔ s o s
rotllada	r o ʎ ʎ 'a ð ə	r o l l 'a ð ə
rotlle	r 'ɔ ʎ ʎ ə	r 'ɔ l l ə
rotlles	r 'ɔ ʎ ʎ ə s	r 'ɔ l l ə s
rotlada	r o l l 'a ð ə	r o t l 'a ð ə
rotle	r 'ɔ l l ə	r 'ɔ l ə
rotles	r 'ɔ l l ə s	r 'ɔ t l ə s
rotonda	r o t 'o n d ə	r o t 'ɔ n d ə
roure	r 'o w ɾ ə	r 'ɔ w ɾ ə
rovell	r o v 'ə ʎ	r o v 'e ʎ
sa	s 'ə	s ə
saber	s ə β 'ə	s ə β 'e
sabotatge	s ə β o t 'a d ʒ ə	s ə β o t 'a dʒ ə
sacabutx	s ə k ə β 'u t ʃ	s ə k ə β 'u tʃ
sahrauí	s ə ɾ ə w 'i	s ə r ə w 'i
salsitxa	s ə l s 'i t ʃ ə	s ə l s 'i tʃ ə
salsitxaire	s ə l s i t ʃ 'a j ɾ ə	s ə l s i tʃ 'a j ɾ ə
salvatge	s ə l v 'a d ʒ ə	s ə l v 'a dʒ ə
salvatges	s ə l v 'a d ʒ ə s	s ə l v 'a dʒ ə s
salvatjada	s ə l v ə d ʒ 'a ð ə	s ə l v ə dʒ 'a ð ə
sancionin	s ə n s i 'ɔ n i n	s ə n s i 'o n i n
sanglot	s ə ŋ g l 'o t	s ə ŋ g l 'ɔ t
sastressa	s ə s t ɾ 'ə s ə	s ə s t ɾ 'e s ə
saturarem	s ə t u ɾ ə ɾ 'ə m	s ə t u ɾ ə ɾ 'ɛ m
saturem	s ə t u ɾ 'ə m	s ə t u ɾ 'ɛ m
sega	s 'e ɣ ə	s 'ə ɣ ə
segrest	s ə ɣ ɾ 'e s t	s ə ɣ ɾ 'ɛ s t
seitó	s ə j t 'o	s ə i t 'o
sembra	s 'e m b ɾ ə	s 'ɛ m b ɾ ə
semestre	s ə m 'e s t ɾ ə	s ə m 'ə s t ɾ ə
seminoma	s ə m i n 'ɔ m ə	s ə m i n 'o m ə
seminomes	s ə m i n 'ɔ m ə s	s ə m i n 'o m ə s
sempre	s 'e m p ɾ ə	s 'ɛ m p ɾ ə
senda	s 'e n d ə	s 'ə n d ə
sens	s 'ə n s	s 'e n s
sense	s 'e n s ə	s 'ə n s ə
senten	s 'e n t ə n	s 'ə n t ə n
sentència	s ə n t 'ɛ n s i ə	s ə n t 'ə n s i ə
sento	s 'e n t o	s 'ɛ n t o
separarem	s ə p ə ɾ ə ɾ 'ə m	s ə p ə ɾ ə ɾ 'ɛ m
separem	s ə p ə ɾ 'ə m	s ə p ə ɾ 'ɛ m
sèrie	s 'ɛ ɾ i ə	s 'ə ɾ i ə
serrarem	s ə r ə ɾ 'ə m	s ə r ə ɾ 'ɛ m
serrem	s ə r 'ə m	s ə r 'ɛ m
setembre	s ə t 'e m b ɾ ə	s ə t 'ɛ m b ɾ ə
setge	s 'e d ʒ ə	s 'ə dʒ ə
setges	s 'e d ʒ ə s	s 'ə dʒ ə s
seua	s 'e w ə	s 'ə w ə
seva	s 'e v ə	s 'ə v ə
seves	s 'e v ə s	s 'ə v ə s
siboc	s i β 'o k	s i β 'ɔ k
significarem	s i n n i f i k ə ɾ 'ə m	s i n n i f i k ə ɾ 'ɛ m
Silèsia	s i l 'ɛ z i ə	s i l 'ə z i ə
simplificarem	s i m p l i f i k ə ɾ 'ə m	s i m p l i f i k ə ɾ 'ɛ m
simplifiquem	s i m p l i f i k 'ə m	s i m p l i f i k 'ɛ m
sinagoga	s i n ə ɣ 'o ɣ ə	s i n ə ɣ 'ɔ ɣ ə
sinestèsia	s i n ə s t 'ɛ z i ə	s i n ə s t 'ə z i ə
sintètica	s i n t 'ɛ t i k ə	s i n t 'ə t i k ə
sintètiques	s i n t 'ɛ t i k ə s	s i n t 'ə t i k ə s
sistema	s i s t 'e m ə	s i s t 'ɛ m ə
Sitges	s 'i d ʒ ə s	s 'i dʒ ə s
sitgetà	s i d ʒ ə t 'a	s i dʒ ə t 'a
sitja	s 'i d ʒ ə	s 'i dʒ ə
sobre	s 'o β ɾ ə	s 'ɔ β ɾ ə
sobta	s 'o t t ə	s 'ɔ t t ə
sofre	s 'o f ɾ ə	s 'ɔ f ɾ ə
solarem	s o l ə ɾ 'ə m	s o l ə ɾ 'ɛ m
solatge	s o l 'a d ʒ ə	s o l 'a dʒ ə
solell	s o l 'ə ʎ	s o l 'e ʎ
solem	s o l 'ə m	s o l 'ɛ m
solquen	s 'o l k ə n	s 'ɔ l k ə n
sonda	s 'o n d ə	s 'ɔ n d ə
sondes	s 'o n d ə s	s 'ɔ n d ə s
sones	s 'ɔ n ə s	s 'o n ə s
sopa	s 'o p ə	s 'ɔ p ə
sopen	s 'o p ə n	s 'ɔ p ə n
sopes	s 'o p ə s	s 'ɔ p ə s
sorda	s 'o ɾ ð ə	s 'ɔ ɾ ð ə
sordes	s 'o ɾ ð ə s	s 'ɔ ɾ ð ə s
sorna	s 'o ɾ n ə	s 'ɔ ɾ n ə
sostre	s 'o s t ɾ ə	s 'ɔ s t ɾ ə
sostres	s 'o s t ɾ ə s	s 'ɔ s t ɾ ə s
sota	s 'o t ə	s 'ɔ t ə
sotgen	s 'ɔ d ʒ ə n	s 'ɔ dʒ ə n
sotges	s 'ɔ d ʒ ə s	s 'ɔ dʒ ə s
sotjar	s o d ʒ 'a	s o dʒ 'a
sotjo	s 'ɔ d ʒ o	s 'ɔ dʒ o
sous	s 'ɔ w s	s 'o w s
soviètica	s o v i 'ɛ t i k ə	s o v i 'ə t i k ə
suarem	s u ə ɾ 'ə m	s u ə ɾ 'ɛ m
subratllades	s u β ɾ ə l ʎ ʎ 'a ð ə s	s u β ɾ ə l l 'a ð ə s
subsistència	s u t s i s t 'ɛ n s i ə	s u t s i s t 'ə n s i ə
subsistències	s u t s i s t 'ɛ n s i ə s	s u t s i s t 'ə n s i ə s
suem	s u 'ə m	s u 'ɛ m
suficiència	s u f i s i 'ɛ n s i ə	s u f i s i 'ə n s i ə
suport	s u p 'ɔ ɾ t	s u p 'o ɾ t
suprem	s u p ɾ 'ə m	s u p ɾ 'ɛ m
sutge	s 'u d ʒ ə	s 'u dʒ ə
tacarem	t ə k ə ɾ 'ə m	t ə k ə ɾ 'ɛ m
tadjik	t ə d ʒ 'i k	t ə dʒ 'i k
tanmateix	t ə m m ə t 'e ʃ	t ə m m ə t 'ɛ ʃ
tanoca	t ə n 'o k ə	t ə n 'ɔ k ə
taquem	t ə k 'ə m	t ə k 'ɛ m
taquimètric	t ə k i m 'ɛ t ɾ i k	t ə k i m 'ə t ɾ i k
tatuatge	t ə t u 'a d ʒ ə	t ə t u 'a dʒ ə
tatxa	t 'a t ʃ ə	t 'a tʃ ə
tatxes	t 'a t ʃ ə s	t 'a tʃ ə s
tatxonar	t ə t ʃ o n 'a	t ə tʃ o n 'a
tèbia	t 'ə β i ə	t 'ɛ β i ə
tecla	t 'e k l ə	t 'ɛ k l ə
tecles	t 'e k l ə s	t 'ɛ k l ə s
teix	t 'e ʃ	t 'ɛ ʃ
tema	t 'e m ə	t 'ɛ m ə
temen	t 'e m ə n	t 'ɛ m ə n
temes	t 'e m ə s	t 'ɛ m ə s
temo	t 'e m o	t 'ɛ m o
tempesta	t ə m p 'e s t ə	t ə m p 'ə s t ə
templa	t 'e m p l ə	t 'ɛ m p l ə
temple	t 'e m p l ə	t 'ɛ m p l ə
temples	t 'e m p l ə s	t 'ɛ m p l ə s
tenda	t 'e n d ə	t 'ə n d ə
tendència	t ə n d 'ɛ n s i ə	t ə n d 'ə n s i ə
tendes	t 'e n d ə s	t 'ə n d ə s
tenebra	t ə n 'e β ɾ ə	t ə n 'ə β ɾ ə
tenebres	t ə n 'e β ɾ ə s	t ə n 'ə β ɾ ə s
tenen	t 'e n ə n	t 'ə n ə n
tènia	t 'ɛ n i ə	t 'ə n i ə
terapèutic	t ə ɾ ə p 'ə w t i k	t ə ɾ ə p 'ɛ w t i k
teratogènic	t ə ɾ ə t o ʒ 'ɛ n i k	t ə ɾ ə t o ʒ 'ə n i k
teratogènica	t ə ɾ ə t o ʒ 'ɛ n i k ə	t ə ɾ ə t o ʒ 'ə n i k ə
teratogènics	t ə ɾ ə t o ʒ 'ɛ n i t s	t ə ɾ ə t o ʒ 'ə n i t s
teratogèniques	t ə ɾ ə t o ʒ 'ɛ n i k ə s	t ə ɾ ə t o ʒ 'ə n i k ə s
tèrbol	t 'ɛ ɾ β o l	t 'ə ɾ β o l
terrestre	t ə r 'e s t ɾ ə	t ə r 'ə s t ɾ ə
terrestres	t ə r 'e s t ɾ ə s	t ə r 'ə s t ɾ ə s
tesi	t 'ɛ z i	t 'ə z i
tesin	t 'ɛ z i n	t 'ə z i n
tesis	t 'ɛ z i s	t 'ə z i s
testimoni	t ə s t i m 'ɔ n i	t ə s t i m 'o n i
testimoniatge	t ə s t i m o n i 'a d ʒ ə	t ə s t i m o n i 'a dʒ ə
teva	t 'e v ə	t 'ə v ə
teves	t 'e v ə s	t 'ə v ə s
tirarem	t i ɾ ə ɾ 'ə m	t i ɾ ə ɾ 'ɛ m
titlada	t i l l 'a ð ə	t i l 'a ð ə
titlades	t i l l 'a ð ə s	t i l 'a ð ə s
titlar	t i l l 'a	t i t l 'a
titlat	t i l l 'a t	t i l 'a t
titlats	t i l l 'a t s	t i l 'a t s
titularem	t i t u l ə ɾ 'ə m	t i t u l ə ɾ 'ɛ m
titulem	t i t u l 'ə m	t i t u l 'ɛ m
tmesi	m m 'ɛ z i	m m 'ə z i
tocarem	t o k ə ɾ 'ə m	t o k ə ɾ 'ɛ m
tomba	t 'o m b ə	t 'ɔ m b ə
tomben	t 'o m b ə n	t 'ɔ m b ə n
tombes	t 'o m b ə s	t 'ɔ m b ə s
tonatge	t o n 'a d ʒ ə	t o n 'a dʒ ə
tonja	t 'ɔ ɲ ə	t 'o ɲ ə
topa	t 'o p ə	t 'ɔ p ə
topen	t 'o p ə n	t 'ɔ p ə n
topo	t 'o p o	t 'ɔ p o
toquem	t o k 'ə m	t o k 'ɛ m
torba	t 'o ɾ β ə	t 'ɔ ɾ β ə
torben	t 'o ɾ β ə n	t 'ɔ ɾ β ə n
torna	t 'o ɾ n ə	t 'ɔ ɾ n ə
tornen	t 'o ɾ n ə n	t 'ɔ ɾ n ə n
tornes	t 'o ɾ n ə s	t 'ɔ ɾ n ə s
torno	t 'o ɾ n o	t 'ɔ ɾ n o
torra	t 'ɔ r ə	t 'o r ə
torre	t 'o r ə	t 'ɔ r ə
tort	t 'ɔ ɾ t	t 'o ɾ t
tosca	t 'o s k ə	t 'ɔ s k ə
tota	t 'o t ə	t 'ɔ t ə
totes	t 'o t ə s	t 'ɔ t ə s
totxes	t 'ɔ t ʃ ə s	t 'ɔ tʃ ə s
totxo	t 'o t ʃ o	t 'ɔ tʃ o
tragèdia	t ɾ ə ʒ 'ɛ ð i ə	t ɾ ə ʒ 'ə ð i ə
transparència	t ɾ ə n s p ə ɾ 'ɛ n s i ə	t ɾ ə n s p ə ɾ 'ə n s i ə
trapezi	t ɾ ə p 'ɛ z i	t ɾ ə p 'ə z i
tremp	t ɾ 'e m p	t ɾ 'ɛ m p
Tremp	t ɾ 'e m p	t ɾ 'ɛ m p
treni	t ɾ 'ɛ n i	t ɾ 'ə n i
trenis	t ɾ 'ɛ n i s	t ɾ 'ə n i s
trenqui	t ɾ 'ɛ ŋ k i	t ɾ 'ə ŋ k i
trenquin	t ɾ 'ɛ ŋ k i n	t ɾ 'ə ŋ k i n
trenquis	t ɾ 'ɛ ŋ k i s	t ɾ 'ə ŋ k i s
trens	t ɾ 'ə n s	t ɾ 'e n s
trepa	t ɾ 'e p ə	t ɾ 'ə p ə
trepes	t ɾ 'e p ə s	t ɾ 'ə p ə s
trepig	t ɾ ə p 'i t ʃ	t ɾ ə p 'i k
trepitjada	t ɾ ə p i d ʒ 'a ð ə	t ɾ ə p i dʒ 'a ð ə
trepitjades	t ɾ ə p i d ʒ 'a ð ə s	t ɾ ə p i dʒ 'a ð ə s
trepitjaneu	t ɾ ə p i d ʒ ə n 'ɛ w	t ɾ ə p i dʒ ə n 'ɛ w
trepitjar	t ɾ ə p i d ʒ 'a	t ɾ ə p i dʒ 'a
trepitjat	t ɾ ə p i d ʒ 'a t	t ɾ ə p i dʒ 'a t
trepitjats	t ɾ ə p i d ʒ 'a t s	t ɾ ə p i dʒ 'a t s
tret	t ɾ 'e t	t ɾ 'ə t
treta	t ɾ 'e t ə	t ɾ 'ə t ə
tretes	t ɾ 'e t ə s	t ɾ 'ə t ə s
trets	t ɾ 'e t s	t ɾ 'ə t s
tretze	t ɾ 'e d z ə	t ɾ 'ə d z ə
treva	t ɾ 'e v ə	t ɾ 'ə v ə
Trèveris	t ɾ 'ɛ v ə ɾ i s	t ɾ 'ə v ə ɾ i s
trèvol	t ɾ 'ɛ v o l	t ɾ 'ə v o l
trèvols	t ɾ 'ɛ v o l s	t ɾ 'ə v o l s
triatge	t ɾ i 'a d ʒ ə	t ɾ i 'a dʒ ə
trigonomètric	t ɾ i ɣ o n o m 'ɛ t ɾ i k	t ɾ i ɣ o n o m 'ə t ɾ i k
trigonomètrica	t ɾ i ɣ o n o m 'ɛ t ɾ i k ə	t ɾ i ɣ o n o m 'ə t ɾ i k ə
trigonomètrics	t ɾ i ɣ o n o m 'ɛ t ɾ i t s	t ɾ i ɣ o n o m 'ə t ɾ i t s
trigonomètriques	t ɾ i ɣ o n o m 'ɛ t ɾ i k ə s	t ɾ i ɣ o n o m 'ə t ɾ i k ə s
trimestre	t ɾ i m 'e s t ɾ ə	t ɾ i m 'ə s t ɾ ə
trirrem	t ɾ i r 'ə m	t ɾ i r 'ɛ m
tromba	t ɾ 'o m b ə	t ɾ 'ɔ m b ə
trombocitopènia	t ɾ o m b o s i t o p 'ɛ n i ə	t ɾ o m b o s i t o p 'ə n i ə
trompa	t ɾ 'o m p ə	t ɾ 'ɔ m p ə
trompes	t ɾ 'o m p ə s	t ɾ 'ɔ m p ə s
tropa	t ɾ 'o p ə	t ɾ 'ɔ p ə
tropes	t ɾ 'o p ə s	t ɾ 'ɔ p ə s
ull	'u j	'u ʎ
un	'u n	u n
uns	'u n s	u n s
us	'u s	u s
vaig	v 'a t ʃ	v 'a j
València	v ə l 'ɛ n s i ə	v ə l 'ə n s i ə
valer	v ə l 'ə	v ə l 'e
vaporatge	v ə p o ɾ 'a d ʒ ə	v ə p o ɾ 'a dʒ ə
ve	v 'e	v 'ə
vegem	v ə ʒ 'ə m	v ə ʒ 'ɛ m
veïnatge	v ə i n 'a d ʒ ə	v ə i n 'a dʒ ə
vencem	v ə n s 'ə m	v ə n s 'ɛ m
vencerem	v ə n s ə ɾ 'ə m	v ə n s ə ɾ 'ɛ m
venci	v 'ɛ n s i	v 'ə n s i
venerarem	v ə n ə ɾ ə ɾ 'ə m	v ə n ə ɾ ə ɾ 'ɛ m
venerem	v ə n ə ɾ 'ə m	v ə n ə ɾ 'ɛ m
vènet	v 'ɛ  n ə t	v 'ə n ə t
vènia	v 'ɛ  n i ə	v 'ə n i ə
ventre	v 'e n t ɾ ə	v 'ə n t ɾ ə
ventrell	v ə n t ɾ 'ə ʎ	v ə n t ɾ 'e ʎ
vespa	v 'e s p ə	v 'ə s p ə
vespre	v 'e s p ɾ ə	v 'ə s p ɾ ə
vetlla	v 'e ʎ ʎ ə	v 'ə l l ə
vetllada	v ə ʎ ʎ 'a ð ə	v ə l l 'a ð ə
vetllades	v ə ʎ ʎ 'a ð ə s	v ə l l 'a ð ə s
vetllar	v ə ʎ ʎ 'a	v ə l l 'a
vetllat	v ə ʎ ʎ 'a t	v ə l l 'a t
vetllats	v ə ʎ ʎ 'a t s	v ə l l 'a t s
vetla	v 'e l l ə	v 'ə ʎ ə
vetlada	v ə l l 'a ð ə	v ə ʎ 'a ð ə
vetlades	v ə l l 'a ð ə s	v ə ʎ 'a ð ə s
vetlar	v ə l l 'a	v ə ʎ 'a
vetlat	v ə l l 'a t	v ə ʎ 'a t
vetlats	v ə l l 'a t s	v ə ʎ 'a t s
viatge	v i 'a d ʒ ə	v i 'a dʒ ə
viatger	v i ə d ʒ 'e	v i ə dʒ 'e
viatgera	v i ə d ʒ 'e ɾ ə	v i ə dʒ 'e ɾ ə
viatjada	v i ə d ʒ 'a ð ə	v i ə dʒ 'a ð ə
viatjades	v i ə d ʒ 'a ð ə s	v i ə dʒ 'a ð ə s
viatjar	v i ə d ʒ 'a	v i ə dʒ 'a
viatjat	v i ə d ʒ 'a t	v i ə dʒ 'a t
viatjats	v i ə d ʒ 'a t s	v i ə dʒ 'a t s
Vicent	v i s 'ɛ n t	v i s 'e n t
vicesecretari	v i s ə s ə k ɾ ə t 'a ɾ i	v i s ə z ə k ɾ ə t 'a ɾ i
vigència	v i ʒ 'ɛ  n s i ə	v i ʒ 'ə n s i ə
vigèsim	v i ʒ 'ɛ  z i m	v i ʒ 'ə z i m
vilatge	v i l 'a d ʒ ə	v i l 'a dʒ ə
vilipendi	v i l i p 'ɛ n d i	v i l i p 'ə n d i
violència	v i o l 'ɛ  n s i ə	v i o l 'ə n s i ə
Viquipèdia	v i k i p 'ɛ ð i ə	v i k i p 'ə ð i ə
viratge	v i ɾ 'a d ʒ ə	v i ɾ 'a dʒ ə
virulència	v i ɾ u l 'ɛ n s i ə	v i ɾ u l 'ə n s i ə
voler	v o l 'ə	v o l 'e
volumètric	v o l u m 'ɛ t ɾ i k	v o l u m 'ə t ɾ i k
votarem	v o t ə ɾ 'ə m	v o t ə ɾ 'ɛ m
votem	v o t 'ə m	v o t 'ɛ m
voto	v 'o t o	v 'ɔ t o
xantatge	ʃ ə n t 'a d ʒ ə	ʃ ə n t 'a dʒ ə
xeic	ʃ 'e j k	ʃ 'ə j k
Xèrica	ʃ 'ɛ ɾ i k ə	ʃ 'ə ɾ i k ə
xifratge	ʃ i f ɾ 'a d ʒ ə	ʃ i f ɾ 'a dʒ ə
xistorra	ʃ i s t 'ɔ r ə	ʃ i s t 'o r ə
xitxarra	ʃ i t ʃ 'a r ə	ʃ i tʃ 'a r ə
xítxero	ʃ 'i t ʃ ə ɾ o	ʃ 'i tʃ ə ɾ o
xou	ʃ 'ɔ w	ʃ 'o w
xous	ʃ 'ɔ w s	ʃ 'o w s
zebra	z 'e β ɾ ə	z 'ə β ɾ ə
zirconi	z i ɾ k 'ɔ n i	z i ɾ k 'o n i
de	d 'ə	d ə
que	k 'ə	k ə
la	l 'ə	l ə
i	'i	i
a	'ə	ə
el	'ə l	ə l
un	'u n	u n
en	'ə n	ə n
les	l 'ə s	l ə s
els	'ə l s	ə l s
del	d 'ə l	d ə l
amb	'ə m	ə m b
al	'ə l	ə l
es	'ə s	ə s
com	k 'ɔ m	k 'o m
El	'ə l	ə l
dels	d 'ə l s	d ə l s
hi	'i	i
La	l 'ə	l ə
o	'ɔ	'o
si	s 'i	s i
em	'ə m	ə m
li	l 'i	l i
tot	t 'o t	t 'ɔ t
seva	s 'e v ə	s 'ə v ə
ens	'ə n s	ə n s
A	'ə	ə
sobre	s 'o β ɾ ə	s 'ɔ β ɾ ə
vaig	v 'a t ʃ	v 'a j
En	'ə n	ə n
Si	s 'i	s i
sense	s 'e n s ə	s 'ə n s ə
ho	'o	o
res	r 'ɛ s	r 'ə s
De	d 'ə	d ə
pel	p 'ə l	p ə l
tots	t 'o t s	t 'ɔ t s
entre	'e n t ɾ ə	'ə n t ɾ ə
meva	m 'e v ə	m 'ə v ə
sempre	s 'e m p ɾ ə	s 'ɛ m p ɾ ə
I	'i	i
he	'e	'ɛ
us	'u s	u s
uns	'u n s	u n s
hem	'ə m	'ɛ m
cosa	k 'ɔ z ə	k 'o z ə
seves	s 'e v ə s	s 'ə v ə s
se	s 'ə	s ə
Un	'u n	u n
Les	l 'ə s	l ə s
sistema	s i s t 'e m ə	s i s t 'ɛ m ə
Em	'ə m	ə m
tota	t 'o t ə	t 'ɔ t ə
et	'ə t	ə t
mentre	m 'e n t ɾ ə	m 'ə n t ɾ ə
Es	'ə s	ə s
poder	p o ð 'ə	p o ð 'e
Al	'ə l	ə l
hores	'ɔ ɾ ə s	'o ɾ ə s
totes	t 'o t ə s	t 'ɔ t ə s
coses	k 'ɔ z ə s	k 'o z ə s
Hi	'i	i
Com	k 'ɔ m	k 'o m
dona	d 'ɔ n ə	d 'o n ə
haver	ə v 'ə	ə v 'e
tenen	t 'e n ə n	t 'ə n ə n
Li	l 'i	l i
Amb	'ə m	ə m b
nens	n 'ə n s	n 'e n s
centre	s 'e n t ɾ ə	s 'ə n t ɾ ə
sota	s 'o t ə	s 'ɔ t ə
ben	b 'e n	b 'ə n
pels	p 'ə l s	p ə l s
molts	m 'o l s	m 'o l t s
contra	k 'o n t ɾ ə	k 'ɔ n t ɾ ə
saber	s ə β 'ə	s ə β 'e
mig	m 'i t ʃ	m 'i k
cotxe	k 'o t ʃ o	k 'ɔ tʃ ə
missatge	m i s 'a d ʒ ə	m i s 'a dʒ ə
Ho	'o	o
moltes	m 'o l t ə s	m 'ɔ l t ə s
mateixa	m ə t 'e ʃ ə	m ə t 'ɛ ʃ ə
eren	'e ɾ ə n	'ɛ ɾ ə n
mes	m 'e s	m 'ə s
Queden	k 'e ð ə n	k 'ɛ ð ə n
podem	p o ð 'ə m	p o ð 'ɛ m
mort	m 'ɔ ɾ t	m 'o ɾ t
desitja	d ə z 'i d ʒ ə	d ə z 'i dʒ ə
forma	f 'o ɾ m ə	f 'ɔ ɾ m ə
fora	f 'ɔ ɾ ə	f 'o ɾ ə
home	'ɔ m o	'ɔ m ə
ve	v 'e	v 'ə
missatges	m i s 'a d ʒ ə s	m i s 'a dʒ ə s
estem	ə s t 'ə m	ə s t 'ɛ m
trenta	t ɾ 'ə n t ə	t ɾ 'e n t ə
sento	s 'e n t o	s 'ɛ n t o
He	'e	'ɛ
hora	'ɔ ɾ ə	ə ɾ ə
Vaig	v 'a t ʃ	v 'a j
Tot	t 'o t	t 'ɔ t
darrere	d ə r 'e ɾ ə	d ə r 'ə ɾ ə
teva	t 'e v ə	t 'ə v ə
grups	g ɾ 'u t s	g ɾ 'u p s
Llobregat	ʎ o β ɾ ə ɣ 'a t	ʎ u β ɾ ə ɣ 'a t
tretze	t ɾ 'e d z ə	t ɾ 'ə d z ə
tema	t 'e m ə	t 'ɛ m ə
fitxers	f i t ʃ 'e s	f i tʃ 'e s
viatge	v i 'a d ʒ ə	v i 'a dʒ ə
molta	m 'o l t ə	m 'ɔ l t ə
dotze	d 'o d z ə	d 'ɔ d z ə
dones	d 'ɔ n ə s	d 'o n ə s
queda	k 'e ð ə	k 'ə ð ə
noi	n 'ɔ j	n 'o i
fort	f 'ɔ ɾ t	f 'o ɾ t
Ens	'ə n s	ə n s
llengua	ʎ 'e ŋ g w ə	ʎ 'ɛ ŋ g w ə
conèixer	k o n 'ə ʃ ə	k o n 'ɛ ʃ ə
segle	s 'e g g l ə	s 'ə ɣ l ə
Tots	t 'o t s	t 'ɔ t s
fitxer	f i t ʃ 'e	f i tʃ 'e
Que	k 'ə	k ə
viatjo	v i 'a d ʒ o	v i 'a dʒ o
jove	ʒ 'o v ə	ʒ 'ɔ v ə
catorze	k ə t 'o ɾ z ə	k ə t 'ɔ ɾ z ə
Mentre	m 'e n t ɾ ə	m 'ə n t ɾ ə
joves	ʒ 'o v ə s	ʒ 'ɔ v ə s
Sempre	s 'e m p ɾ ə	s 'ɛ m p ɾ ə
imatges	i m 'a d ʒ ə s	i m 'a dʒ ə s
fem	f 'ə m	f 'ɛ m
faig	f 'a t ʃ	f 'a tʃ
anem	ə n 'ə m	ə n 'ɛ m
projecte	p ɾ o ʒ 'ɛ t t ə	p ɾ o ʒ 'ə t t ə
meves	m 'e v ə s	m 'ɛ v ə s
viatjar	v i ə d ʒ 'a	v i ə dʒ 'a
sabem	s ə β 'ə m	s ə β 'ɛ m
mitjançant	m i d ʒ ə n s 'a n t	m i dʒ ə n s 'a n t
mitjans	m i d ʒ 'a n s	m i dʒ 'a n s
imatge	i m 'a d ʒ ə	i m 'a dʒ ə
boca	b 'o k ə	b 'ɔ k ə
temes	t 'e m ə s	t 'ɛ m ə s
tecla	t 'e k l ə	t 'ɛ k l ə
sèrie	s 'ɛ ɾ i ə	s 'ə ɾ i ə
homes	'ɔ m ə s	'o m ə s
centres	s 'e n t ɾ ə s	s 'ə n t ɾ ə s
Lleida	ʎ 'e j ð ə	ʎ 'ə j ð ə
tens	t 'ə n s	t 'e n s
peix	p 'e ʃ	p 'ɛ ʃ
malgrat	m ə l ɣ ɾ 'a t	m ə l g ɾ 'a t
maig	m 'a t ʃ	m 'a tʃ
trens	t ɾ 'ə n s	t ɾ 'e n s
preferències	p ɾ ə f ə ɾ 'ɛ n s i ə s	p ɾ ə f ə ɾ 'ə n s i ə s
mitjà	m i d ʒ 'a	m i dʒ 'a
silenci	s i l 'ɛ n s i	s i l 'ə n s i
aspectes	ə s p 'ɛ t t ə s	ə s p 'ə t t ə s
volem	v o l 'ə m	v o l 'ɛ m
fes	f 'e s	f 'ə s
curs	k 'u s	k 'u ɾ s
torna	t 'o ɾ n ə	t 'ɔ ɾ n ə
suport	s u p 'ɔ ɾ t	s u p 'o ɾ t
queden	k 'e ð ə n	k 'ɛ ð ə n
peixos	p 'e ʃ o s	p 'ɛ ʃ o s
junts	ʒ 'u n s	ʒ 'u n t s
haig	'a t ʃ	'a tʃ
foto	f 'o t o	f 'ɔ t o
Podem	p o ð 'ə m	p o ð 'ɛ m
Pere	p 'e ɾ ə	p 'ə ɾ ə
O	'ɔ	'o
presència	p ɾ ə z 'ɛ n s i ə	p ɾ ə z 'ə n s i ə
etcètera	ə t s 'ɛ t ə ɾ ə	ə t s 'ə t ə ɾ ə
dòlars	d 'ɔ l ə s	d 'ɔ l ə ɾ s
conte	k 'o n t ə	k 'ɔ n t ə
platja	p l 'a d ʒ ə	p l 'a dʒ ə
me'n	m ə n	m 'ə n
crèdit	k ɾ 'ɛ ð i t	k ɾ 'ə ð i t
bossa	b 'o s ə	b 'ɔ s ə
Malgrat	m ə l ɣ ɾ 'a t	m ə l g ɾ 'a t
Hem	'ə m	'ɛ m
Entre	'e n t ɾ ə	'ə n t ɾ ə
referència	r ə f ə ɾ 'ɛ n s i ə	r ə f ə ɾ 'ə n s i ə
pedra	p 'e ð ɾ ə	p 'ə ð ɾ ə
passatgers	p ə s ə d ʒ 'e s	p ə s ə dʒ 'e s
paisatge	p ə j z 'a d ʒ ə	p ə j z 'a dʒ ə
nois	n 'ɔ j s	n 'o i s
mètode	m 'ɛ t o ð ə	m 'ə t o ð ə
mitja	m 'i d ʒ ə	m 'i dʒ ə
gens	ʒ 'ə n s	ʒ 'e n s
formes	f 'o ɾ m ə s	f 'ɔ ɾ m ə s
cotxes	k 'o t ʃ ə s	k 'ɔ tʃ ə s
compra	k 'o m p ɾ ə	k 'ɔ m p ɾ ə
Us	'u s	u s
Montse	m 'o n s ə	m 'ɔ n s ə
respecte	r ə s p 'ɛ t t ə	r ə s p 'ə t t ə
personatges	p ə ɾ s o n 'a d ʒ ə s	p ə ɾ s o n 'a dʒ ə s
parts	p 'a ɾ s	p 'a ɾ t s
me	m 'ə	m ə
mateixos	m ə t 'e ʃ o s	m ə t 'ɛ ʃ o s
gossos	g 'o s o s	g 'ɔ s o s
Pel	p 'ə l	p ə l
Et	'ə t	ə t
Anem	ə n 'ə m	ə n 'ɛ m
volen	v 'o l ə n	v 'ɔ l ə n
plens	p l 'ə n s	p l 'e n s
pitjor	p i d ʒ 'o	p i dʒ 'o
personatge	p ə ɾ s o n 'a d ʒ ə	p ə ɾ s o n 'a dʒ ə
farem	f ə ɾ 'ə m	f ə ɾ 'ɛ m
diverses	d i v 'ɛ ɾ s ə s	d i v 'ə ɾ s ə s
dimecres	d i m 'e k ɾ ə s	d i m 'ə k ɾ ə s
deixen	d 'e ʃ ə n	d 'ə ʃ ə n
Sense	s 'e n s ə	s 'ə n s ə
Desitja	d ə z 'i d ʒ ə	d ə z 'i dʒ ə
Desitja	d ə z 'i d ʒ ə	d ə z 'i dʒ ə
transport	t ɾ ə n s p 'ɔ ɾ t	t ɾ ə n s p 'o ɾ t
processos	p ɾ o s 'e s o s	p ɾ o s 'ə s o s
pedres	p 'e ð ɾ ə s	p 'ə ð ɾ ə s
desig	d ə z 'i t ʃ	d ə z 'i k
cerca	s 'ɛ ɾ k ə	s 'ə ɾ k ə
recerca	r ə s 'ɛ ɾ k ə	r ə s 'ə ɾ k ə
matèria	m ə t 'ɛ ɾ i ə	m ə t 'ə ɾ i ə
fosca	f 'o s k ə	f 'ɔ s k ə
fer-ho	f 'e ɾ o	f 'ɛ ɾ o
entendre	ə n t 'e n d ɾ ə	ə n t 'ə n d ɾ ə
dolça	d 'o l s ə	d 'ɔ l s ə
diferències	d i f ə ɾ 'ɛ n s i ə s	d i f ə ɾ 'ə n s i ə s
defecte	d ə f 'ɛ t t ə	d ə f 'ə t t ə
ves	v 'e s	v 'ə s
torno	t 'o ɾ n o	t 'ɔ ɾ n o
sistemes	s i s t 'e m ə s	s i s t 'ɛ m ə s
metges	m 'e d ʒ ə s	m 'ə dʒ ə s
formen	f 'o ɾ m ə n	f 'ɔ ɾ m ə n
conseqüència	k o n s ə k w 'ɛ n s i ə	k o n s ə k w 'ə n s i ə
boig	b 'ɔ t ʃ	b 'ɔ tʃ
aspecte	ə s p 'ɛ t t ə	ə s p 'ə t t ə
aparèixer	ə p ə ɾ 'ə ʃ ə	ə p ə ɾ 'ɛ ʃ ə
València	v ə l 'ɛ n s i ə	v ə l 'ə n s i ə
Montserrat	m o n s ə r 'a t	m o n t s ə r 'a t
i	'i	i
viatges	v i 'a d ʒ ə s	v i 'a dʒ ə s
vespre	v 'e s p ɾ ə	v 'ə s p ɾ ə
sabent	s ə β 'ɛ n t	s ə β 'e n t
reforma	r ə f 'o ɾ m ə	r ə f 'ɔ ɾ m ə
quedo	k 'e ð o	k 'ə ð o
projectes	p ɾ o ʒ 'ɛ t t ə s	p ɾ o ʒ 'ə t t ə s
llenguatge	ʎ ə ŋ g w 'a d ʒ ə	ʎ ə ŋ g w 'a dʒ ə
equips	ə k 'i t s	ə k 'i p s
doble	d 'o b b l ə	d 'ɔ b b l ə
disposen	d i s p 'o z ə n	d i s p 'ɔ z ə n
diferència	d i f ə ɾ 'ɛ n s i ə	d i f ə ɾ 'ə n s i ə
consciència	k o n t s i 'ɛ n s i ə	k o n t s i 'ə n s i ə
Moltes	m 'o l t ə s	m 'ɔ l t ə s
Als	'ə l s	ə l s
època	'ɛ p o k ə	'ə p o k ə
A	'ə	ə
voler	v o l 'ə	v o l 'e
reconèixer	r ə k o n 'ə ʃ ə	r ə k o n 'ɛ ʃ ə
paciència	p ə s i 'ɛ n s i ə	p ə s i 'ə n s i ə
butxaca	b u t ʃ 'a k ə	b u tʃ 'a k ə
bombes	b 'o m b ə s	b 'ɔ m b ə s
Soc	s 'o k	s 'ɔ k
èpoques	'ɛ p o k ə s	'ə p o k ə s
transports	t ɾ ə n s p 'ɔ ɾ s	t ɾ ə n s p 'o ɾ t s
trajecte	t ɾ ə ʒ 'ɛ t t ə	t ɾ ə ʒ 'ə t t ə
teves	t 'e v ə s	t 'ə v ə s
seqüència	s ə k w 'ɛ n s i ə	s ə k w 'ə n s i ə
quarts	k w 'a ɾ s	k w 'a ɾ t s
presenten	p ɾ ə z 'e n t ə n	p ɾ ə z 'ə n t ə n
parlem	p ə ɾ l 'ə m	p ə ɾ l 'ɛ m
ordre	'o ɾ ð ɾ ə	'ɔ ɾ ð ɾ ə
mitjana	m i d ʒ 'a n ə	m i dʒ 'a n ə
marcs	m 'a ɾ t s	m 'a ɾ s s
fotos	f 'o t o s	f 'ɔ t o s
esport	ə s p 'ɔ ɾ t	ə s p 'o ɾ t
donem	d o n 'ə m	d o n 'ɛ m
despatx	d ə s p 'a t ʃ	d ə s p 'a tʃ
deixo	d 'e ʃ o	d 'ɛ ʃ o
capsa	k 'a t s ə	k 'a s ə
acabem	ə k ə β 'ə m	ə k ə β 'ɛ m
Viatjo	v i 'a d ʒ o	v i 'a dʒ o
Sento	s 'e n t o	s 'ɛ n t o
Faig	f 'a t ʃ	f 'a tʃ
Conca	k 'o ŋ k ə	k 'ɔ ŋ k ə
sentin	s 'e n t i n	s 'ɛ n t i n
segles	s 'e g g l ə s	s 'ə ɣ l ə s
representen	r ə p ɾ ə z 'e n t ə n	r ə p ɾ ə z 'ə n t ə n
regles	r 'e g g l ə s	r 'ə ɣ l ə s
pèl	p 'ə l	p 'ɛ l
provoca	p ɾ o v 'o k ə	p ɾ o v 'ɔ k ə
premsa	p ɾ 'e n s ə	p ɾ 'ɛ n s ə
port	p 'ɔ ɾ t	p 'o ɾ t
metge	m 'e d ʒ ə	m 'ə dʒ ə
immens	i m m 'ə n s	i m m 'e n s
enorme	ə n 'o ɾ m ə	ə n 'ɔ ɾ m ə
elfs	'ɛ l t s	'ɛ l s
conceptes	k o n s 'ɛ t t ə s	k o n s 'ə t t ə s
comencem	k o m ə n s 'ə m	k o m ə n s 'ɛ m
caminem	k ə m i n 'ə m	k ə m i n 'ɛ m
atendre	ə t 'e n d ɾ ə	ə t 'ə n d ɾ ə
Uns	'u n s	u n s
Totes	t 'o t ə s	t 'ɔ t ə s
Boi	b 'ɔ j	b 'o i
Com	k 'ɔ m	k 'o m
varem	v ə ɾ 'ə m	v ə ɾ 'ɛ m
ull	'u j	'u ʎ
tornes	t 'o ɾ n ə s	t 'ɔ ɾ n ə s
tinguessin	t i ŋ g 'e s i n	t i ŋ g 'ə s i n
sèries	s 	s 'ə ɾ i ə s
saps	s 'a t s	s 'a p s
pèls	p 'ə l s	p 'ɛ l s
portem	p o ɾ t 'ə m	p o ɾ t 'ɛ m
passatger	p ə s ə d ʒ 'e	p ə s ə dʒ 'e
mots	m 'o t s	m 'ɔ t s
moto	m 'o t o	m 'ɔ t o
mot	m 'o t	m 'ɔ t
m'hi	m i	m 'i
llicència	ʎ i s 'ɛ n s i ə	ʎ i s 'ə n s i ə
llest	ʎ 'e s t	ʎ 'ə s t
llengües	ʎ 'e ŋ g w ə s	ʎ 'ɛ ŋ g w ə s
fitxes	f 'i t ʃ ə s	f 'i tʃ ə s
enmig	ə m m 'i t ʃ	ə m m 'i k
efectes	ə f 'ɛ t t ə s	ə f 'ə t t ə s
contes	k 'o n t ə s	k 'ɔ n t ə s
concepte	k o n s 'ɛ t t ə	k o n s 'ə t t ə
arribarem	ə r i β ə ɾ 'ə m	ə r i β ə ɾ 'ɛ m
Tremp	t ɾ 'e m p	t ɾ 'ɛ m p
Pesa	p 'e z ə	p 'ə z ə
Molts	m 'o l s	m 'o l t s
Fes	f 'e s	f 'ə s
En	'ə n	ə n
violència	v i o l 'ɛ n s i ə	v i o l 'ə n s i ə
transparència	t ɾ ə n s p ə ɾ 'ɛ n s i ə	t ɾ ə n s p ə ɾ 'ə n s i ə
transferència	t ɾ ə n s f ə ɾ 'ɛ n s i ə	t ɾ ə n s f ə ɾ 'ə n s i ə
raig	r 'a t ʃ	r 'a tʃ
presidència	p ɾ ə z i ð 'ɛ n s i ə	p ɾ ə z i ð 'ə n s i ə
plataforma	p l ə t ə f 'o ɾ m ə	p l ə t ə f 'ɔ ɾ m ə
peatges	p e 'a d ʒ ə s	p e 'a dʒ ə s
morts	m 'ɔ ɾ s	m 'o ɾ t s
mitjanit	m i d ʒ ə n 'i t	m i dʒ ə n 'i t
menja	m 'e n ʒ ə	m 'ə n ʒ ə
mateixes	m ə t 'e ʃ ə s	m ə t 'ɛ ʃ ə s
intento	i n t 'e n t o	i n t 'ɛ n t o
intenten	i n t 'e n t ə n	i n t 'ə n t ə n
formatge	f o ɾ m 'a d ʒ ə	f o ɾ m 'a dʒ ə
fitxers	f i t ʃ 'e s	f i tʃ 'e s
fantasia	f ə n t ə z 'i ə	f ə n t ə s 'i ə
estranjs	ə s t ɾ 'a j n s	ə s t ɾ 'a ɲ s
entren	'e n t ɾ ə n	'ə n t ɾ ə n
enormes	ə n 'o ɾ m ə s	ə n 'ɔ ɾ m ə s
corre	k 'o r ə	k 'ɔ r ə
coratge	k o ɾ 'a d ʒ ə	k o ɾ 'a dʒ ə
copes	k 'o p ə s	k 'ɔ p ə s
competències	k o m p ə t 'ɛ n s i ə s	k o m p ə t 'ə n s i ə s
ciència	s i 'ɛ n s i ə	s i 'ə n s i ə
Torna	t 'o ɾ n ə	t 'ɔ ɾ n ə
Eren	'e ɾ ə n	'ɛ ɾ ə n
Antoni	ə n t 'ɔ n i	ə n t 'o n i
vulguem	v u l ɣ 'ə m	v u l ɣ 'ɛ m
vivendes	v i v 'e n d ə s	v i v 'ə n d ə s
vivenda	v i v 'e n d ə	v i v 'ə n d ə
txa	t ʃ 'a	tʃ 'a
trobem	t ɾ o β 'ə m	t ɾ o β 'ɛ m
tornen	t 'o ɾ n ə n	t 'ɔ ɾ n ə n
tindrem	t i n d ɾ 'ə m	t i n d ɾ 'ɛ m
residència	r ə z i ð 'ɛ n s i ə	r ə z i ð 'ə n s i ə
repte	r 'ɛ t t ə	r 'ə t t ə
reportatge	r ə p o ɾ t 'a d ʒ ə	r ə p o ɾ t 'a dʒ ə
puguem	p u ɣ 'ə m	p u ɣ 'ɛ m
preguntem	p ɾ ə ɣ u n t 'ə m	p ɾ ə ɣ u n t 'ɛ m
podrem	p o ð ɾ 'ə m	p o ð ɾ 'ɛ m
plantegem	p l ə n t ə ʒ 'ə m	p l ə n t ə ʒ 'ɛ m
perfecte	p ə ɾ f 'ɛ t t ə	p ə ɾ f 'ə t t ə
neboda	n ə β 'o ð ə	n ə β 'ɔ ð ə
mitjons	m i d ʒ 'o n s	m i dʒ 'o n s
lo	l 'o	l o
llop	ʎ 'o p	ʎ 'ɔ p
llagosta	ʎ ə ɣ 'o s t ə	ʎ ə ɣ 'ɔ s t ə
intens	i n t 'ə n s	i n t 'e n s
incidències	i n s i ð 'ɛ n s i ə s	i n s i ð 'ə n s i ə s
impotència	i m p o t 'ɛ n s i ə	i m p o t 'ə n s i ə
herois	ə ɾ 'ɔ j s	ə ɾ 'o i s
habitatges	ə β i t 'a d ʒ ə s	ə β i t 'a dʒ ə s
gotes	g 'o t ə s	g 'ɔ t ə s
gota	g 'o t ə	g 'ɔ t ə
glop	g l 'o p	g l 'ɔ p
fosques	f 'o s k ə s	f 'ɔ s k ə s
fixes	f 'i t s ə s	f 'i ʃ ə s
fetge	f 'e d ʒ ə	f 'ə dʒ ə
feix	f 'e ʃ	f 'ɛ ʃ
esports	ə s p 'ɔ ɾ s	ə s p 'o ɾ t s
endarrere	ə n d ə r 'e ɾ ə	ə n d ə r 'ə ɾ ə
encendre	ə n s 'e n d ɾ ə	ə n s 'ə n d ɾ ə
donen	d 'o n ə n	d 'ɔ n ə n
domèstic	d o m 'ɛ s t i k	d o m 'ə s t i k
disposem	d i s p o z 'ə m	d i s p o z 'ɛ m
dimonis	d i m 'ɔ n i s	d i m 'o n i s
descens	d ə t s 'ə n s	d ə t s 'e n s
demanem	d ə m ə n 'ə m	d ə m ə n 'ɛ m
creix	k ɾ 'e ʃ	k ɾ 'ɛ ʃ
corbes	k 'o ɾ β ə s	k 'ɔ ɾ β ə s
concerts	k o n s 'ɛ ɾ s	k o n s 'ɛ ɾ t s
compro	k 'o m p ɾ o	k 'ɔ m p ɾ o
argument	ə ɾ ɣ u m 'e n t	a ɾ ɣ u m 'e n t
anirem	ə n i ɾ 'ə m	ə n i ɾ 'ɛ m
aliment	ə l i m 'e n t	a l i m 'e n t
agenda	ə ʒ 'e n d ə	ə ʒ 'ə n d ə
acceptem	ə t s ə t t 'ə m	ə t s ə t t 'ɛ m
Sitges	s 'i d ʒ ə s	s 'i dʒ ə s
Respecte	r ə s p 'ɛ t t ə	r ə s p 'ə t t ə
Res	r 'ɛ s	r 'ə s
Palència	p ə l 'ɛ n s i ə	p ə l 'ə n s i ə
Londres	l 'o n d ɾ ə s	l 'ɔ n d ɾ ə s
Intento	i n t 'e n t o	i n t 'ɛ n t o
Imatge	i m 'a d ʒ ə	i m 'a dʒ ə
Horts	'ɔ ɾ s	ə ɾ t s
Deixo	d 'e ʃ o	d 'ɛ ʃ o
o	'ɔ	'o
txec	t ʃ 'ɛ k	tʃ 'ɛ k
tinguem	t i ŋ g 'ə m	t i ŋ g 'ɛ m
testimonis	t ə s t i m 'ɔ n i s	t ə s t i m 'o n i s
te	t 'ə	t ə
sencera	s ə n s 'ə ɾ ə	s ə n s 'e ɾ ə
retrobo	r ə t ɾ 'o β o	r ə t ɾ 'ɔ β o
renda	r 'e n d ə	r 'ə n d ə
rebutjar	r ə β u d ʒ 'a	r ə β u dʒ 'a
pensem	p ə n s 'ə m	p ə n s 'ɛ m
parer	p ə ɾ 'ə	p ə ɾ 'e
oberts	o β 'ɛ ɾ s	o β 'ɛ ɾ t s
neix	n 'e ʃ	n 'ɛ ʃ
missatgeria	m i s ə d ʒ ə ɾ 'i ə	m i s ə dʒ ə ɾ 'i ə
menjo	m 'e n ʒ o	m 'ə n ʒ o
mantenen	m ə n t 'e n ə n	m ə n t 'ə n ə n
lleixa	ʎ 'e ʃ ə	ʎ 'ɛ ʃ ə
indiferència	i n d i f ə ɾ 'ɛ n s i ə	i n d i f ə ɾ 'ə n s i ə
independència	i n d ə p ə n d 'ɛ n s i ə	i n d ə p ə n d 'ə n s i ə
grega	g ɾ 'ə ɣ ə	g ɾ 'ɛ ɣ ə
goig	g 'ɔ t ʃ	g 'ɔ tʃ
foscos	f 'o s k o s	f 'ɔ s k o s
forts	f 'ɔ ɾ s	f 'o ɾ t s
foren	f 'o ɾ ə n	f 'ɔ ɾ ə n
fixa	f 'i t s ə	f 'i ʃ ə
fitxa	f 'i t ʃ ə	f 'i tʃ ə
esperen	ə s p 'e ɾ ə n	ə s p 'ɛ ɾ ə n
dutxa	d 'u t ʃ ə	d 'u tʃ ə
dimoni	d i m 'ɔ n i	d i m 'o n i
desaparèixer	d ə z ə p ə ɾ 'ə ʃ ə	d ə z ə p ə ɾ 'ɛ ʃ ə
corren	k 'o r ə n	k 'ɔ r ə n
conseqüències	k o n s ə k w 'ɛ n s i ə s	k o n s ə k w 'ə n s i ə s
comparseros	k o m p ə ɾ s 'e ɾ o s	k o m p ə ɾ s 'ɛ ɾ o s
celebra	s ə l 'e β ɾ ə	s ə l 'ə β ɾ ə
bars	b 'a s	b 'a ɾ s
acadèmic	ə k ə ð 'ɛ m i k	ə k ə ð 'ə m i k
Volen	v 'o l ə n	v 'ɔ l ə n
Volem	v o l 'ə m	v o l 'ɛ m
Tens	t 'ə n s	t 'e n s
Sota	s 'o t ə	s 'ɔ t ə
Preferències	p ɾ ə f ə ɾ 'ɛ n s i ə s	p ɾ ə f ə ɾ 'ə n s i ə s
Pontevedra	p o n t ə v 'e ð ɾ ə	p o n t ə v 'ə ð ɾ ə
Pels	p 'ə l s	p ə l s
Menjo	m 'e n ʒ o	m 'ə n ʒ o
Home	'ɔ m o	'ɔ m ə
Estem	ə s t 'ə m	ə s t 'ɛ m
Centre	s 'e n t ɾ ə	s 'ə n t ɾ ə
volent	v o l 'ɛ n t	v o l 'e n t
vehemència	v ə ə m 'ɛ n s i ə	v ə ə m 'ə n s i ə
tètric	t 'ɛ t ɾ i k	t 'ə t ɾ i k
transforma	t ɾ ə n s f 'o ɾ m ə	t ɾ ə n s f 'ɔ ɾ m ə
tragèdia	t ɾ ə ʒ 'ɛ ð i ə	t ɾ ə ʒ 'ə ð i ə
tornarem	t o ɾ n ə ɾ 'ə m	t o ɾ n ə ɾ 'ɛ m
tonto	t 'o n t o	t 'ɔ n t o
testimoni	t ə s t i m 'ɔ n i	t ə s t i m 'o n i
tendència	t ə n d 'ɛ n s i ə	t ə n d 'ə n s i ə
tecles	t 'e k l ə s	t 'ɛ k l ə s
sortirem	s o ɾ t i ɾ 'ə m	s o ɾ t i ɾ 'ɛ m
sofre	s 'o f ɾ ə	s 'ɔ f ɾ ə
sistema	s i s t 'e m ə	s i s t 'ɛ m ə
silencis	s i l 'ɛ n s i s	s i l 'ə n s i s
sencer	s ə n s 'ə	s ə n s 'e
ronda	r 'o n d ə	r 'ɔ n d ə
ressona	r ə s 'ɔ n ə	r ə s 'o n ə
rere	r 'e ɾ ə	r 'ə ɾ ə
reformes	r ə f 'o ɾ m ə s	r ə f 'ɔ ɾ m ə s
recorre	r ə k 'o r ə	r ə k 'ɔ r ə
punjs	p 'u j n s	p 'u ɲ s
proposem	p ɾ o p o z 'ə m	p ɾ o p o z 'ɛ m
procedències	p ɾ o s ə ð 'ɛ n s i ə s	p ɾ o s ə ð 'ə n s i ə s
prestatges	p ɾ ə s t 'a d ʒ ə s	p ɾ ə s t 'a dʒ ə s
prestatgeries	p ɾ ə s t ə d ʒ ə ɾ 'i ə s	p ɾ ə s t ə dʒ ə ɾ 'i ə s
presses	p ɾ 'e s ə s	p ɾ 'ə s ə s
presento	p ɾ ə z 'e n t o	p ɾ ə z 'ə n t o
ports	p 'ɔ ɾ s	p 'o ɾ t s
ponència	p o n 'ɛ n s i ə	p o n 'ə n s i ə
poguessin	p o ɣ 'e s i n	p o ɣ 'ə s i n
pixels	p i ʃ 'ɛ l s	p i z 'ɛ l s
pitjors	p i d ʒ 'o s	p i dʒ 'o s
penja	p 'e n ʒ ə	p 'ə n ʒ ə
pengen	p 'e n ʒ ə n	p 'ə n ʒ ə n
passaport	p ə s ə p 'ɔ ɾ t	p ə s ə p 'o ɾ t
ordres	'o ɾ ð ɾ ə s	'ɔ ɾ ð ɾ ə s
omple	'o m p l ə	'ɔ m p l ə
ombres	'o m b ɾ ə s	'ɔ m b ɾ ə s
necessitem	n ə s ə s i t 'ə m	n ə s ə s i t 'ɛ m
mèdica	m 'ɛ ð i k ə	m 'ə ð i k ə
mitjanes	m i d ʒ 'a n ə s	m i dʒ 'a n ə s
mirem	m i ɾ 'ə m	m i ɾ 'ɛ m
mengen	m 'e n ʒ ə n	m 'ə n ʒ ə n
megues	m 'ə ɣ ə s	m 'ɛ ɣ ə s
matrimoni	m ə t ɾ i m 'ɔ n i	m ə t ɾ i m 'o n i
massatges	m ə s 'a d ʒ ə s	m ə s 'a dʒ ə s
marxem	m ə ɾ ʃ 'ə m	m ə ɾ ʃ 'ɛ m
lletjota	ʎ ə d ʒ 'ɔ t ə	ʎ ə dʒ 'ɔ t ə
lletja	ʎ 'e d ʒ ə	ʎ 'ə dʒ ə
lleig	ʎ 'e t ʃ	ʎ 'ɛ tʃ
jutges	ʒ 'u d ʒ ə s	ʒ 'u dʒ ə s
intermèdies	i n t ə ɾ m 'ɛ ð i ə s	i n t ə ɾ m 'ə ð i ə s
idèntica	i ð 'ɛ n t i k ə	i ð 'ə n t i k ə
haver-hi	ə v 'ɛ ɾ i	ə v 'ə ɾ i
grecs	g ɾ 'e t s	g ɾ 'ɛ t s
grec	g ɾ 'e k	g ɾ 'ɛ k
gravarem	g ɾ ə v ə ɾ 'ə m	g ɾ ə v ə ɾ 'ɛ m
golfes	g 'o l f ə s	g 'ɔ l f ə s
gespa	ʒ 'e s p ə	ʒ 'ə s p ə
gasoil	g ə z 'ɔ j l	g ə z 'o i l
fronts	f ɾ 'o n s	f ɾ 'o n t s
freqüències	f ɾ ə k w 'ɛ n s i ə s	f ɾ ə k w 'ə n s i ə s
freqüència	f ɾ ə k w 'ɛ n s i ə	f ɾ ə k w 'ə n s i ə
fotre	f 'o t ɾ ə	f 'ɔ t ɾ ə
fotem	f o t 'ə m	f o t 'ɛ m
estètica	ə s t 'ɛ t i k ə	ə s t 'ə t i k ə
essències	ə s 'ɛ n s i ə s	ə s 'ə n s i ə s
esquizofrènic	ə s k i z o f ɾ 'ɛ n i k	ə s k i z o f ɾ 'ə n i k
espongiformes	ə s p o n ʒ i f 'o ɾ m ə s	ə s p o n ʒ i f 'ɔ ɾ m ə s
esmorzen	ə z m 'o ɾ z ə n	ə z m 'ɔ ɾ z ə n
escolta	ə s k 'o l t ə	ə s k 'ɔ l t ə
escletxa	ə s k l 'e t ʃ ə	ə s k l 'ə tʃ ə
esborranjs	ə z β o r 'a j n s	ə z β o r 'a ɲ s
empremtes	ə m p ɾ 'e n t ə s	ə m p ɾ 'ɛ m ə s
efecte	ə f 'ɛ t t ə	ə f 'ə t t ə
difondre	d i f 'o n d ɾ ə	d i f 'ɔ n d ɾ ə
diabètic	d i ə β 'ɛ t i k	d i ə β 'ə t i k
desitjo	d ə z 'i d ʒ o	d ə z 'i dʒ o
desitjava	d ə z i d ʒ 'a v ə	d ə z i dʒ 'a v ə
desitjada	d ə z i d ʒ 'a ð ə	d ə z i dʒ 'a ð ə
creuem	k ɾ ə w 'ə m	k ɾ ə w 'ɛ m
creixen	k ɾ 'e ʃ ə n	k ɾ 'ɛ ʃ ə n
conca	k 'o ŋ k ə	k 'ɔ ŋ k ə
comte	k 'o n t ə	k 'ɔ m ə
compren	k 'o m p ɾ ə n	k 'ɔ m p ɾ ə n
comenten	k o m 'e n t ə n	k o m 'ə n t ə n
colze	k 'o l z ə	k 'ɔ l z ə
coincidències	k o i n s i ð 'ɛ n s i ə s	k o i n s i ð 'ə n s i ə s
ciències	s i 'ɛ n s i ə s	s i 'ə n s i ə s
certs	s 'ɛ ɾ s	s 'ɛ ɾ t s
ceptre	s 'e t t ɾ ə	s 'ə t t ɾ ə
bèsties	b 'ɛ s t i ə s	b 'ə s t i ə s
bots	b 'o t s	b 'ɔ t s
bosses	b 'o s ə s	b 'ɔ s ə s
borsa	b 'o ɾ s ə	b 'ɔ ɾ s ə
borda	b 'o ɾ ð ə	b 'ɔ ɾ ð ə
aèries	ə 'ɛ ɾ i ə s	ə 'ə ɾ i ə s
arts	'a ɾ s	'a ɾ t s
aliens	ə l i 'ə n s	ə l i 'e n s
alfabètic	ə l f ə β 'ɛ t i k	ə l f ə β 'ə t i k
aimara	ə j m 'a ɾ ə	ə i m 'a ɾ ə
agafant-me	ə ɣ ə f 'a m m ə	ə ɣ ə f 'a n m ə
acomiadem	ə k o m i ə ð 'ə m	ə k o m i ə ð 'ɛ m
accepto	ə t s 'e t t o	ə t s 'ə t t o
Vegem	v ə ʒ 'ə m	v ə ʒ 'ɛ m
Transferència	t ɾ ə n s f ə ɾ 'ɛ n s i ə	t ɾ ə n s f ə ɾ 'ə n s i ə
Torre	t 'o r ə	t 'ɔ r ə
Tornes	t 'o ɾ n ə s	t 'ɔ ɾ n ə s
Tenen	t 'e n ə n	t 'ə n ə n
Sabent	s ə β 'ɛ n t	s ə β 'e n t
Ribagorça	r i β ə ɣ 'o ɾ s ə	r i β ə ɣ 'ɔ ɾ s ə
Regne	r 'e n n ə	r 'ə n n ə
Perdoni	p ə ɾ ð 'ɔ n i	p ə ɾ ð 'o n i
Mitjana	m i d ʒ 'a n ə	m i dʒ 'a n ə
Missatge	m i s 'a d ʒ ə	m i s 'a dʒ ə
Mig	m 'i t ʃ	m 'i k
Me	m 'ə	m ə
Hola	'ɔ l ə	ə l ə
Formes	f 'o ɾ m ə s	f 'ɔ ɾ m ə s
Fitxer	f i t ʃ 'e	f i tʃ 'e
Fem	f 'ə m	f 'ɛ m
Farem	f ə ɾ 'ə m	f ə ɾ 'ɛ m
Escolta	ə s k 'o l t ə	ə s k 'ɔ l t ə
Entro	'e n t ɾ o	'ə n t ɾ o
Eivissa	ə j v 'i s ə	ə i v 'i s ə
Dones	d 'ɔ n ə s	d 'o n ə s
Dimecres	d i m 'e k ɾ ə s	d i m 'ə k ɾ ə s
Del	d 'ə l	d ə l
Curs	k 'u s	k 'u ɾ s
Consciència	k o n t s i 'ɛ n s i ə	k o n t s i 'ə n s i ə
Ciències	s i 'ɛ n s i ə s	s i 'ə n s i ə s
Cerca	s 'ɛ ɾ k ə	s 'ə ɾ k ə
Celoni	s ə l 'ɔ n i	s ə l 'o n i
Volen	v 'o l ə n	v 'ɔ l ə n
Hi	'i	i
De	d 'ə	d ə
xops	ʃ 'o t s	ʃ 'ɔ p s
vinguessis	v i ŋ g 'e s i s	v i ŋ g 'ə s i s
viatja	v i 'a d ʒ ə	v i 'a dʒ ə
urgència	u ɾ ʒ 'ɛ n s i ə	u ɾ ʒ 'ə n s i ə
trepitjar	t ɾ ə p i d ʒ 'a	t ɾ ə p i dʒ 'a
tennis	t 'ɛ n n i s	t 'ə n n i s
tenda	t 'e n d ə	t 'ə n d ə
sorprèn	s o ɾ p ɾ 'ə n	s o ɾ p ɾ 'ɛ n
serem	s ə ɾ 'ə m	s ə ɾ 'ɛ m
sentència	s ə n t 'ɛ n s i ə	s ə n t 'ə n s i ə
sentint-se	s ə n t 'i n s ə	s ə n t 'i n t s ə
sens	s 'ə n s	s 'e n s
retorna	r ə t 'o ɾ n ə	r ə t 'ɔ ɾ n ə
relacioni	r ə l ə s i 'ɔ n i	r ə l ə s i 'o n i
rebuig	r ə β 'u t ʃ	r ə β 'u tʃ
pop	p 'o p	p 'ɔ p
poder-hi	p o ð 'ɛ ɾ i	p o ð 'ə ɾ i
percentatge	p ə ɾ s ə n t 'a d ʒ ə	p ə ɾ s ə n t 'a dʒ ə
pensi	p 'ɛ n s i	p 'ə n s i
passegem	p ə s ə ʒ 'ə m	p ə s ə ʒ 'ɛ m
ombra	'o m b ɾ ə	'ɔ m b ɾ ə
oi	'ɔ j	'o i
observem	o t s ə ɾ v 'ə m	o t s ə ɾ v 'ɛ m
morro	m 'o r o	m 'ɔ r o
lleixes	ʎ 'e ʃ ə s	ʎ 'ɛ ʃ ə s
irrompre	i r 'o m p ɾ ə	i r 'ɔ m p ɾ ə
incidència	i n s i ð 'ɛ n s i ə	i n s i ð 'ə n s i ə
incendi	i n s 'ɛ n d i	i n s 'ə n d i
greix	g ɾ 'e ʃ	g ɾ 'ɛ ʃ
fonda	f 'o n d ə	f 'ɔ n d ə
feble	f 'e b b l ə	f 'ə b b l ə
enèsima	ə n 'ɛ z i m ə	ə n 'ə z i m ə
domèstica	d o m 'ɛ s t i k ə	d o m 'ə s t i k ə
distendre	d i s t 'e n d ɾ ə	d i s t 'ə n d ɾ ə
danjs	d 'a j n s	d 'a ɲ s
cèntims	s 'ɛ n t i n s	s 'ə n t i n s
crèdits	k ɾ 'ɛ ð i t s	k ɾ 'ə ð i t s
corro	k 'o r o	k 'ɔ r o
copa	k 'o p ə	k 'ɔ p ə
concentren	k o n s 'e n t ɾ ə n	k o n s 'ə n t ɾ ə n
compres	k 'o m p ɾ ə s	k 'ɔ m p ɾ ə s
competència	k o m p ə t 'ɛ n s i ə	k o m p ə t 'ə n s i ə
bèstia	b 'ɛ s t i ə	b 'ə s t i ə
beix	b 'e ʃ	b 'ɛ ʃ
avantatges	ə v ə n t 'a d ʒ ə s	ə v ə n t 'a dʒ ə s
arruinats	ə r u j n 'a t s	ə r u i n 'a t s
afronta	ə f ɾ 'o n t ə	ə f ɾ 'ɔ n t ə
acostem	ə k o s t 'ə m	ə k o s t 'ɛ m
accepten	ə t s 'ɛ t t ə n	ə t s 'ə t t ə n
accepta	ə t s 'ɛ t t ə	ə t s 'ə t t ə
absort	ə t s 'ɔ ɾ t	ə t s 'o ɾ t
Tota	t 'o t ə	t 'ɔ t ə
Sistema	s i s t 'e m ə	s i s t 'ɛ m ə
Ronda	r 'o n d ə	r 'ɔ n d ə
Queda	k 'e ð ə	k 'ə ð ə
Presidència	p ɾ ə z i ð 'ɛ n s i ə	p ɾ ə z i ð 'ə n s i ə
Port	p 'ɔ ɾ t	p 'o ɾ t
Passem	p ə s 'ə m	p ə s 'ɛ m
Ginebra	ʒ i n 'e β ɾ ə	ʒ i n 'ə β ɾ ə
Agència	ə ʒ 'ɛ n s i ə	ə ʒ 'ə n s i ə
ètiques	'ɛ t i k ə s	'ə t i k ə s
que	k 'ə	k ə
Us	'u s	u s
Que	k 'ə	k ə
La	l 'ə	l ə
En	'ə n	ə n
xèrifs	ʃ 'ɛ ɾ i t s	ʃ 'ɛ ɾ i s
xopa	ʃ 'o p ə	ʃ 'ɔ p ə
xop	ʃ 'o p	ʃ 'ɔ p
xifratge	ʃ i f ɾ 'a d ʒ ə	ʃ i f ɾ 'a dʒ ə
whiskjs	b 'i s k i s	b 'i s k s
vuitens	v u j t 'ə n s	v u j t 'e n s
votarem	v o t ə ɾ 'ə m	v o t ə ɾ 'ɛ m
vingueren	v i ŋ g 'e ɾ ə n	v i ŋ g 'ɛ ɾ ə n
viatjaven	v i ə d ʒ 'a v ə n	v i ə dʒ 'a v ə n
viatjava	v i ə d ʒ 'a v ə	v i ə dʒ 'a v ə
viatjat	v i ə d ʒ 'a t	v i ə dʒ 'a t
viatgis	v i 'a d ʒ i s	v i 'a dʒ i s
viatgin	v i 'a d ʒ i n	v i 'a dʒ i n
viatgers	v i ə d ʒ 'e s	v i ə dʒ 'e s
viatge	v i 'a d ʒ ə	v i 'a dʒ ə
vespres	v 'e s p ɾ ə s	v 'ə s p ɾ ə s
venem	v ə n 'ə m	v ə n 'ɛ m
vegem	v ə ʒ 'ə m	v ə ʒ 'ɛ m
valoren	v ə l 'o ɾ ə n	v ə l 'ɔ ɾ ə n
utilitzarem	u t i l i d z ə ɾ 'ə m	u t i l i d z ə ɾ 'ɛ m
uniforme	u n i f 'o ɾ m ə	u n i f 'ɔ ɾ m ə
tèbia	t 'ə β i ə	t 'ɛ β i ə
tèbia	t 'ə β i ə	t 'ɛ β i ə
txecs	t ʃ 'ɛ t s	tʃ 'ɛ t s
tronxos	t ɾ 'o n ʃ o s	t ɾ 'ɔ n ʃ o s
trepitjats	t ɾ ə p i d ʒ 'a t s	t ɾ ə p i dʒ 'a t s
trepitjat	t ɾ ə p i d ʒ 'a t	t ɾ ə p i dʒ 'a t
trepitgés	t ɾ ə p i d ʒ 'e s	t ɾ ə p i dʒ 'e s
trepig	t ɾ ə p 'i t ʃ	t ɾ ə p 'i k
travessem	t ɾ ə v ə s 'ə m	t ɾ ə v ə s 'ɛ m
travessarem	t ɾ ə v ə s ə ɾ 'ə m	t ɾ ə v ə s ə ɾ 'ɛ m
trasplantessin	t ɾ ə s p l ə n t 'e s i n	t ɾ ə s p l ə n t 'ə s i n
transmetent-me	t ɾ ə n z m ə t 'e m m ə	t ɾ ə n z m ə t 'ə n m ə
transcorre	t ɾ ə n s k 'o r ə	t ɾ ə n s k 'ɔ r ə
tova	t 'o v ə	t 'ɔ v ə
totxo	t 'o t ʃ o	t 'ɔ tʃ o
totxanes	t o t ʃ 'a n ə s	t o tʃ 'a n ə s
totes	t 'o t ə s	t 'ɔ t ə s
tot	t 'o t	t 'ɔ t
torre	t 'o r ə	t 'ɔ r ə
torero	t o ɾ 'e ɾ o	t o ɾ 'ɛ ɾ o
torba	t 'o ɾ β ə	t 'ɔ ɾ β ə
topen	t 'o p ə n	t 'ɔ p ə n
tomba	t 'o m b ə	t 'ɔ m b ə
tirem	t i ɾ 'ə m	t i ɾ 'ɛ m
terraqüi	t ə r 'a k w i	t ə r 'a k i
tenis	t 'ɛ n i s	t 'ə n i s
tendències	t ə n d 'ɛ n s i ə s	t ə n d 'ə n s i ə s
te'm	t ə m	t 'ɛ m
te'l	t ə l	t 'ɛ l
tatuatges	t ə t u 'a d ʒ ə s	t ə t u 'a dʒ ə s
successos	s u t s 'e s o s	s u t s 'ə s o s
sospesen	s o s p 'e z ə n	s o s p 'ə z ə n
sorna	s 'o ɾ n ə	s 'ɔ ɾ n ə
sordmuda	s o ɾ m m 'u ð ə	s u ɾ m m 'u ð ə
sopes	s 'o p ə s	s 'ɔ p ə s
sopen	s 'o p ə n	s 'ɔ p ə n
sopa	s 'o p ə	s 'ɔ p ə
siguem	s i ɣ 'ə m	s i ɣ 'ɛ m
serens	s ə ɾ 'ə n s	s ə ɾ 'e n s
ser-ho	s 'e ɾ o	s 'ɛ ɾ o
ser-hi	s 'e ɾ i	s 'ɛ ɾ i
seqüències	s ə k w 'ɛ n s i ə s	s ə k w 'ə n s i ə s
separem	s ə p ə ɾ 'ə m	s ə p ə ɾ 'ɛ m
sentis	s 'e n t i s	s 'ɛ n t i s
sentint-me	s ə n t 'i m m ə	s ə n t 'i n m ə
senten	s 'e n t ə n	s 'ə n t ə n
sempre	s 'e m p ɾ ə	s 'ɛ m p ɾ ə
semblessin	s ə m b l 'e s i n	s ə m b l 'ə s i n
seleccionem	s ə l ə t s i o n 'ə m	s ə l ə t s i o n 'ɛ m
seitons	s ə j t 'o n s	s ə i t 'o n s
sapiens	s ə p i 'ə n s	s ə p i 'e n s
salvatjades	s ə l v ə d ʒ 'a ð ə s	s ə l v ə dʒ 'a ð ə s
salts	s 'a l s	s 'a l t s
salsitxes	s ə l s 'i t ʃ ə s	s ə l s 'i tʃ ə s
salpebra	s ə l p 'e β ɾ ə	s ə l p 'ə β ɾ ə
sahrauí	s ə ɾ ə w 'i	s ə r ə w 'i
rètols	r 'ɛ t o ls	r 'ə t o l s
règim	r 'ə ʒ i m	r 'ɛ ʒ i m
rèdit	r 'ɛ ð i t	r 'ə ð i t
rotonda	r o t 'o n d ə	r o t 'ɔ n d ə
rosses	r 'o s ə s	r 'ɔ s ə s
ronden	r 'o n d ə n	r 'ɔ n d ə n
ronca	r 'o ŋ k ə	r 'ɔ ŋ k ə
riem	r i 'ə m	r i 'ɛ m
reverència	r ə v ə ɾ 'ɛ n s i ə	r ə v ə ɾ 'ə n s i ə
respecto	r ə s p 'e t t o	r ə s p 'ɛ t t o
respectessin	r ə s p ə t t 'e s i n	r ə s p ə t t 'ə s i n
resolem	r ə z o l 'ə m	r ə z o l 'ɛ m
resistències	r ə z i s t 'ɛ n s i ə s	r ə z i s t 'ə n s i ə s
resistència	r ə z i s t 'ɛ n s i ə	r ə z i s t 'ə n s i ə
residències	r ə z i ð 'ɛ n s i ə s	r ə z i ð 'ə n s i ə s
resen	r 'e z ə n	r 'ə z ə n
res	r 'ɛ s	r 'ə s
reptes	r 'ɛ t t ə s	r 'ə t t ə s
reproduint-la	r ə p ɾ o ð u 'i n l ə	r ə p ɾ o ð 'u i n l ə
repliquem	r ə p l i k 'ə m	r ə p l i k 'ɛ m
rentatge	r ə n t 'a d ʒ ə	r ə n t 'a dʒ ə
renoven	r ə n 'o v ə n	r ə n 'ɔ v ə n
renecs	r ə n 'e t s	r ə n 'ə t s
rencontre	r ə ŋ k 'o n t ɾ ə	r ə ŋ k 'ɔ n t ɾ ə
remetrem	r ə m ə t ɾ 'ə m	r ə m ə t ɾ 'ɛ m
regne	r 'e n n ə	r 'ə n n ə
regla	r 'e g g l ə	r 'ə ɣ l ə
reexaminar	r e ə t s ə m i n 'a	r e ə d z ə m i n 'a
redimensioni	r ə ð i m ə n s i 'ɔ n i	r ə ð i m ə n s i 'o n i
recorren	r ə k 'o r ə n	r ə k 'ɔ r ə n
recordem	r ə k o ɾ ð 'ə m	r ə k o ɾ ð 'ɛ m
reconeixent-ne	r ə k o n ə ʃ 'e n n ə	r ə k o n ə ʃ 'ɛ n n ə
recomanem	r ə k o m ə n 'ə m	r ə k o m ə n 'ɛ m
recolzo	r ə k 'o l z o	r ə k 'ɔ l z o
recolzem	r ə k o l z 'ə m	r ə k o l z 'ɛ m
recolza	r ə k 'o l z ə	r ə k 'ɔ l z ə
receptes	r ə s 'ɛ t t ə s	r ə s 'ə t t ə s
rec	r 'e k	r 'ɛ k
rebutjava	r ə β u d ʒ 'a v ə	r ə β u dʒ 'a v ə
rebessin	r ə β 'e s i n	r ə β 'ə s i n
quedes	k 'e ð ə s	k 'ə ð ə s
quars	k w 'a s	k w 'a ɾ s
puntualitzem	p u n t u ə l i d z 'ə m	p u n t u ə l i d z 'ɛ m
prudència	p ɾ u ð 'ɛ n s i ə	p ɾ u ð 'ə n s i ə
promocionin	p ɾ o m o s i 'ɔ n i n	p ɾ o m o s i 'o n i n
profètics	p ɾ o f 'ɛ t i t s	p ɾ o f 'ə t i t s
procedirem	p ɾ o s ə ð i ɾ 'ə m	p ɾ o s ə ð i ɾ 'ɛ m
primigeni	p ɾ i m i ʒ 'ɛ n i	p ɾ i m i ʒ 'ə n i
pretenem	p ɾ ə t ə n 'ə m	p ɾ ə t ə n 'ɛ m
pretendre	p ɾ ə t 'e n d ɾ ə	p ɾ ə t 'ə n d ɾ ə
prestatgeria	p ɾ ə s t ə d ʒ ə ɾ 'i ə	p ɾ ə s t ə dʒ ə ɾ 'i ə
presentem	p ɾ ə z ə n t 'ə m	p ɾ ə z ə n t 'ɛ m
preromàntics	p ɾ ə r o m 'a n t i t s	p ɾ ə ɾ o m 'a n t i t s
prepararem	p ɾ ə p ə ɾ ə ɾ 'ə m	p ɾ ə p ə ɾ ə ɾ 'ɛ m
prengueren	p ɾ ə ŋ g 'e ɾ ə n	p ɾ ə ŋ g 'ɛ ɾ ə n
prenent-se	p ɾ ə n 'e n s ə	p ɾ ə n 'ɛ n s ə
premsa	p ɾ 'e n s ə	p ɾ 'ɛ n s ə
premem	p ɾ ə m 'ə m	p ɾ ə m 'ɛ m
preguntem	p ɾ ə ɣ u n t 'ə m	p ɾ ə ɣ u n t 'ɛ m
preferència	p ɾ ə f ə ɾ 'ɛ n s i ə	p ɾ ə f ə ɾ 'ə n s i ə
potència	p o t 'ɛ n s i ə	p o t 'ə n s i ə
posicioni	p o z i s i 'ɔ n i	p o z i s i 'o n i
posem	p o z 'ə m	p o z 'ɛ m
posarem	p o z ə ɾ 'ə m	p o z ə ɾ 'ɛ m
porta-me-les	p 'ɔ ɾ t ə m ə l ə s	p o ɾ t ə m 'ɛ l ə s
porro	p 'o r o	p 'ɔ r o
popes	p 'o p ə s	p 'ɔ p ə s
polèmica	p o l 'ɛ m i k ə	p o l 'ə m i k ə
podent	p o ð 'ɛ n t	p o ð 'e n t
plumero	p l u m 'e ɾ o	p l u m 'ə ɾ o
plorem	p l o ɾ 'ə m	p l o ɾ 'ɛ m
plecs	p l 'ɛ t s	p l 'ə t s
petxina	p ə t ʃ 'i n ə	p ə tʃ 'i n ə
perxes	p 'ɛ ɾ ʃ ə s	p 'ɛ ɾ s ə s
pertenences	p ə ɾ t ə n 'ɛ n s ə s	p ə ɾ t ə n 'ə n s ə s
persistència	p ə ɾ s i s t 'ɛ n s i ə	p ə ɾ s i s t 'ə n s i ə
perpetren	p ə ɾ p 'e t ɾ ə n	p ə ɾ p 'ə t ɾ ə n
perfectes	p ə ɾ f 'ɛ t t ə s	p ə ɾ f 'ə t t ə s
perdre-la	p 'ɛ ɾ ð ɾ ə l ə	p ə ɾ ð ɾ 'ɛ l ə
penetren	p ə n 'e t ɾ ə n	p ə n 'ə t ɾ ə n
patètiques	p ə t 'ɛ t i k ə s	p ə t 'ə t i k ə s
patrimoni	p ə t ɾ i m 'ɔ n i	p ə t ɾ i m 'o n i
parèntesis	p ə ɾ 'ɛ n t ə z i s	p ə ɾ 'ə n t ə z i s
parlarem	p ə ɾ l ə ɾ 'ə m	p ə ɾ l ə ɾ 'ɛ m
parcs	p 'a ɾ t s	p 'a ɾ s s
paratges	p ə ɾ 'a d ʒ ə s	p ə ɾ 'a dʒ ə s
paisatgisme	p ə j z ə d ʒ 'i z m ə	p ə j z ə dʒ 'i z m ə
paguem	p ə ɣ 'ə m	p ə ɣ 'ɛ m
ostatge	o s t 'a d ʒ ə	o s t 'a dʒ ə
orienten	o ɾ i 'e n t ə n	o ɾ i 'ə n t ə n
oratge	o ɾ 'a d ʒ ə	o ɾ 'a dʒ ə
operen	o p 'e ɾ ə n	o p 'ɛ ɾ ə n
oncle	'o ŋ k l ə	'ɔ ŋ k l ə
oloro	o l 'o ɾ o	o l 'ɔ ɾ o
oferirem	o f ə ɾ i ɾ 'ə m	o f ə ɾ i ɾ 'ɛ m
njaps	ɲ 'a t s	ɲ 'a s
notarem	n o t ə ɾ 'ə m	n o t ə ɾ 'ɛ m
netegessin	n ə t ə ʒ 'e s i n	n ə t ə ʒ 'ə s i n
negligència	n ə ɣ l i ʒ 'ɛ n s i ə	n ə ɣ l i ʒ 'ə n s i ə
nedes	n 'e ð ə s	n 'ə ð ə s
neden	n 'e ð ə n	n 'ɛ ð ə n
neanderthalensis	n e ə n d ə ɾ t ə l 'ɛ n s i s	n e ə n d ə ɾ t ə l 'ə n s i s
natges	n 'a d ʒ ə s	n 'a dʒ ə s
naps	n 'a t s	n 'a p s
naips	n 'a j t s	n 'a j s
mosso	m 'o s o	m 'ɔ s o
mosca	m 'o s k ə	m 'ɔ s k ə
morses	m 'o ɾ s ə s	m 'ɔ ɾ s ə s
morros	m 'o r o s	m 'ɔ r o s
mon	m 'o n	m o n
molèsties	m o l 'ɛ s t i ə s	m o l 'ə s t i ə s
molècules	m o l 'ə k u l ə s	m o l 'ɛ k u l ə s
moguem	m o ɣ 'ə m	m o ɣ 'ɛ m
modernes	m o ð 'ɛ ɾ n ə s	m o ð 'ə ɾ n ə s
moc	m 'o k	m 'ɔ k
miratge	m i ɾ 'a d ʒ ə	m i ɾ 'a dʒ ə
migmetratge	m i m m ə t ɾ 'a d ʒ ə	m i m m ə t ɾ 'a dʒ ə
metros	m 'e t ɾ o s	m 'ə t ɾ o s
mengem	m ə n ʒ 'ə m	m ə n ʒ 'ɛ m
megahertzos	m ə ɣ ə 'ɛ ɾ d z o s	m ə ɣ ə 'ə ɾ d z o s
matèries	m ə t 'ɛ ɾ i ə s	m ə t 'ə ɾ i ə s
massatge	m ə s 'a d ʒ ə	m ə s 'a dʒ ə
marxessin	m ə ɾ ʃ 'e s i n	m ə ɾ ʃ 'ə s i n
marxandatge	m ə ɾ ʃ ə n d 'a d ʒ ə	m ə ɾ ʃ ə n d 'a dʒ ə
magatzem	m ə ɣ ə d z 'ə m	m ə ɣ ə d z 'ɛ m
ma	m 'ə	m ə
lluirà	ʎ u i ɾ 'a	ʎ u j ɾ 'a
llesta	ʎ 'e s t ə	ʎ 'ə s t ə
llenja	ʎ 'e ɲ ə	ʎ 'ə ɲ ə
llengües	ʎ 'e ŋ g w ə s	ʎ 'ɛ ŋ g w ə s
llenci	ʎ 'ɛ n s i	ʎ 'ə n s i
llegendes	ʎ ə ʒ 'e n d ə s	ʎ ə ʒ 'ə n d ə s
llambordes	ʎ ə m b 'o ɾ ð ə s	ʎ ə m b 'ɔ ɾ ð ə s
lepra	l 'e p ɾ ə	l 'ə p ɾ ə
lamento	l ə m 'e n t o	l ə m 'ə n t o
jutge	ʒ 'u d ʒ ə	ʒ 'u dʒ ə
jueva	ʒ u 'e v ə	ʒ u 'ə v ə
interrompre	i n t ə r 'o m p ɾ ə	i n t ə r 'ɔ m p ɾ ə
interpretem	i n t ə ɾ p ɾ ə t 'ə m	i n t ə ɾ p ɾ ə t 'ɛ m
interferència	i n t ə ɾ f ə ɾ 'ɛ n s i ə	i n t ə ɾ f ə ɾ 'ə n s i ə
intentem	i n t ə n t 'ə m	i n t ə n t 'ɛ m
intentarem	i n t ə n t ə ɾ 'ə m	i n t ə n t ə ɾ 'ɛ m
ingresses	i ŋ g ɾ 'e s ə s	i ŋ g ɾ 'ə s ə s
indolència	i n d o l 'ɛ n s i ə	i n d o l 'ə n s i ə
incorporem	i ŋ k o ɾ p o ɾ 'ə m	i ŋ k o ɾ p o ɾ 'ɛ m
inconsistència	i ŋ k o n s i s t 'ɛ n s i ə	i ŋ k o n s i s t 'ə n s i ə
incerts	i n s 'ɛ ɾ s	i n s 'ɛ ɾ t s
incendis	i n s 'ɛ n d i s	i n s 'ə n d i s
import	i m p 'ɔ ɾ t	i m p 'o ɾ t
imperfecte	i m p ə ɾ f 'ɛ t t ə	i m p ə ɾ f 'ə t t ə
impaciència	i m p ə s i 'ɛ n s i ə	i m p ə s i 'ə n s i ə
imaginem	i m ə ʒ i n 'ə m	i m ə ʒ i n 'ɛ m
ignoren	i n n 'o ɾ ə n	i n n 'ɔ ɾ ə n
idoni	i ð 'ɔ n i	i ð 'o n i
horts	'ɔ ɾ s	ə ɾ t s
hora	'ɔ ɾ ə	ə ɾ ə
hola	'ɔ l ə	ə l ə
histèrics	i s t 'ɛ ɾ i t s	i s t 'ə ɾ i t s
haguessis	ə ɣ 'e s i s	ə ɣ 'ə s i s
haguessin	ə ɣ 'e s i n	ə ɣ 'ə s i n
guspires	g u s p 'i ɾ ə s	g s p 'i ɾ ə s
guspira	g u s p 'i ɾ ə	g s p 'i ɾ ə
guinda	g 'i n d ə	g w 'i n d ə
guiarem	g i ə ɾ 'ə m	g i ə ɾ 'ɛ m
guetos	g 'e t o s	g 'ə t o s
guanjem	g w ə ɲ 'ə m	g w ə ɲ 'ɛ m
guanjarem	g w ə ɲ ə ɾ 'ə m	g w ə ɲ ə ɾ 'ɛ m
guanjant-me	g w ə ɲ 'a m m ə	g w ə ɲ 'a n m ə
grups	g ɾ 'u t s	g ɾ 'u p s
greixos	g ɾ 'e ʃ o s	g ɾ 'ɛ ʃ o s
golfo	g 'o l f o	g 'ɔ l f o
girem	ʒ i ɾ 'ə m	ʒ i ɾ 'ɛ m
genètics	ʒ ə n 'ɛ t i t s	ʒ ə n 'ə t i t s
genèrica	ʒ ə n 'ɛ ɾ i k ə	ʒ ə n 'ə ɾ i k ə
generen	ʒ ə n 'e ɾ ə n	ʒ ə n 'ɛ ɾ ə n
gemecs	ʒ ə m 'e t s	ʒ ə m 'ɛ t s
gemec	ʒ ə m 'e k	ʒ ə m 'ɛ k
gaspatxo	g ə s p 'a t ʃ o	g ə s p 'a tʃ o
garatges	g ə ɾ 'a d ʒ ə s	g ə ɾ 'a dʒ ə s
fèlids	f 'ɛ l i t s	f 'ə l i t s
fuig	f 'u t ʃ	f 'u tʃ
frenètic	f ɾ ə n 'ɛ t i k	f ɾ ə n 'ə t i k
frens	f ɾ 'ə n s	f ɾ 'e n s
fots	f 'o t s	f 'ɔ t s
fotre-li	f 'o t ɾ ə l i	f o t ɾ 'ɛ l i
fot	f 'o t	f 'ɔ t
formatges	f o ɾ m 'a d ʒ ə s	f o ɾ m 'a dʒ ə s
foques	f 'o k ə s	f 'ɔ k ə s
florint-se	f l o ɾ 'i n s ə	f l o ɾ 'i n t s ə
fletxes	f l 'e t ʃ ə s	f l 'ə tʃ ə s
fletxa	f l 'e t ʃ ə	f l 'ɛ tʃ ə
fiquessin	f i k 'e s i n	f i k 'ə s i n
fetus	f 'ɛ t u s	f 'ə t u s
fermes	f 'ɛ ɾ m ə s	f 'ə ɾ m ə s
fer-hi	f 'e ɾ i	f 'ɛ ɾ i
fent-se	f 'e n s ə	f 'ɛ n s ə
fent-lo	f 'e n l o	f 'ə n l o
fen	f 'e n	f 'ə n
feixos	f 'e ʃ o s	f 'ɛ ʃ o s
fantasiós	f ə n t ə z i 'o s	f ə n t ə s i 'o s
fantasies	f ə n t ə z 'i ə s	f ə n t ə s 'i ə s
evolucioni	ə v o l u s i 'ɔ n i	ə v o l u s i 'o n i
estudiïn	ə s t u ð 'i i n	ə s t u ð i 'i n
estudiarem	ə s t u ð i ə ɾ 'ə m	ə s t u ð i ə ɾ 'ɛ m
estris	'ɛ s t ɾ i s	'ə s t ɾ i s
estrenjent-me	ə s t ɾ ə ɲ 'e m m ə	ə s t ɾ ə ɲ 'ə n m ə
estratègia	ə s t ɾ ə t 'ə ʒ i ə	ə s t ɾ ə t 'ɛ ʒ i ə
estarem	ə s t ə ɾ 'ə m	ə s t ə ɾ 'ɛ m
essència	ə s 'ɛ n s i ə	ə s 'ə n s i ə
esquitxen	ə s k 'i t ʃ ə n	ə s k 'i tʃ ə n
esprimatxat	ə s p ɾ i m ə t ʃ 'a t	ə s p ɾ i m ə tʃ 'a t
esport	ə s p 'ɔ ɾ t	ə s p 'o ɾ t
esment	ə z m 'e n t	e z m 'e n t
esgrogueint-se	ə z ɣ ɾ o ɣ ə 'i n s ə	ə z ɣ ɾ o ɣ 'ə j n t s ə
escrivint-te	ə s k ɾ i v 'i n t ə	ə s k ɾ i v 'i n t t ə
escombra	ə s k 'o m b ɾ ə	ə s k 'ɔ m b ɾ ə
escolto	ə s k 'o l t o	ə s k 'ɔ l t o
escoltes	ə s k 'o l t ə s	ə s k 'ɔ l t ə s
escoltem	ə s k o l t 'ə m	ə s k o l t 'ɛ m
enutjat	ə n u d ʒ 'a t	ə n u dʒ 'a t
enuig	ə n 'u t ʃ	ə n 'u tʃ
entenem	ə n t ə n 'ə m	ə n t ə n 'ɛ m
ensenji	ə n s 'ɛ ɲ i	ə n s 'ə ɲ i
ensenjem	ə n s ə ɲ 'ə m	ə n s ə ɲ 'ɛ m
ensenjarem	ə n s ə ɲ ə ɾ 'ə m	ə n s ə ɲ ə ɾ 'ɛ m
engranatge	ə ŋ g ɾ ə n 'a d ʒ ə	ə ŋ g ɾ ə n 'a dʒ ə
enginjs	ə n ʒ 'i j n s	ə n ʒ 'i ɲ s
enganjem	ə ŋ g ə ɲ 'ə m	ə ŋ g ə ɲ 'ɛ m
enganxarem	ə ŋ g ə n ʃ ə ɾ 'ə m	ə ŋ g ə n ʃ ə ɾ 'ɛ m
endreço	ə n d ɾ 'e s o	ə n d ɾ 'ə s o
enciclopèdia	ə n s i k l o p 'ɛ ð i ə	ə n s i k l o p 'ə ð i ə
encaminem	ə ŋ k ə m i n 'ə m	ə ŋ k ə m i n 'ɛ m
empentes	ə m p 'ə n t ə s	ə m p 'e n t ə s
empenta	ə m p 'ə n t ə	ə m p 'e n t ə
emborratxant-me	ə m b o r ə t ʃ 'a m m ə	ə m b o r ə tʃ 'a n m ə
emborratxa	ə m b o r 'a t ʃ ə	ə m b o r 'a tʃ ə
eliminem	ə l i m i n 'ə m	ə l i m i n 'ɛ m
dèries	d 'ɛ ɾ i ə s	d 'ə ɾ i ə s
dèficits	d 'ɛ f i s i t s	d 'ə f i s i t s
dutxat	d u t ʃ 'a t	d u tʃ 'a t
duem	d u 'ə m	d u 'ɛ m
donessin	d o n 'e s i n	d o n 'ə s i n
donarem	d o n ə ɾ 'ə m	d o n ə ɾ 'ɛ m
docència	d o s 'ɛ n s i ə	d o s 'ə n s i ə
disposo	d i s p 'o z o	d i s p 'ɔ z o
discrepo	d i s k ɾ 'e p o	d i s k ɾ 'ə p o
discjòqueis	d i s k ʒ 'ɔ k ə j s	d i s k ʒ 'ɔ k ə i s
digueren	d i ɣ 'e ɾ ə n	d i ɣ 'ɛ ɾ ə n
dient-se	d i 'e n s ə	d i 'ɛ n s ə
diem	d i 'ə m	d i 'ɛ m
dibuixant-me	d i β u ʃ 'a m m ə	d i β u ʃ 'a n m ə
destorben	d ə s t 'o ɾ β ə n	d ə s t 'ɔ ɾ β ə n
desordres	d ə z 'o ɾ ð ɾ ə s	d ə z 'ɔ ɾ ð ɾ ə s
desordre	d ə z 'o ɾ ð ɾ ə	d ə z 'ɔ ɾ ð ɾ ə
desitjat	d ə z i d ʒ 'a t	d ə z i dʒ 'a t
desitjaria	d ə z i d ʒ ə ɾ 'i ə	d ə z i dʒ ə ɾ 'i ə
desitgi	d ə z 'i d ʒ i	d ə z 'i dʒ i
desitges	d ə z 'i d ʒ ə s	d ə z 'i dʒ ə s
desitgem	d ə z i d ʒ 'ə m	d ə z i dʒ 'ɛ m
desigs	d ə z 'i t ʃ s	d ə z 'i s
desemboca	d ə z ə m b 'o k ə	d ə z ə m b 'ɔ k ə
descendència	d ə t s ə n d 'ɛ n s i ə	d ə t s ə n d 'ə n s i ə
demanarem	d ə m ə n ə ɾ 'ə m	d ə m ə n ə ɾ 'ɛ m
deixes	d 'e ʃ ə s	d 'ə ʃ ə s
deficiència	d ə f i s i 'ɛ n s i ə	d ə f i s i 'ə n s i ə
cèlebre	s 'ɛ l ə β ɾ ə	s 'ə l ə β ɾ ə
curs	k 'u s	k 'u ɾ s
cromos	k ɾ 'o m o s	k ɾ 'ɔ m o s
creïn	k ɾ 'e i n	k ɾ ə 'i n
cremes	k ɾ 'e m ə s	k ɾ 'ɛ m ə s
cremen	k ɾ 'e m ə n	k ɾ 'ɛ m ə n
crema	k ɾ 'e m ə	k ɾ 'ɛ m ə
creixerem	k ɾ ə ʃ ə ɾ 'ə m	k ɾ ə ʃ ə ɾ 'ɛ m
cosa	k 'ɔ z ə	k 'o z ə
correspondències	k o r ə s p o n d 'ɛ n s i ə s	k o r ə s p o n d 'ə n s i ə s
correm	k o r 'ə m	k o r 'ɛ m
corregirem	k o r ə ʒ i ɾ 'ə m	k o r ə ʒ i ɾ 'ɛ m
copsem	k o t s 'ə m	k o s 'ɛ m
continuessin	k o n t i n u 'e s i n	k o n t i n u 'ə s i n
continuem	k o n t i n u 'ə m	k o n t i n u 'ɛ m
contestem	k o n t ə s t 'ə m	k o n t ə s t 'ɛ m
contenen	k o n t 'e n ə n	k o n t 'ə n ə n
contemplem	k o n t ə m p l 'ə m	k o n t ə m p l 'ɛ m
consta	k 'o n s t ə	k 'ɔ n s t ə
consistència	k o n s i s t 'ɛ n s i ə	k o n s i s t 'ə n s i ə
considero	k o n s i ð 'e ɾ o	k o n s i ð 'ə ɾ o
conques	k 'o ŋ k ə s	k 'ɔ ŋ k ə s
connecta	k o n n 'e t t ə	k o n n 'ɛ t t ə
coneixerem	k o n ə ʃ ə ɾ 'ə m	k o n ə ʃ ə ɾ 'ɛ m
coneixem	k o n ə ʃ 'ə m	k o n ə ʃ 'ɛ m
concretem	k o ŋ k ɾ ə t 'ə m	k o ŋ k ɾ ə t 'ɛ m
concentrem	k o n s ə n t ɾ 'ə m	k o n s ə n t ɾ 'ɛ m
comtats	k o n t 'a t s	k o m 'a t s
comprèn	k o m p ɾ 'ə n	k o m p ɾ 'ɛ n
comprovem	k o m p ɾ o v 'ə m	k o m p ɾ o v 'ɛ m
comprometem	k o m p ɾ o m ə t 'ə m	k o m p ɾ o m ə t 'ɛ m
completi	k o m p l 'ɛ t i	k o m p l 'ə t i
completa-la	k o m p l 'ə t ə l ə	k o m p l ə t 'a l ə
complementem	k o m p l ə m ə n t 'ə m	k o m p l ə m ə n t 'ɛ m
comparèixer	k o m p ə ɾ 'ə ʃ ə	k o m p ə ɾ 'ɛ ʃ ə
comparsero	k o m p ə ɾ s 'e ɾ o	k o m p ə ɾ s 'ɛ ɾ o
comentem	k o m ə n t 'ə m	k o m ə n t 'ɛ m
comencin	k o m 'ɛ n s i n	k o m 'ə n s i n
comenci	k o m 'ɛ n s i	k o m 'ə n s i
comences	k o m 'ɛ n s ə s	k o m 'ə n s ə s
coincidència	k o i n s i ð 'ɛ n s i ə	k o i n s i ð 'ə n s i ə
cofoi	k o f 'ɔ j	k o f 'o i
coco	k 'o k o	k 'ɔ k o
cliquem	k l i k 'ə m	k l i k 'ɛ m
cinèfils	s i n 'ɛ f i l s	s i n 'ə f i l s
cerquem	s ə ɾ k 'ə m	s ə ɾ k 'ɛ m
celebren	s ə l 'e β ɾ ə n	s ə l 'ə β ɾ ə n
cec	s 'e k	s 'ɛ k
carència	k ə ɾ 'ɛ n s i ə	k ə ɾ 'ə n s i ə
cars	k 'a s	k 'a ɾ s
carruatges	k ə r u 'a d ʒ ə s	k ə r u 'a dʒ ə s
carruatge	k ə r u 'a d ʒ ə	k ə r u 'a dʒ ə
carboni	k ə ɾ β 'ɔ n i	k ə ɾ β 'o n i
caputxeta	k ə p u t ʃ 'ə t ə	k ə p u tʃ 'ə t ə
capritxós	k ə p ɾ i t ʃ 'o s	k ə p ɾ i tʃ 'o s
capbussar	k ə b b u s 'a	k ə p b b u s 'a
brots	b ɾ 'o t s	b ɾ 'ɔ t s
bot	b 'o t	b 'ɔ t
borden	b 'o ɾ ð ə n	b 'ɔ ɾ ð ə n
bolquen	b 'o l k ə n	b 'ɔ l k ə n
boirina	b o j ɾ 'i n ə	b o i ɾ 'i n ə
bes	b 'e s	b 'ə s
benèvol	b ə n 'ɛ v o l	b ə n 'ə v o l
barbs	b 'a ɾ t s	b 'a ɾ s
baixem	b ə ʃ 'ə m	b ə ʃ 'ɛ m
baixarem	b ə ʃ ə ɾ 'ə m	b ə ʃ ə ɾ 'ɛ m
avaluarem	ə v ə l u ə ɾ 'ə m	ə v ə l u ə ɾ 'ɛ m
atxes	'a t ʃ ə s	'a tʃ ə s
aturem	ə t u ɾ 'ə m	ə t u ɾ 'ɛ m
atribuir-ho	ə t ɾ i β u 'i ɾ o	ə t ɾ i β 'u j ɾ o
aterratge	ə t ə r 'a d ʒ ə	ə t ə r 'a dʒ ə
atendrem	ə t ə n d ɾ 'ə m	ə t ə n d ɾ 'ɛ m
assaigs	ə s 'a t ʃ s	ə s 'a tʃ s
asimètrica	ə s i m 'ɛ t ɾ i k ə	ə z i m 'ə t ɾ i k ə
arribessin	ə r i β 'e s i n	ə r i β 'ə s i n
arribem	ə r i β 'ə m	ə r i β 'ɛ m
arregla	ə r 'e g g l ə	ə r 'ɛ g g l ə
aritmètiques	ə ɾ i m m 'ɛ t i k ə s	ə ɾ i m m 'ə t i k ə s
aritmètica	ə ɾ i m m 'ɛ t i k ə	ə ɾ i m m 'ə t i k ə
aritmètic	ə ɾ i m m 'ɛ t i k	ə ɾ i m m 'ə t i k
arcs	'a ɾ t s	'a ɾ s s
aproven	ə p ɾ 'o v ə n	ə p ɾ 'ɔ v ə n
aprenentatge	ə p ɾ ə n ə n t 'a d ʒ ə	ə p ɾ ə n ə n t 'a dʒ ə
aportessin	ə p o ɾ t 'e s i n	ə p o ɾ t 'ə s i n
apliquem	ə p l i k 'ə m	ə p l i k 'ɛ m
aparegueren	ə p ə ɾ ə ɣ 'e ɾ ə n	ə p ə ɾ ə ɣ 'ɛ ɾ ə n
anomenem	ə n o m ə n 'ə m	ə n o m ə n 'ɛ m
angèlica	ə n ʒ 'ɛ l i k ə	ə n ʒ 'ə l i k ə
anessin	ə n 'e s i n	ə n 'ə s i n
alts	'a l s	'a l t s
alteren	ə l t 'e ɾ ə n	ə l t 'ɛ ɾ ə n
alertes	ə l 'ɛ ɾ t ə s	ə l 'ə ɾ t ə s
alegre	ə l 'e ɣ ɾ ə	ə l 'ə ɣ ɾ ə
ajudarem	ə ʒ u ð ə ɾ 'ə m	ə ʒ u ð ə ɾ 'ɛ m
aixeco	ə ʃ 'e k o	ə ʃ 'ɛ k o
aixeca	ə ʃ 'e k ə	ə ʃ 'ɛ k ə
agència	ə ʒ 'ɛ n s i ə	ə ʒ 'ə n s i ə
agafessin	ə ɣ ə f 'e s i n	ə ɣ ə f 'ə s i n
agafarem	ə ɣ ə f ə ɾ 'ə m	ə ɣ ə f ə ɾ 'ɛ m
afecten	ə f 'ɛ t t ə n	ə f 'ə t t ə n
afecte	ə f 'ɛ t t ə	ə f 'ə t t ə
adscrit	ə s k ɾ 'i t	ə t s k ɾ 'i t
adornen	ə ð 'o ɾ n ə n	ə ð 'ɔ ɾ n ə n
adjuntar	ə d ʒ u n t 'a	ə dʒ u n t 'a
adjudica	ə d ʒ u ð 'i k ə	ə dʒ u ð 'i k ə
adjacent	ə d ʒ ə s 'e n t	ə dʒ ə s 'e n t
adequa	ə ð 'e k w ə	ə ð 'ɛ k w ə
actualitzem	ə t t u ə l i d z 'ə m	ə t t u ə l i d z 'ɛ m
acceptarem	ə t s ə t t ə ɾ 'ə m	ə t s ə t t ə ɾ 'ɛ m
aboquem	ə β o k 'ə m	ə β o k 'ɛ m
a	'ə	ə
Zürich	z u ɾ 'i k	g w ɾ 'i k
Xènia	ʃ 'ɛ n i ə	ʃ 'ə n i ə
Xop	ʃ 'o p	ʃ 'ɔ p
Weissmann	b ə j s m 'a n n	b ə i s m 'a n n
Webs	b 'e t s	b 'ə t s
Vicent	v i s 'ɛ n t	v i s 'e n t
Viatjava	v i ə d ʒ 'a v ə	v i ə dʒ 'a v ə
Viatges	v i 'a d ʒ ə s	v i 'a dʒ ə s
Ve	v 'e	v 'ə
Urgències	u ɾ ʒ 'ɛ n s i ə s	u ɾ ʒ 'ə n s i ə s
Unesco	u n 'e s k o	u n 'ə s k o
Txetxènia	t ʃ ə t ʃ 'ɛ n i ə	tʃ ə tʃ 'ə n i ə
Triarem	t ɾ i ə ɾ 'ə m	t ɾ i ə ɾ 'ɛ m
Trepitjant	t ɾ ə p i d ʒ 'a n t	t ɾ ə p i dʒ 'a n t
Transports	t ɾ ə n s p 'ɔ ɾ s	t ɾ ə n s p 'o ɾ t s
Transport	t ɾ ə n s p 'ɔ ɾ t	t ɾ ə n s p 'o ɾ t
Tort	t 'ɔ ɾ t	t 'o ɾ t
Torno	t 'o ɾ n o	t 'ɔ ɾ n o
Ton	t 'o n	t o n
Tema	t 'e m ə	t 'ɛ m ə
Te	t 'ə	t ə
Taipei	t ə j p 'ə j	t ə i p 'ə j
Sortirem	s o ɾ t i ɾ 'ə m	s o ɾ t i ɾ 'ɛ m
Sobre	s 'o β ɾ ə	s 'ɔ β ɾ ə
Sistemes	s i s t 'e m ə s	s i s t 'ɛ m ə s
Sistema	s i s t 'e m ə	s i s t 'ɛ m ə
Serem	s ə ɾ 'ə m	s ə ɾ 'ɛ m
Saps	s 'a t s	s 'a p s
Reconèixer	r ə k o n 'ə ʃ ə	r ə k o n 'ɛ ʃ ə
Quedo	k 'e ð o	k 'ə ð o
Posem	p o z 'ə m	p o z 'ɛ m
Portem	p o ɾ t 'ə m	p o ɾ t 'ɛ m
Ponència	p o n 'ɛ n s i ə	p o n 'ə n s i ə
Pingu	p 'i ŋ g u	p 'i ŋ g
Penèlope	p ə n 'ɛ l o p ə	p ə n 'ə l o p ə
Peix	p 'e ʃ	p 'ɛ ʃ
Parts	p 'a ɾ s	p 'a ɾ t s
Ordre	'o ɾ ð ɾ ə	'ɔ ɾ ð ɾ ə
Omple	'o m p l ə	'ɔ m p l ə
Nois	n 'ɔ j s	n 'o i s
Neix	n 'e ʃ	n 'ɛ ʃ
Mostrarem	m o s t ɾ ə ɾ 'ə m	m o s t ɾ ə ɾ 'ɛ m
Mossos	m 'o s o s	m 'ɔ s o s
Montsià	m o n s i 'a	m o n t s i 'a
Montsenj	m o n s 'ə ɲ	m o n t s 'ə ɲ
Molta	m 'o l t ə	m 'ɔ l t ə
Mitjà	m i d ʒ 'a	m i dʒ 'a
Missatger	m i s ə d ʒ 'e	m i s ə dʒ 'e
Menja	m 'e n ʒ ə	m 'ə n ʒ ə
Martens	m ə ɾ t 'ə n s	m ə ɾ t 'e n s
Malone	m ə l 'o n ə	m ə l 'ɔ n ə
Lo	l 'o	l o
Llicència	ʎ i s 'ɛ n s i ə	ʎ i s 'ə n s i ə
Llevo	ʎ 'e v o	ʎ 'ə v o
Jutja	ʒ 'u d ʒ ə	ʒ 'u dʒ ə
Jofre	ʒ 'o f ɾ ə	ʒ 'ɔ f ɾ ə
Jerusalem	ʒ ə ɾ u z ə l 'ə m	ʒ ə ɾ u z ə l 'ɛ m
Jeroni	ʒ ə ɾ 'ɔ n i	ʒ ə ɾ 'o n i
Intentarem	i n t ə n t ə ɾ 'ə m	i n t ə n t ə ɾ 'ɛ m
Ignoro	i n n 'o ɾ o	i n n 'ɔ ɾ o
Ibèrica	i β 'ɛ ɾ i k ə	i β 'ə ɾ i k ə
Hug	'u k	ə k
Haig	'a t ʃ	'a tʃ
Habitatge	ə β i t 'a d ʒ ə	ə β i t 'a dʒ ə
Günther	g w n t 'e	g w n tʃ 'e
Fent-ho	f 'e n t o	f 'ɛ n t o
Esports	ə s p 'ɔ ɾ s	ə s p 'o ɾ t s
Entren	'e n t ɾ ə n	'ə n t ɾ ə n
Encoratjo	ə ŋ k o ɾ 'a d ʒ o	ə ŋ k o ɾ 'a dʒ o
Elisenda	ə l i z 'e n d ə	ə l i z 'ə n d ə
Eindhoven	ə j n d 'o v ə n	ə i n d 'ɔ v ə n
Efecte	ə f 'ɛ t t ə	ə f 'ə t t ə
Ebre	'e β ɾ ə	'ə β ɾ ə
Ebre	'e β ɾ ə	'ə β ɾ ə
EAJA	e 'a ʒ ə	ə 'a ʒ ə
Donarem	d o n ə ɾ 'ə m	d o n ə ɾ 'ɛ m
Disposem	d i s p o z 'ə m	d i s p o z 'ɛ m
Detroit	d ə t ɾ 'ɔ j t	d ə t ɾ 'o i t
Desitjo	d ə z 'i d ʒ o	d ə z 'i dʒ o
Desitjava	d ə z i d ʒ 'a v ə	d ə z i dʒ 'a v ə
Dedicarem	d ə ð i k ə ɾ 'ə m	d ə ð i k ə ɾ 'ɛ m
Darrere	d ə r 'e ɾ ə	d ə r 'ə ɾ ə
Copia-la	k o p 'i ə l ə	k o p i 'a l ə
Copa	k 'o p ə	k 'ɔ p ə
Conèixer	k o n 'ə ʃ ə	k o n 'ɛ ʃ ə
Contem	k o n t 'ə m	k o n t 'ɛ m
Consta	k 'o n s t ə	k 'ɔ n s t ə
Connecta	k o n n 'e t t ə	k o n n 'ɛ t t ə
Comparseros	k o m p ə ɾ s 'e ɾ o s	k o m p ə ɾ s 'ɛ ɾ o s
Comences	k o m 'ɛ n s ə s	k o m 'ə n s ə s
Ciència	s i 'ɛ n s i ə	s i 'ə n s i ə
Chirac	t ʃ i ɾ 'a k	s i ɾ 'a k
Carreras	k ə r 'e ɾ ə s	k ə r 'ɛ ɾ ə s
Carnero	k ə ɾ n 'e ɾ o	k ə ɾ n 'ə ɾ o
Caputxeta	k ə p u t ʃ 'ə t ə	k ə p u tʃ 'ə t ə
Cambotja	k ə m b 'ɔ d ʒ ə	k ə m b 'ɔ dʒ ə
Bodes	b 'o ð ə s	b 'ɔ ð ə s
Bangkok	b ə ŋ k k 'o k	b ə ŋ g k 'o k
Aèria	ə 'ɛ ɾ i ə	ə 'ə ɾ i ə
Arts	'a ɾ s	'a ɾ t s
Anirem	ə n i ɾ 'ə m	ə n i ɾ 'ɛ m
Aixeca	ə ʃ 'e k ə	ə ʃ 'ɛ k ə
Agustí	ə ɣ u s t 'i	ə ɣ s t 'i
Agenda	ə ʒ 'e n d ə	ə ʒ 'ə n d ə
el	'ə l	ə l
amb	'ə m	ə m b
oi	'ɔ j	'o i
o	'ɔ	'o
es	'ə s	ə s
el	'ə l	ə l
a	'ə	ə
Viatjarà	v i ə d ʒ ə ɾ 'a	v i ə dʒ ə ɾ 'a
Totes	t 'o t ə s	t 'ɔ t ə s
Tindrem	t i n d ɾ 'ə m	t i n d ɾ 'ɛ m
Si	s 'i	s i
Li	l 'i	l i
I	'i	i
Ho	'o	o
He	'e	'ɛ
Et	'ə t	ə t
Estarem	ə s t ə ɾ 'ə m	ə s t ə ɾ 'ɛ m
que	k 'ə	k ə
hi	'i	i
com	k 'ɔ m	k 'o m
Si	s 'i	s i
Queda	k 'e ð ə	k 'ə ð ə
I	'i	i
He	'e	'ɛ
Com	k 'ɔ m	k 'o m
Amb	'ə m	ə m b
xilens	ʃ i l 'ə n s	ʃ i l 'e n s
visionem	v i z i o n 'ə m	v i z i o n 'ɛ m
viatger	v i ə d ʒ 'e	v i ə dʒ 'e
urgències	u ɾ ʒ 'ɛ n s i ə s	u ɾ ʒ 'ə n s i ə s
txetxena	t ʃ ə t ʃ 'ə n ə	tʃ ə tʃ 'ə n ə
txeca	t ʃ 'ɛ k ə	tʃ 'ɛ k ə
tropes	t ɾ 'o p ə s	t ɾ 'ɔ p ə s
trigonomètriques	t ɾ i ɣ o n o m 'ɛ t ɾ i k ə s	t ɾ i ɣ o n o m 'ə t ɾ i k ə s
trigonomètriques	t ɾ i ɣ o n o m 'ɛ t ɾ i k ə s	t ɾ i ɣ o n o m 'ə t ɾ i k ə s
treva	t ɾ 'e v ə	t ɾ 'ə v ə
trepitjant	t ɾ ə p i d ʒ 'a n t	t ɾ ə p i dʒ 'a n t
tornem	t o ɾ n 'ə m	t o ɾ n 'ɛ m
torben	t 'o ɾ β ə n	t 'ɔ ɾ β ə n
temple	t 'e m p l ə	t 'ɛ m p l ə
tatxa	t 'a t ʃ ə	t 'a tʃ ə
tanquessin	t ə ŋ k 'e s i n	t ə ŋ k 'ə s i n
sjs	s 'i s	s s
suspens	s u s p 'ə n s	s u s p 'e n s
surrealisme	s u r e ə l 'i z m ə	s u ɾ r e ə l 'i z m ə
sortints	s o ɾ t 'i n s	s o ɾ t 'i n t s
sopem	s o p 'ə m	s o p 'ɛ m
sexi	s 'ɛ t s i	s 'ə t s i
senglars	s ə ŋ g l 'a s	s ə ŋ g l 'a ɾ s
segles	s 'e g g l ə s	s 'ə ɣ l ə s
sapiguem	s ə p i ɣ 'ə m	s ə p i ɣ 'ɛ m
rossa	r 'o s ə	r 'ɔ s ə
ressort	r ə s 'ɔ ɾ t	r ə s 'o ɾ t
rentessin	r ə n t 'e s i n	r ə n t 'ə s i n
removent-se	r ə m o v 'e n s ə	r ə m o v 'ɛ n s ə
reciclatge	r ə s i k l 'a d ʒ ə	r ə s i k l 'a dʒ ə
recepta	r ə s 'ɛ t t ə	r ə s 'ə t t ə
rebutja	r ə β 'u d ʒ ə	r ə β 'u dʒ ə
qüestionen	k w ə s t i 'o n ə n	k w ə s t i 'ɔ n ə n
puig	p 'u t ʃ	p 'u tʃ
prènsil	p ɾ 'ɛ n s i l	p ɾ 'ə n s i l
provoquen	p ɾ o v 'o k ə n	p ɾ o v 'ɔ k ə n
promocioni	p ɾ o m o s i 'ɔ n i	p ɾ o m o s i 'o n i
promig	p ɾ o m 'i t ʃ	p ɾ o m 'i k
promig	p ɾ o m 'i t ʃ	p ɾ o m 'i k
progressos	p ɾ o ɣ ɾ 'e s o s	p ɾ o ɣ ɾ 'ə s o s
procurem	p ɾ o k u ɾ 'ə m	p ɾ o k u ɾ 'ɛ m
procedència	p ɾ o s ə ð 'ɛ n s i ə	p ɾ o s ə ð 'ə n s i ə
pretenen	p ɾ ə t 'e n ə n	p ɾ ə t 'ə n ə n
presentessin	p ɾ ə z ə n t 'e s i n	p ɾ ə z ə n t 'ə s i n
preceptes	p ɾ ə s 'ɛ t t ə s	p ɾ ə s 'ə t t ə s
portessin	p o ɾ t 'e s i n	p o ɾ t 'ə s i n
polèmiques	p o l 'ɛ m i k ə s	p o l 'ə m i k ə s
polze	p 'o l z ə	p 'ɔ l z ə
podriem	p o ð ɾ i 'ə m	p o ð ɾ i 'ɛ m
pitjor	p i d ʒ 'o	p i dʒ 'o
pertinences	p ə ɾ t i n 'ɛ n s ə s	p ə ɾ t i n 'ə n s ə s
perifèries	p ə ɾ i f 'ɛ ɾ i ə s	p ə ɾ i f 'ə ɾ i ə s
perfecte	p ə ɾ f 'ɛ t t ə	p ə ɾ f 'ə t t ə
percentatges	p ə ɾ s ə n t 'a d ʒ ə s	p ə ɾ s ə n t 'a dʒ ə s
penitència	p ə n i t 'ɛ n s i ə	p ə n i t 'ə n s i ə
peatge	p e 'a d ʒ ə	p e 'a dʒ ə
passarem	p ə s ə ɾ 'ə m	p ə s ə ɾ 'ɛ m
pasarem	p ə z ə ɾ 'ə m	p ə z ə ɾ 'ɛ m
omplen	'o m p l ə n	'ɔ m p l ə n
numero	n u m 'e ɾ o	n u m 'ɛ ɾ o
naixem	n ə ʃ 'ə m	n ə ʃ 'ɛ m
mèdics	m 'ɛ ð i t s	m 'ə ð i t s
murs	m 'u s	m 'u ɾ s
movent-se	m o v 'e n s ə	m o v 'ɛ n s ə
motos	m 'o t o s	m 'ɔ t o s
molèstia	m o l 'ɛ s t i ə	m o l 'ə s t i ə
mitjancer	m i d ʒ ə n s 'e	m i dʒ ə n s 'e
mitges	m 'i d ʒ ə s	m 'i dʒ ə s
mars	m 'a s	m 'a ɾ s
marimatxo	m ə ɾ i m 'a t ʃ o	m ə ɾ i m 'a tʃ o
maleint-me	m ə l ə 'i m m ə	m ə l 'ə j n m ə
magnètica	m ə n n 'ɛ t i k ə	m ə n n 'ə t i k ə
lletja	ʎ 'e d ʒ ə	ʎ 'ə dʒ ə
llestos	ʎ 'e s t o s	ʎ 'ə s t o s
llebre	ʎ 'e β ɾ ə	ʎ 'ə β ɾ ə
lideratge	l i ð ə ɾ 'a d ʒ ə	l i ð ə ɾ 'a dʒ ə
kosovars	k o z o v 'a s	k o z o v 'a ɾ s
jazz	ʒ 'a s	ʒ 'a z
interpreto	i n t ə ɾ p ɾ 'e t o	i n t ə p ɾ 'ə t o
intermèdies	i n t ə ɾ m 'ɛ ð i ə s	i n t ə ɾ m 'ə ð i ə s
intempèrie	i n t ə m p 'ɛ ɾ i ə	i n t ə m p 'ə ɾ i ə
insolència	i n s o l 'ɛ n s i ə	i n s o l 'ə n s i ə
innocència	i n n o s 'ɛ n s i ə	i n n o s 'ə n s i ə
ingressos	i ŋ g ɾ 'e s o s	i ŋ g ɾ 'ə s o s
incongruència	i ŋ k o ŋ g ɾ u 'ɛ n s i ə	i ŋ k o ŋ g ɾ u 'ə n s i ə
incoherència	i ŋ k o ə ɾ 'ɛ n s i ə	i ŋ k o ə ɾ 'ə n s i ə
incloent-hi	i ŋ k l o 'e n t i	i ŋ k l o 'ɛ n t i
imatges	i m 'a d ʒ ə s	i m 'a dʒ ə s
ignoro	i n n 'o ɾ o	i n n 'ɔ ɾ o
homenatge	o m ə n 'a d ʒ ə	o m ə n 'a dʒ ə
hipotètica	i p o t 'ɛ t i k ə	i p o t 'ə t i k ə
heroi	ə ɾ 'ɔ j	ə ɾ 'o i
helvètic	ə l v 'ɛ t i k	ə l v 'ə t i k
habitatge	ə β i t 'a d ʒ ə	ə β i t 'a dʒ ə
gèlida	ʒ 'ɛ l i ð ə	ʒ 'ə l i ð ə
guèiser	g 'ə j z ə	g w 'ə j z ə
glops	g l 'o t s	g l 'ɔ t s
ginebra	ʒ i n 'e β ɾ ə	ʒ i n 'ə β ɾ ə
gestioni	ʒ ə s t i 'ɔ n i	ʒ ə s t i 'o n i
genètica	ʒ ə n 'ɛ t i k ə	ʒ ə n 'ə t i k ə
gemma	ʒ 'e m m ə	ʒ 'ɛ m m ə
fèretre	f 'ɛ ɾ ə t ɾ ə	f 'ə ɾ ə t ɾ ə
fosses	f 'o s ə s	f 'ɔ s ə s
fogatge	f o ɣ 'a d ʒ ə	f o ɣ 'a dʒ ə
fixar	f i t s 'a	f i ʃ 'a
fessin	f 'e s i n	f 'ə s i n
fent-los	f 'e n l o s	f 'ə n l o s
fent-la	f 'e n l ə	f 'ə n l ə
febre	f 'e β ɾ ə	f 'ə β ɾ ə
febles	f 'e b b l ə s	f 'ə b b l ə s
exsoci	ə t s 'ɔ s i	ə s 'ɔ s i
estèril	ə s t 'ɛ ɾ i l	ə s t 'ə ɾ i l
estiguem	ə s t i ɣ 'ə m	ə s t i ɣ 'ɛ m
espaguetis	ə s p ə ɣ 'ɛ t i s	ə s p ə ɣ 'ə t i s
eso	'e s o	'ə z o
escolten	ə s k 'o l t ə n	ə s k 'ɔ l t ə n
energètiques	ə n ə ɾ ʒ 'ɛ t i k ə s	ə n ə ɾ ʒ 'ə t i k ə s
energètica	ə n ə ɾ ʒ 'ɛ t i k ə	ə n ə ɾ ʒ 'ə t i k ə
ene	'e n ə	'ə n ə
endèmica	ə n d 'ɛ m i k ə	ə n d 'ə m i k ə
endarrere	ə n d ə r 'e ɾ ə	ə n d ə r 'ə ɾ ə
encertem	ə n s ə ɾ t 'ə m	ə n s ə ɾ t 'ɛ m
encarregarem	ə ŋ k ə r ə ɣ ə ɾ 'ə m	ə ŋ k ə r ə ɣ ə ɾ 'ɛ m
empitjora	ə m p i d ʒ 'o ɾ ə	ə m p i dʒ 'o ɾ ə
ego	'e ɣ o	'ə ɣ o
dutxes	d 'u t ʃ ə s	d 'u tʃ ə s
dutxant-me	d u t ʃ 'a m m ə	d u tʃ 'a n m ə
draps	d ɾ 'a t s	d ɾ 'a p s
dolços	d 'o l s o s	d 'ɔ l s o s
discorre	d i s k 'o r ə	d i s k 'ɔ r ə
dient-me	d i 'e m m ə	d i 'ə n m ə
dient-me	d i 'e m m ə	d i 'ə n m ə
dient-li	d i 'e n l i	d i 'ə n l i
diem	d i 'ə m	d i 'ɛ m
devoro	d ə v 'o ɾ o	d ə v 'ɔ ɾ o
desperfectes	d ə s p ə ɾ f 'ɛ t t ə s	d ə s p ə ɾ f 'ə t t ə s
desitjaven	d ə z i d ʒ 'a v ə n	d ə z i dʒ 'a v ə n
desitjar	d ə z i d ʒ 'a	d ə z i dʒ 'a
desitjable	d ə z i d ʒ 'a b b l ə	d ə z i dʒ 'a b b l ə
desavantatge	d ə z ə v ə n t 'a d ʒ ə	d ə z ə v ə n t 'a dʒ ə
desapareguessin	d ə z ə p ə ɾ ə ɣ 'e s i n	d ə z ə p ə ɾ ə ɣ 'ə s i n
depenem	d ə p ə n 'ə m	d ə p ə n 'ɛ m
dediquem	d ə ð i k 'ə m	d ə ð i k 'ɛ m
curts	k 'u ɾ s	k 'u ɾ t s
creï	k ɾ 'e i	k ɾ 'ɛ i
creixem	k ɾ ə ʃ 'ə m	k ɾ ə ʃ 'ɛ m
coses	k 'ɔ z ə s	k 'o z ə s
correspondència	k o r ə s p o n d 'ɛ n s i ə	k o r ə s p o n d 'ə n s i ə
corba	k 'o ɾ β ə	k 'ɔ ɾ β ə
copsar	k o t s 'a	k o p s 'a
contempla	k o n t 'e m p l ə	k o n t 'ɛ m p l ə
consideren	k o n s i ð 'e ɾ ə n	k o n s i ð 'ɛ ɾ ə n
connecto	k o n n 'e t t o	k o n n 'ɛ t t o
connecten	k o n n 'e t t ə n	k o n n 'ə t t ə n
concupiscència	k o ŋ k u p i t s 'ɛ n s i ə	k o ŋ k u p i t s 'ə n s i ə
clonatge	k l o n 'a d ʒ ə	k l o n 'a dʒ ə
cibernètic	s i β ə ɾ n 'ɛ t i k	s i β ə ɾ n 'ə t i k
castanjs	k ə s t 'a j n s	k ə s t 'a ɲ s
cartutx	k ə ɾ t 'u t ʃ	k ə ɾ t 'u tʃ
carpàtxio	k ə ɾ p 'a t ʃ i o	k ə ɾ p 'a tʃ i o
carboncles	k ə ɾ β 'o ŋ k l ə s	k ə ɾ β 'ɔ ŋ k l ə s
capritxosa	k ə p ɾ i t ʃ 'o z ə	k ə p ɾ i tʃ 'o z ə
bonjs	b 'o j n s	b 'o ɲ s
bomba	b 'o m b ə	b 'ɔ m b ə
be	b 'e	b 'ə
ascens	ə t s 'ə n s	ə t s 'e n s
arruinada	ə r u j n 'a ð ə	ə r u i n 'a ð ə
arenga	ə ɾ 'e ŋ g ə	ə ɾ 'ə ŋ g ə
apèndix	ə p 'ə n d i t s	ə p 'ə n d ʃ
alcoholèmies	ə l k o o l 'ɛ m i ə s	ə l k o o l 'ə m i ə s
afronten	ə f ɾ 'o n t ə n	ə f ɾ 'ɔ n t ə n
adolescència	ə ð o l ə t s 'ɛ n s i ə	ə ð o l ə t s 'ə n s i ə
adjunt	ə d ʒ 'u n t	ə dʒ 'u n t
actuïn	ə t t 'u i n	ə t t u 'i n
acostumem	ə k o s t u m 'ə m	ə k o s t u m 'ɛ m
Viatjarà	v i ə d ʒ ə ɾ 'a	v i ə dʒ ə ɾ 'a
Varem	v ə ɾ 'ə m	v ə ɾ 'ɛ m
Ull	'u j	'u ʎ
Tindrem	t i n d ɾ 'ə m	t i n d ɾ 'ɛ m
Suprem	s u p ɾ 'ə m	s u p ɾ 'ɛ m
Sorprèn	s o ɾ p ɾ 'ə n	s o ɾ p ɾ 'ɛ n
Sens	s 'ə n s	s 'e n s
Ruth	r 'u t	r 'u tʃ
Poder	p o ð 'ə	p o ð 'e
Plataforma	p l ə t ə f 'o ɾ m ə	p l ə t ə f 'ɔ ɾ m ə
Plantegem	p l ə n t ə ʒ 'ə m	p l ə n t ə ʒ 'ɛ m
Montevideo	m o n t ə v i ð 'e o	m o n t ə v i ð 'ə o
Mes	m 'e s	m 'ə s
Llatinoamèrica	ʎ ə t i n o ə m 'ɛ ɾ i k ə	ʎ ə t i n o ə m 'ə ɾ i k ə
Le	l 'e	l 'ə
Jutges	ʒ 'u d ʒ ə s	ʒ 'u dʒ ə s
Inmunodeficiència	i m m u n o ð ə f i s i 'ɛ n s i ə	i m m u n o ð ə f i s i 'ə n s i ə
Hèlsinki	'ɛ l s i ŋ k i	'ɛ l s i n ʒ i
Huc	'u k	ə k
Hisenda	i z 'e n d ə	i z 'ə n d ə
Grenoble	g ɾ ə n 'o b b l ə	g ɾ ə n 'ɔ b b l ə
Folch	f 'o l k	f 'o l s
Estarem	ə s t ə ɾ 'ə m	ə s t ə ɾ 'ɛ m
Endreço	ə n d ɾ 'e s o	ə n d ɾ 'ə s o
Contra	k 'o n t ɾ ə	k 'ɔ n t ɾ ə
COCO	k 'o k o	k 'ɔ k o
Ben	b 'e n	b 'ə n
Amèrica	ə m 'ɛ ɾ i k ə	ə m 'ə ɾ i k ə
habilitació	ə β i l i t ə s i 'o	ə β i l i t ə s i 'o k
habilitaɾ	ə β i l i t 'a	ə β i l i t 'a t
habilitaɾan	ə β i l i t ə ɾ 'a n	ə β i l i t ə w 'a n
habilitaɾà	ə β i l i t ə ɾ 'a	ə β i l i t ə w 'a t
habitació	ə β i t ə s i 'o	ə β i t ə s i 'o k
habitaɾ	ə β i t 'a	ə β i t 'a t
habitem	ə β i t 'ə m	ə β i t 'ɛ m
habituació	ə β i t u ə s i 'o	ə β i t u ə s i 'o k
habitualment	ə β i t u ˌ a l m 'e n t	ə β i t u ə l m 'e n t
hagiogɾafia	ə ʒ i o ɣ ɾ ə f 'i ə	ə ʒ i o ɣ ə f 'i ə
haguem	ə ɣ 'ə m	ə ɣ 'ɛ m
hagueɾa	ə ɣ 'e ɾ ə	ə ɣ 'ə w ə
hagueɾen	ə ɣ 'e ɾ ə n	ə ɣ 'ɛ ʒ ə n
hagueɾes	ə ɣ 'e ɾ ə s	ə ɣ 'ə z ə s
haguessen	ə ɣ 'e s ə n	ə ɣ 'ə s ə n
haguesses	ə ɣ 'e s ə s	ə ɣ 'ə s ə s
haguessin	ə ɣ 'e s i n	ə ɣ 'ə s i n
haguessis	ə ɣ 'e s i s	ə ɣ 'ə s i s
hagué	ə ɣ 'e	ə ɣ 'ɛ k
haguéɾem	ə ɣ 'e ɾ ə m	ə ɣ ə 'ɛ m
haguéɾeu	ə ɣ 'e ɾ ə w	ə ɣ ə 'ɛ w
hagués	ə ɣ 'e s	ə ɣ 'ə s
haguéssem	ə ɣ 'e s ə m	ə ɣ ə s 'ɛ m
haguésseu	ə ɣ 'e s ə w	ə ɣ ə s 'ɛ w
haguéssim	ə ɣ 'e s i m	ə ɣ ə s 'i m
haguéssiu	ə ɣ 'e s i w	ə ɣ ə s 'i w
haguí	ə ɣ 'i	ə ɣ 'i s
haia	'a j ə	ə j ə
haití	ə j t 'i	ə j t 'i t
haixix	ə ʃ 'i ʃ	ə ʃ 'i s
halloween	ə ʎ o β 'e ə n	ə ʎ o β 'ɛ ə n
halteɾofília	ə l t ə ɾ o f 'i l i ə	ə l t ə d z o f i l 'i ə
hambuɾg	ə m b 'u ɾ k	ə m b 'u tʃ
hambuɾgueseɾia	ə m b u ɾ ɣ ə z ə ɾ 'i ə	ə m b u ɾ ɣ ə z ə ð 'i ə
hangaɾ	ə ŋ g 'a	ə ŋ g 'a t
hannoveɾ	ə n n o v 'e	ə n n o v 'ɛ k
haɾdɾive	ə ɾ ð ɾ 'i v ə	ə d d i 'i v ə
haɾdɾives	ə ɾ ð ɾ 'i v ə s	ə d d i 'i v ə s
haɾdwaɾe	'a ɾ u ə	ə ə ð ə 'a ð ə
haɾem	ə ɾ 'ə m	ə d z 'ɛ m
haɾmonia	ə ɾ m o n 'i ə	ə m m o n 'i ə
haɾmonies	ə ɾ m o n 'i ə s	ə m m o n 'i ə s
haɾmoniosa	ə ɾ m o n i 'o z ə	ə m m o n i 'o z ə
haɾmoniosament	ə ɾ m o n i ˌ o z ə m 'e n t	ə m m o n i o z ə m 'e n t
haɾmonioses	ə ɾ m o n i 'o z ə s	ə m m o n i 'o z ə s
haɾmoniosos	ə ɾ m o n i 'o z o s	ə m m o n i 'o z o s
haɾmonitza	ə ɾ m o n 'i d z ə	ə m m o n 'i d z ə
haɾmonització	ə ɾ m o n i d z ə s i 'o	ə m m o n i d z ə s i 'o k
haɾmonitzada	ə ɾ m o n i d z 'a ð ə	ə m m o n i d z 'a ð ə
haɾmonitzaɾ	ə ɾ m o n i d z 'a	ə m m o n i d z 'a t
haɾmonitzat	ə ɾ m o n i d z 'a t	ə m m o n i d z 'a t
haɾmonitzats	ə ɾ m o n i d z 'a t s	ə m m o n i d z 'a t s
haɾmoniós	ə ɾ m o n i 'o s	ə m m o n i 'o s
haɾmònic	ə ɾ m 'ɔ n i k	ə m m o n 'i k
haɾmònica	ə ɾ m 'ɔ n i k ə	ə m m o n 'i k ə
haɾmònicament	ə ɾ m ˌ ɔ n i k ə m 'e n t	ə m m o n 'i k ə m 'e n t
haɾmònics	ə ɾ m 'ɔ n i t s	ə m m o n 'i t s
haɾmòniques	ə ɾ m 'ɔ n i k ə s	ə m m o n 'i k ə s
haɾpistes	ə ɾ p 'i s t ə s	ə ə p 'i s t ə s
hauɾan	ə w ɾ 'a n	ə w w 'a n
hauɾem	ə w ɾ 'ə m	ə w z 'ɛ m
hauɾies	ə w ɾ 'i ə s	ə w z 'i ə s
hauɾà	ə w ɾ 'a	ə w k 'a t
hauɾàs	ə w ɾ 'a s	ə w k 'a s
hauɾé	ə w ɾ 'e	ə w z 'ə t
hauɾíem	ə w ɾ 'i ə m	ə w z i 'ɛ m
hauɾíeu	ə w ɾ 'i ə w	ə w z i 'ɛ w
hemofília	ə m o f 'i l i ə	ə m o f i l 'i ə
hemoroides	ə m o r 'ɔ j ð ə s	ə m o ɾ 'ɔ j ð ə s
hemoràgia	ə m o r 'a ʒ i ə	ə m o ɾ ə ʒ 'i ə
hemoràgies	ə m o r 'a ʒ i ə s	ə m o ɾ ə ʒ 'i ə s
henna	'e n n ə	'ɛ n n ə
hepàtic	ə p 'a t i k	ə p ə t 'i k
heɾba	'ɛ ɾ β ə	'ə z β ə
heɾbei	ə ɾ β 'ə j	ə ə β 'ə j
heɾbes	'ɛ ɾ β ə s	'ə z β ə s
heɾbomedicinal	ə ɾ β o m ə ð i s i n 'a l	ə ə β o m ə ð i s i n 'a l
heɾbívoɾ	ə ɾ β 'i v o ɾ	ə ə β i v 'o k
heɾbívoɾs	ə ɾ β 'i v o ɾ s	ə ə β i v 'o s
heɾeditaɾi	ə ɾ ə ð i t 'a ɾ i	ə d z ə ð i t 'a ʒ i
heɾeditàɾia	ə ɾ ə ð i t 'a ɾ i ə	ə d z ə ð i t ə ð 'i ə
heɾeditàɾies	ə ɾ ə ð i t 'a ɾ i ə s	ə d z ə ð i t ə b b 'i ə s
heɾeta	ə ɾ 'ə t ə	ə d z 'ə t ə
heɾetada	ə ɾ ə t 'a ð ə	ə d z ə t 'a ð ə
heɾetades	ə ɾ ə t 'a ð ə s	ə d z ə t 'a ð ə s
heɾetaɾ	ə ɾ ə t 'a	ə d z ə t 'a t
heɾetat	ə ɾ ə t 'a t	ə d z ə t 'a t
heɾetatge	ə ɾ ə t 'a dʒ ə	ə d z ə t 'a dʒ ə
heɾetats	ə ɾ ə t 'a t s	ə d z ə t 'a t s
heɾeten	ə ɾ 'e t ə n	ə d z 'ə t ə n
heɾetges	ə ɾ 'e dʒ ə s	ə d z 'ə dʒ ə s
heɾetgia	ə ɾ ə dʒ 'i ə	ə d z ə dʒ 'i ə
heɾeu	ə ɾ 'ɛ w	ə d z 'ɛ w
heɾeus	ə ɾ 'ɛ w s	ə ə 'ɛ w s
heɾeva	ə ɾ 'e v ə	ə d z 'ə v ə
heɾeves	ə ɾ 'e v ə s	ə d z 'ə v ə s
inapɾehensible	i n ə p ɾ ə ə n s 'i b b l ə	i n ə p ɾ ə s n s 'i b b l ə
incoheɾent	i ŋ k o ə ɾ 'e n t	i ŋ k o ə d z 'e n t
incoheɾents	i ŋ k o ə ɾ 'e n s	i ŋ k o ə d z 'e n s
incoheɾència	i ŋ k o ə ɾ 'ɛ n s i ə	i ŋ k o ə d z ə n s 'i ə
incoheɾències	i ŋ k o ə ɾ 'ɛ n s i ə s	i ŋ k o ə d z ə n s 'i ə s
inexhauɾible	i n ə d z ə w ɾ 'i b b l ə	i n ə d z ə w z 'i b b l ə
inexhauɾibles	i n ə d z ə w ɾ 'i b b l ə s	i n ə d z ə w z 'i b b l ə s
infɾahumanes	i m f ɾ ə u m 'a n ə s	i m f e ə m m 'a n ə s
inhabilitació	i n ə β i l i t ə s i 'o	i n ə β i l i t ə s i 'o k
inhabilitaɾ	i n ə β i l i t 'a	i n ə β i l i t 'a t
inhabilitaɾia	i n ə β i l i t ə ɾ 'i ə	i n ə β i l i t ə ʒ 'i ə
inhabilitaɾne	i n ə β i l i t 'a ɾ n ə	i n ə β i l i t 'a n n ə
inhalació	i n ə l ə s i 'o	i n ə l ə s i 'o k
inhalaɾ	i n ə l 'a	i n ə l 'a t
inhalatòɾia	i n ə l ə t 'ɔ ɾ i ə	i n ə l ə t o ʒ 'i ə
inheɾent	i n ə ɾ 'e n t	i n ə d z 'e n t
inheɾents	i n ə ɾ 'e n s	i n ə d z 'e n s
inhibeix	i n i β 'ə ʃ	i n i β 'ɛ ʃ
inhibeixi	i n i β 'ə ʃ i	i n i β 'ɛ ʃ i
inhibició	i n i β i s i 'o	i n i β i s i 'o k
inhibidoɾ	i n i β i ð 'o	i n i β i ð 'o k
inhibiɾ	i n i β 'i	i n i β 'i s
inhibiɾse	i n i β 'i ɾ s ə	i n i β 'i s ə
inhumació	i n u m ə s i 'o	i n u m ə s i 'o k
inhumà	i n u m 'a	i n u m 'a t
inhòspit	i n 'ɔ s p i t	i n o s p 'i t
inhòspita	i n 'ɔ s p i t ə	i n o s p 'i t ə
macɾohistòɾia	m ə k ɾ o i s t 'ɔ ɾ i ə	m ə k k o i s t o ɾ 'i ə
malhumoɾat	m ˌ a l u m o ɾ 'a t	m ə l u m o ð 'a t
megaheɾtzos	m ə ɣ ə 'ɛ ɾ d z o s	m ə ɣ ə 'ɛ tʃ d z o s
megaheɾtzs	m ə ɣ ə 'ɛ ɾ d z s	m ə ɣ ə 'ɛ tʃ d z s
