A	'ə	 ə 
abadessa	ə β ə ð 'ɛ s ə	 ə β ə ð 'e s ə 
abandonis	ə β ə n d 'ɔ n i s	 ə β ə n d 'o n i s 
abdomen	ə b d 'o m ə n	 ə b d 'ɔ m ə n 
abell	ə β 'ɛ ʎ	 ə β 'e ʎ 
abella	ə β 'ɛ ʎ ə	 ə β 'e ʎ ə 
Abella	ə β 'ɛ ʎ ə	 ə β 'e ʎ ə 
abelles	ə β 'ɛ ʎ ə s	 ə β 'e ʎ ə s 
ablació	ə β l ə s i 'o	 ə b b l ə s i 'o 
abrilenc	ə β ɾ i l 'ɛ ŋ	 ə β ɾ i l 'ɛ n s 
abscés	ə p s 'e s	 ə p s k 'e s 
absolt	ə p s 'ɔ l t	 ə p s 'o l t 
abundantment	ə β u n d ə m m 'e n	 ə β u n d ə n ə m 'e n 
àcar	'a k ə	 'a k ə r 
acer	ə s 'e r	 ə k 'e 
acoblada	ə k u b b l 'a ð ə	 ə k u β l 'a ð ə 
acoblades	ə k u b b l 'a ð ə s	 ə k u β l 'a ð ə s 
acord	ə k 'ɔ r t	 ə k 'o r t 
Açores	ə s 'ɔ ɾ ə s	 ə s 'o ɾ ə s 
acórrer	ə k 'o r ə	 ə k u r 'e 
actriu	ə k t ɾ 'i w	 ə k t ɾ 'i u 
adequada	ə ð ə k w 'a ð ə	 ə ð ə k 'a ð ə 
adequades	ə ð ə k w 'a ð ə s	 ə ð ə k 'a ð ə s 
adequat	ə ð ə k w 'a t	 ə ð ə k 'a t 
adequats	ə ð ə k w 'a t s	 ə ð ə k 'a t s 
adesiara	ə ð ə z i 'a ɾ ə	 a ð ə z i 'a ɾ ə 
adhesiu	ə ð ə z 'i w	 ə ð i ə z 'i w 
adob	ə ð 'o p	 ə ð 'o 
adúlter	ə ð 'u l t ə r	 ə ð u l t 'e 
advers	ə d b 'ɛ r s	 ə d b 'e s 
aerobi	ə e ɾ 'ɔ β i	 ə ə ɾ 'ɔ β i 
aeròbic	ə e ɾ 'ɔ β i k	 ə ə ɾ 'ɔ β i k 
aeròmetre	ə e ɾ 'ɔ m ə t ɾ ə	 ə ə ɾ 'ɔ m ə t ɾ ə 
afaitada	ə f ə j t 'a ð ə	 ə f ə i t 'a ð ə 
afaitades	ə f ə j t 'a ð ə s	 ə f ə i t 'a ð ə s 
afaitar	ə f ə j t 'a	 ə f ə i t 'a 
afaitat	ə f ə j t 'a t	 ə f ə i t 'a t 
afaitats	ə f ə j t 'a t s	 ə f ə i t 'a t s 
afecta	ə f 'e k t ə	 ə f 'ɛ k t ə 
afecte	ə f 'e k t ə	 ə f 'ɛ k t ə 
afectes	ə f 'e k t ə s	 ə f 'ɛ k t ə s 
afer	ə f 'e r	 ə f 'e 
Afganistan	ə v ɣ ə n i s t 'a n	 ə f ɣ ə n i s t 'a n 
aflora	ə f l 'ɔ ɾ ə	 ə f l 'o ɾ ə 
aflores	ə f l 'ɔ ɾ ə s	 ə f l 'o ɾ ə s 
afores	ə f 'ɔ ɾ ə s	 ə f 'o ɾ ə s 
afronta	ə f ɾ 'o n t ə	 ə f ɾ 'ɔ n t ə 
agenda	ə ʒ 'e n d ə	 ə ʒ 'ɛ n d ə 
aguaitada	ə ɣ w ə j t 'a ð ə	 ə ɣ w ə i t 'a ð ə 
aguaitades	ə ɣ w ə j t 'a ð ə s	 ə ɣ w ə i t 'a ð ə s 
aguaitant	ə ɣ w ə j t 'a n	 ə ɣ w ə i t 'a n 
aguaitar	ə ɣ w ə j t 'a	 ə ɣ w ə i t 'a 
aguaitat	ə ɣ w ə j t 'a t	 ə ɣ w ə i t 'a t 
aguaitats	ə ɣ w ə j t 'a t s	 ə ɣ w ə i t 'a t s 
Àgueda	'a ɣ ə ð ə	 'a ɣ u ə ð ə 
àguila	'a ɣ i l ə	 'a ɣ u i l ə 
aguilenc	ə ɣ i l 'ɛ ŋ	 ə ɣ i l 'ɛ n s 
àguiles	'a ɣ i l ə s	 'a ɣ u i l ə s 
ai	'a j	 'a i 
aidada	ə j ð 'a ð ə	 ə i ð 'a ð ə 
aidades	ə j ð 'a ð ə s	 ə i ð 'a ð ə s 
aidant	ə j ð 'a n	 ə i ð 'a n 
aidar	ə j ð 'a	 ə i ð 'a 
aidat	ə j ð 'a t	 ə i ð 'a t 
aidats	ə j ð 'a t s	 ə i ð 'a t s 
aiguabarreig	ə j ɣ w ə β ə r 'ɛ t ʃ	 ə j ɣ w ə β ə r 'ɛ ʃ 
aiguafort	ə j ɣ w ə f 'ɔ r t	 ə j ɣ w ə f 'o r t 
aigualir	ə j ɣ w ə l 'i	 ə j ɣ u ə l 'i 
aiguaneu	ə j ɣ w ə n 'e w	 ə j ɣ w ə n 'ɛ w 
aigüera	ə j ɣ w 'e ɾ ə	 a j ə w 'e ɾ ə 
aigüerola	ə j ɣ w ə ɾ 'ɔ l ə	 a j ɣ w ə ɾ 'ɔ l ə 
aigüeroles	ə j ɣ w ə ɾ 'ɔ l ə s	 a j ɣ w ə ɾ 'ɔ l ə s 
al	'ə l	 ə l 
albenc	ə l β 'ɛ ŋ	 ə l β 'ɛ n s 
alcaldessa	ə l k ə l d 'ɛ s ə	 ə l k ə l d 'e s ə 
alçament	ə l s ə m 'e n	 a l s ə m 'e n 
Alcàsser	ə l k 'a s ə r	 ə l k 'a s ə 
alcàsser	ə l k 'a s ə r	 ə l k 'a s ə 
alcohol	ə l k u 'ɔ l	 ə l k u 'a l 
aleatori	ə l e ə t 'ɔ ɾ i	 ə l ə ə t 'ɔ ɾ i 
alegre	ə l 'e ɣ ɾ ə	 ə l 'ɛ ɣ ɾ ə 
aleshores	ə l ə z 'ɔ ɾ ə s	 ə l ə s 'o ə s 
aleteig	ə l ə t 'ɛ t ʃ	 ə l ə t 'ɛ ʃ 
alfabregueta	ə l f ə β ɾ ə ɣ 'ɛ t ə	 ə l f ə β ɾ ə ɣ u 'ɛ t ə 
algebraic	ə l ʒ ə β ɾ 'a j k	 ə l ʒ ə β ɾ 'a i k 
àlgid	'a l ʒ i t	 'a l ʒ i ð 
àlgids	'a l ʒ i t s	 'a l ʒ i ð s 
alhora	ə l 'ɔ ɾ ə	 ə l i 'o ɾ ə 
àliga	'a l i ɣ ə	 ' a l i ɣ ə 
àligues	'a l i ɣ ə s	 ' a l i ɣ ə s 
alimenti	ə l i m 'e n t i	 ə l i m 'ɛ n t i 
alineament	ə l i n e ə m 'e n	 ə l i n ə ə m 'e n 
aljub	ə l ʒ 'u p	 ə l ʒ 'u 
allenc	ə ʎ 'ɛ ŋ	 ə ʎ 'ɛ n s 
almirallessa	ə l m i ɾ ə ʎ 'ɛ s ə	 ə l m i ɾ ə ʎ 'e s ə 
alosa	ə l 'ɔ z ə	 ə l 'o z ə 
alt	'a l	 'a l t 
Altai	ə l t 'a j	 ə l t 'a i 
altaic	ə l t 'a j k	 ə l t 'a i k 
altra	'a l t ɾ ə	 ' a l t ɾ ə 
altre	'a l t ɾ ə	 ' a l t ɾ ə 
altres	'a l t ɾ ə s	 ' a l t ɾ ə s 
altri	'a l t ɾ i	 ' a l t ɾ i 
alzinenc	ə l z i n 'ɛ ŋ	 ə l z i n 'ɛ n s 
amainada	ə m ə j n 'a ð ə	 ə m ə i n 'a ð ə 
amainades	ə m ə j n 'a ð ə s	 ə m ə i n 'a ð ə s 
amainant	ə m ə j n 'a n	 ə m ə i n 'a n 
amainar	ə m ə j n 'a	 ə m ə i n 'a 
amainat	ə m ə j n 'a t	 ə m ə i n 'a t 
amainats	ə m ə j n 'a t s	 ə m ə i n 'a t s 
amarg	ə m 'a r k	 ə m 'a r 
ambdós	ə m d 'o s	 ə m b d 'o s 
ambdues	ə m d 'u ə s	 ə m b d 'u ə s 
ambigüitat	ə m b i ɣ w i t 'a t	 ə m b i ɣ i t 'a t 
ambigüitats	ə m b i ɣ w i t 'a t s	 ə m b i ɣ i t 'a t s 
amblada	ə m b l 'a ð ə	 ə m ə l 'a ð ə 
amblades	ə m b l 'a ð ə s	 ə m ə l 'a ð ə s 
amens	ə m 'ɛ n s	 ə m 'e n s 
amor	ə m 'o r	 ə m 'o 
ampolla	ə m p 'o ʎ ə	 ə m p 'ɔ ʎ ə 
anacard	ə n ə k 'a r	 ə n ə k 'a r t 
anàrquica	ə n 'a r k i k ə	 ə n ə r k 'i k ə 
anàrquics	ə n 'a r k i k s	 ə n ə r k 'i k s 
Andreu	ə n d ɾ 'e w	 ə n d ɾ 'ɛ w 
àngels	'a n ʒ ə l s	 a n ʒ 'ɛ l s 
Àngels	'a n ʒ ə l s	 a n ʒ 'ɛ l s 
anihilar	ə n i i l 'a	 ə n i ə l 'a 
anterior	ə n t ə ɾ i 'o r	 ə n t ə ɾ i 'o 
antimoni	ə n t i m 'ɔ n i	 ə n t i m 'o n i 
antitancs	ə n t i t 'a ŋ s	 ə n t i t 'a ŋ k s 
Antoni	ə n t 'ɔ n i	 ə n t 'o n i 
Anvers	ə m b 'ɛ r s	 ə m b 'e s 
anvers	ə m b 'ɛ r s	 ə m b 'e s 
aparell	ə p ə ɾ 'ɛ ʎ	 ə p ə ɾ 'e ʎ 
aparença	ə p ə ɾ 'ɛ n s ə	 ə p ə ɾ 'e n s ə 
aparentment	ə p ə ɾ ə m m 'e n	 ə p ə ɾ ə n ə m 'e n 
aplaudida	ə p l ə w ð 'i ð ə	 ə p l ə u ð 'i ð ə 
aplaudides	ə p l ə w ð 'i ð ə s	 ə p l ə u ð 'i ð ə s 
aplaudint	ə p l ə w ð 'i n	 ə p l ə u ð 'i n 
aplaudir	ə p l ə w ð 'i	 ə p l ə u ð 'i 
apòstrofs	ə p 'ɔ s t ɾ u f s	 ə p u s t ɾ 'ɔ f s 
aprehendre	ə p ɾ ə 'ɛ n d ɾ ə	 ə p ɾ ə u n d ɾ ə 
aquàriums	ə k w 'a ɾ i u m s	 ə k w 'a ɾ i w m s 
aqüeducte	ə k w ə ð 'u k t ə	 ə k ə ð 'u k t ə 
aqüeductes	ə k w ə ð 'u k t ə s	 ə k ə ð 'u k t ə s 
aqueix	ə k 'ɛ ʃ	 ə k 'e ʃ 
aquell	ə k 'ɛ ʎ	 ə k 'e ʎ 
aquest	ə k 'ɛ t	 ə k 'ɛ s t 
aqüicultura	ə k w i k u l t 'u ɾ ə	 ə k i k u l t 'u ɾ ə 
armament	ə r m ə m 'e n	 a r m ə m 'e n 
arqueig	ə r k 'ɛ t ʃ	 ə r k 'ɛ ʃ 
arraulida	ə r ə w l 'i ð ə	 ə r ə u l 'i ð ə 
arraulides	ə r ə w l 'i ð ə s	 ə r ə u l 'i ð ə s 
arraulint	ə r ə w l 'i n	 ə r ə u l 'i n 
arraulir	ə r ə w l 'i	 ə r ə u l 'i 
arts	'a r s	 'a r t s 
Artur	ə r t 'u r	 ə r t 'u 
arxiduquessa	ə r ʃ i ð u k 'ɛ s ə	 ə r ʃ i ð u k 'e s ə 
arxillaüt	ə r ʃ i ʎ ə 'u t	 ə r ʃ 'i ʎ 'a 'u t 
asimètric	ə s i m 'ɛ t ɾ i k	 ə z i m 'ɛ t ɾ i k 
assaig	ə s 'a t ʃ	 ə s ə 'i ə 
assalt	ə s 'a l	 ə s 'a l t 
asseure's	ə s 'ɛ w ɾ ə s	 ə s ə w ɾ 'ɛ s 
assumpte	ə s 'u m t ə	 ə s 'u m p t ə 
assumptes	ə s 'u m t ə s	 ə s 'u m p t ə s 
asteroide	ə s t ə ɾ 'ɔ j ð ə	 ə s t ə ɾ u 'i ð ə 
astronauta	ə s t ɾ u n 'a w t ə	 ə s t ɾ u n ə 'u t ə 
astronautes	ə s t ɾ u n 'a w t ə s	 ə s t ɾ u n ə 'u t ə s 
atendre	ə t 'e n d ɾ ə	 ə t 'ɛ n d ɾ ə 
atenenc	ə t ə n 'ɛ ŋ	 ə t ə n 'ɛ n s 
ateu	ə t 'e w	 ə t 'ɛ w 
atlàntic	ə l l 'a n t i k	 ə t l 'a n t i k 
atles	'a l l ə s	 'a t l ə s 
Atles	'a l l ə s	 'a t l ə s 
atleta	ə l l 'ɛ t ə	 ə t l 'ɛ t ə 
atlètic	ə l l 'ɛ t i k	 ə t l 'ɛ t i k 
atot	ə t 'o t	 ə t 'ɔ t 
atraient	ə t ɾ ə j 'e n	 ə t ɾ ə i 'e n 
atret	ə t ɾ 'e t	 ə t ɾ 'ɛ t 
atrets	ə t ɾ 'e t s	 ə t ɾ 'ɛ t s 
atroç	ə t ɾ 'ɔ s	 ə t ɾ 'o s 
atur	ə t 'u r	 ə t 'u 
atzar	ə d z 'a r	 ə d z 'a 
aurèola	ə w ɾ 'ɛ u l ə	 ə w ɾ ə 'ɔ l ə 
auster	ə w s t 'e r	 ə w s t 'e 
Àustria	'a w s t ɾ i ə	 a w s t ɾ 'i ə 
autocar	ə w t u k 'a r	 ə w t u k 'a 
autòmats	ə w t 'ɔ m ə t s	 ə w t u m 'a t s 
autoretrat	ə w t u r ə t ɾ 'a t	 ə w t u ɾ ə t ɾ 'a t 
autoretrats	ə w t u r ə t ɾ 'a t s	 ə w t u ɾ ə t ɾ 'a t s 
autosuficiència	ə w t u s u f i s i 'ɛ n s i ə	 ə w t u z u f i s i 'ɛ n s i ə 
autosuficient	ə w t u s u f i s i 'e n	 ə w t u z u f i s i 'e n 
avantbraç	ə β ə m b ɾ 'a s	 ə β ə n β ɾ 'a s 
avantpassat	ə β ə m p ə s 'a t	 ə β ə n p ə s 'a t 
avantpassats	ə β ə m p ə s 'a t s	 ə β ə n p ə s 'a t s 
avar	ə β 'a r	 ə β 'a 
avellanenc	ə β ə ʎ ə n 'ɛ ŋ	 ə β ə ʎ ə n 'ɛ n s 
babiloni	b ə β i l 'ɔ n i	 b ə β i l 'o n i 
Badakhxan	b ə ð ə k ʃ 'a n	 b ə ð ə k ə 'a n 
bagenc	b ə ʒ 'ɛ ŋ	 b ə ʒ 'ɛ n s 
Bahames	b ə 'a m ə s	 b ə m m ə s 
baixkir	b ə ʃ k 'i	 b ə ʃ s 'i 
balbuceig	b ə l β u s 'ɛ t ʃ	 b ə l β u s 'ɛ ʃ 
balear	b ə l e 'a r	 b ə l e 'a 
balears	b ə l e 'a r s	 b ə l ə 'a s 
Balears	b ə l e 'a r s	 b ə l ə 'a s 
balneari	b ə l n e 'a ɾ i	 b ə l ə e 'a ɾ i 
banc	b 'a ŋ	 b 'a ŋ k 
bancs	b 'a ŋ s	 b 'a ŋ k s 
bàndols	b 'a n d u l s	 b ə n d 'ɔ l s 
bar	b 'a r	 b 'a 
baronessa	b ə ɾ u n 'ɛ s ə	 b ə ɾ u n 'e s ə 
barreig	b ə r 'ɛ t ʃ	 b ə r 'ɛ ʃ 
basalt	b ə z 'a l	 b ə z 'a l t 
bastard	b ə s t 'a r t	 b ə s t 'a r 
bateig	b ə t 'ɛ t ʃ	 b ə t 'ɛ ʃ 
baül	b ə 'u l	 b 'a ʎ 
be	b 'e	 b 'ɛ 
Beatriu	b e ə t ɾ 'i w	 b e ə t ɾ 'i u 
beguina	b ə ɣ 'i n ə	 b ə ɣ u 'i n ə 
bei	b 'ɛ j	 b 'ɛ i 
beisbol	b ə j z β 'ɔ l	 b ə i z β 'ɔ l 
Belgrad	b ə l ɣ ɾ 'a t	 b ə l ɣ ɾ 'a ð 
bellugueig	b ə ʎ u ɣ 'ɛ t ʃ	 b ə ʎ u ɣ u 'ɛ ʃ 
bemoll	b ə m 'ɔ ʎ	 b ə m 'o ʎ 
ben	b 'e n	 b 'ɛ n 
Benaguasil	b ə n ə ɣ w ə z 'i l	 b ə n ə ɣ w ə s 'i l 
beneficioses	b ə n ə f i s i 'o z ə s	 b ə n ə f i s i 'o s ə s 
beneitó	b ə n ə j t 'o	 b ə n ə i t 'o 
bes	b 'e s	 b 'ɛ s 
besnebot	b ə z n ə β 'o t	 b ə z n ə β 'ɔ t 
beso	b 'e z u	 b 'ɛ z u 
Bétera	b 'e t ə ɾ ə	 b ə t 'e ɾ ə 
Bigorra	b i ɣ 'ɔ r ə	 b i ɣ 'o r ə 
billar	b i ʎ 'a r	 b i ʎ 'a 
bioflavonoide	b i u f l ə β u n 'ɔ j ð ə	 b i u f l ə β u n u 'i ð ə 
bioma	b i 'ɔ m ə	 b i 'o m ə 
bipolar	b i p u l 'a r	 b i p u l 'a 
bisbalenc	b i z β ə l 'ɛ ŋ	 b i z β ə l 'ɛ n s 
blanqueig	b l ə ŋ k 'ɛ t ʃ	 b l ə ŋ k 'ɛ ʃ 
blavenc	b l ə β 'ɛ ŋ	 b l ə β 'ɛ n s 
blens	b l 'ɛ n s	 b l 'e n s 
bloqueig	b l u k 'ɛ t ʃ	 b l u k 'ɛ ʃ 
bo	b 'ɔ	 b 'o 
bobolinc	b u β u l 'i ŋ	 b u β u l 'i ŋ k 
boc	b 'o k	 b 'ɔ k 
boca	b 'o k ə	 b 'ɔ k ə 
bocs	b 'o k s	 b 'ɔ k s 
boda	b 'o ð ə	 b 'ɔ ð ə 
bodes	b 'o ð ə s	 b 'ɔ ð ə s 
boga	b 'o ɣ ə	 b 'ɔ ɣ ə 
boig	b 'ɔ t ʃ	 b 'ɔ j ə 
boirina	b u j ɾ 'i n ə	 b u i ɾ 'i n ə 
bolca	b 'o l k ə	 b 'ɔ l k ə 
bolquen	b 'o l k ə n	 b 'ɔ l k ə n 
bomba	b 'o m b ə	 b 'ɔ m b ə 
bombes	b 'o m b ə s	 b 'ɔ m b ə s 
bombo	b 'o m b u	 b 'ɔ m b u 
bombolla	b u m b 'o ʎ ə	 b u m b 'ɔ ʎ ə 
bon	b 'ɔ n	 b 'o n 
bona	b 'ɔ n ə	 b 'o n ə 
bones	b 'ɔ n ə s	 b 'o n ə s 
bons	b 'ɔ n s	 b 'o n s 
bonze	b 'ɔ n z ə	 b 'o n z ə 
bonzessa	b u n z 'ɛ s ə	 b u n z 'e s ə 
boques	b 'o k ə s	 b 'ɔ k ə s 
borgenc	b u r ʒ 'ɛ ŋ	 b u r ʒ 'ɛ n s 
borsa	b 'o r s ə	 b 'ɔ r s ə 
borses	b 'o r s ə s	 b 'ɔ r s ə s 
borur	b u ɾ 'u r	 b u ɾ 'u 
bosc	b 'ɔ s k	 b 'o s k 
bossa	b 'o s ə	 b 'ɔ s ə 
bosses	b 'o s ə s	 b 'ɔ s ə s 
bot	b 'o t	 b 'ɔ t 
bota	b 'o t ə	 b 'ɔ t ə 
botes	b 'o t ə s	 b 'ɔ t ə s 
boti	b 'o t i	 b 'ɔ t i 
bou	b 'ɔ w	 b 'o w 
bous	b 'ɔ w s	 b u 'u s 
bràctea	b ɾ 'a k t e ə	 b ɾ 'a k t ə ə 
bragueta	b ɾ ə ɣ 'ɛ t ə	 b ɾ ə ɣ u 'ɛ t ə 
brànquia	b ɾ 'a ŋ k i ə	 b ɾ ə ŋ k 'i ə 
brànquies	b ɾ 'a ŋ k i ə s	 b ɾ ə ŋ k 'i ə s 
bressa	b ɾ 'ɛ s ə	 b ɾ 'e s ə 
bretxa	b ɾ 'e t ʃ ə	 b ɾ 'ɛ t ʃ ə 
breu	b ɾ 'e w	 b ɾ 'ɛ w 
breus	b ɾ 'e w s	 b ɾ 'ɛ w s 
brillantment	b ɾ i ʎ ə m m 'e n	 b ɾ i ʎ ə n ə m 'e n 
broda	b ɾ 'o ð ə	 b ɾ 'ɔ ð ə 
brolla	b ɾ 'o ʎ ə	 b ɾ 'ɔ ʎ ə 
brollen	b ɾ 'o ʎ ə n	 b ɾ 'ɔ ʎ ə n 
bromur	b ɾ u m 'u r	 b ɾ u m 'u 
brot	b ɾ 'o t	 b ɾ 'ɔ t 
brota	b ɾ 'o t ə	 b ɾ 'ɔ t ə 
brou	b ɾ 'ɔ w	 b ɾ 'o 
Brunei	b ɾ u n 'ɛ j	 b ɾ u n 'ɛ i 
brunenc	b ɾ u n 'ɛ ŋ	 b ɾ u n 'ɛ n s 
búbal	b 'u β ə l	 b u β 'a l 
búfal	b 'u f ə l	 b u f 'a l 
búfals	b 'u f ə l s	 b u f 'a l s 
búgula	b 'u ɣ u l ə	 b u ɣ 'u l ə 
buidada	b u j ð 'a ð ə	 b u i ð 'a ð ə 
buidades	b u j ð 'a ð ə s	 b u i ð 'a ð ə s 
buidar	b u j ð 'a	 b u i ð 'a 
buidat	b u j ð 'a t	 b u i ð 'a t 
buidatge	b u j ð 'a d ʒ ə	 b u i ð 'a d ʒ ə 
buidats	b u j ð 'a t s	 b u i ð 'a t s 
buidor	b u j ð 'o	 b u i ð 'o 
búlgar	b 'u l ɣ ə r	 b u l ɣ 'a 
búlgara	b 'u l ɣ ə ɾ ə	 b u l ɣ 'a ɾ ə 
bullabessa	b u ʎ ə β 'ɛ s ə	 b u ʎ ə β 'e s ə 
búnquer	b 'u ŋ k ə r	 b u ŋ k 'e 
burg	b 'u r k	 b 'u r 
busseig	b u s 'ɛ t ʃ	 b u s 'ɛ ʃ 
cabeça	k ə β 'ɛ s ə	 k ə β 'e s ə 
cabell	k ə β 'ɛ ʎ	 k ə β 'e ʎ 
caber	k ə β 'ɛ	 k ə β 'e 
cabilenc	k ə β i l 'ɛ ŋ	 k ə β i l 'ɛ n s 
caireta	k ə j ɾ 'ɛ t ə	 k ə i ɾ 'ɛ t ə 
calabruixar	k ə l ə β ɾ u ʃ 'a	 k ə l ə β ɾ u i ʃ 'a 
Calabuig	k ə l ə β 'u t ʃ	 k ə l ə β 'u ʃ 
calàndria	k ə l 'a n d ɾ i ə	 k ə l ə n d ɾ 'i ə 
calb	k 'a l p	 k 'a l 
calbs	k 'a l p s	 k 'a l s 
caler	k ə l 'ɛ	 k ə l 'e 
calfred	k ə l f ɾ 'ɛ t	 k ə l f ɾ 'e d 
camarlenc	k ə m ə r l 'ɛ ŋ	 k ə m ə r l 'ɛ ŋ k 
camp	k 'a m	 k 'a m p 
camps	k 'a m s	 k 'a m p s 
canadenc	k ə n ə ð 'ɛ ŋ	 k ə n ə ð 'ɛ n s 
canadencs	k ə n ə ð 'ɛ ŋ s	 k ə n ə ð 'ɛ ŋ k s 
càndid	k 'a n d i t	 k 'a n d i ð 
canoa	k ə n 'o ə	 k ə n 'ɔ ə 
cantimplora	k ə n t i m p l 'ɔ ɾ ə	 k ə n t i m p l 'o ɾ ə 
caos	k 'a o s	 k ə 'ɔ s 
capbussó	k ə b b u s 'o	 k ə p b u s 'o 
capdavall	k ə b d ə β 'a ʎ	 k ə p d ə β 'a ʎ 
capdavanter	k ə b d ə β ə n t 'e	 k ə p d ə β ə n t 'e 
capgirada	k ə b ʒ i ɾ 'a ð ə	 k ə p ʒ i ɾ 'a ð ə 
capgirades	k ə b ʒ i ɾ 'a ð ə s	 k ə p ʒ i ɾ 'a ð ə s 
capgirar	k ə b ʒ i ɾ 'a	 k ə p ʒ i ɾ 'a 
capgirat	k ə b ʒ i ɾ 'a t	 k ə p ʒ i ɾ 'a t 
capgirats	k ə b ʒ i ɾ 'a t s	 k ə p ʒ i ɾ 'a t s 
capvespre	k ə b b 'e s p ɾ ə	 k ə p b 'ɛ s p ɾ ə 
capvuitada	k ə b b u j t 'a ð ə	 k ə p b u i t 'a ð ə 
car	k 'a r	 k 'a 
carablanc	k ə ɾ ə b b l 'a ŋ	 k ə ɾ ə β l 'a ŋ 
caràcter	k ə ɾ 'a k t ə r	 k ə ɾ 'a k t ə 
carantoines	k ə ɾ ə n t 'ɔ j n ə s	 k ə ɾ ə n 'ɔ j n ə s 
càrcer	k 'a r s ə	 k 'a r s ə r 
carei	k ə ɾ 'ɛ j	 k ə ɾ 'ɛ i 
cartílags	k ə r t 'i l ə k s	 k ə r t i l 'a k s 
càtar	k 'a t ə r	 k ə t 'a 
catorze	k ə t 'o r z ə	 k ə t 'ɔ r z ə 
caviar	k ə β i 'a r	 k ə β i 'a 
ce	s 'e	 s 'ɛ 
cec	s 'e k	 s 'ɛ k 
cecs	s 'e k s	 s 'ɛ k s 
cega	s 'e ɣ ə	 s 'ɛ ɣ ə 
cegues	s 'e ɣ ə s	 s 'ɛ ɣ ə s 
ceguesa	s ə ɣ 'ɛ z ə	 s ə ɣ u 'ɛ z ə 
Ceilan	s ə j l 'a n	 s ə i l 'a n 
cella	s 'ɛ ʎ ə	 s 'e ʎ ə 
celles	s 'ɛ ʎ ə s	 s 'e ʎ ə s 
cens	s 'ɛ n s	 s 'e n s 
centre	s 'e n t ɾ ə	 s 'ɛ n t ɾ ə 
centren	s 'e n t ɾ ə n	 s 'ɛ n t ɾ ə n 
centres	s 'e n t ɾ ə s	 s 'ɛ n t ɾ ə s 
centri	s 'e n t ɾ i	 s 'ɛ n t ɾ i 
cèntrics	s 'ɛ n t ɾ i k s	 s ə n t ɾ 'i k s 
centrin	s 'e n t ɾ i n	 s 'ɛ n t ɾ i n 
centro	s 'e n t ɾ u	 s 'ɛ n t ɾ u 
ceptre	s 'e p t ɾ ə	 s 'ɛ p t ɾ ə 
cera	s 'ɛ ɾ ə	 s 'e ɾ ə 
cercle	s 'e r k l ə	 s 'ɛ r k l ə 
cercles	s 'e r k l ə s	 s 'ɛ r k l ə s 
cèrcols	s 'ɛ r k u l s	 s ə r k 'ɔ l s 
Cèsar	s 'ɛ z ə r	 s ə z 'a 
cessen	s 'e s ə n	 s 'ɛ s ə n 
cessi	s 'e s i	 s 'ɛ s i 
cessin	s 'e s i n	 s 'ɛ s i n 
cèstrum	s 'ɛ s t ɾ u m	 s ə s t ɾ 'u m 
cianur	s i ə n 'u r	 s i ə n 'u 
ciberespai	s i β ə ɾ ə s p 'a j	 s i β ə ɾ ə s p 'a i 
ciberespais	s i β ə ɾ ə s p 'a j s	 s i β ə ɾ ə s p 'a i s 
ciberpunk	s i β ə r p 'u ŋ k	 s i β ə r p 'u n 
cicatriu	s i k ə t ɾ 'i w	 s i k ə t ɾ 'i u 
ciclomotor	s i k l u m u t 'o r	 s i k l u m u t 'o 
cigar	s i ɣ 'a r	 s i ɣ 'a 
cilíndrica	s i l 'i n d ɾ i k ə	 s i l i n d ɾ 'i k ə 
cínamom	s 'i n ə m u m	 s i n ə m 'o m 
cinc	s 'i ŋ	 s 'i ŋ k 
cincs	s 'i ŋ s	 s 'i ŋ k s 
Cir	s 'i r	 s 'i 
cistellenc	s i s t ə ʎ 'ɛ ŋ	 s i s t ə ʎ 'ɛ n s 
cistercenc	s i s t ə r s 'ɛ ŋ	 s i s t ə r s 'ɛ n s 
ciurons	s i w ɾ 'o n s	 s i u ɾ 'o n s 
ciutadà	s i w t ə ð 'a	 s 'i w t 'a ð 'a 
clixé	k l i ʃ 'e	 k l ʃ 'e 
clon	k l 'ɔ n	 k l 'o n 
clona	k l 'ɔ n ə	 k l 'o n ə 
clones	k l 'ɔ n ə s	 k l 'o n ə s 
cloni	k l 'ɔ n i	 k l 'o n i 
clonin	k l 'ɔ n i n	 k l 'o n i n 
clonis	k l 'ɔ n i s	 k l 'o n i s 
clono	k l 'ɔ n u	 k l 'o n u 
clor	k l 'ɔ r	 k l 'o 
clora	k l 'ɔ ɾ ə	 k l 'o ɾ ə 
clores	k l 'ɔ ɾ ə s	 k l 'o ɾ ə s 
clorur	k l u ɾ 'u r	 k l u ɾ 'u 
clos	k l 'ɔ s	 k l 'o s 
closa	k l 'ɔ z ə	 k l 'o z ə 
closes	k l 'ɔ z ə s	 k l 'o z ə s 
closos	k l 'ɔ z u s	 k l 'o z u s 
clou	k l 'ɔ w	 k l 'o 
ço	s 'ɔ	 s 'o 
cobalt	k u β 'a l	 k u β 'a l t 
cobla	k 'o b b l ə	 k 'ɔ b b l ə 
cobles	k 'o b b l ə s	 k 'ɔ b b l ə s 
coca	k 'o k ə	 k 'ɔ k ə 
coclear	k u k l e 'a r	 k u k l e 'a 
coco	k 'o k u	 k 'ɔ k u 
cofoi	k u f 'ɔ j	 k u f 'o i 
cogoma	k u ɣ 'ɔ m ə	 k u ɣ 'o m ə 
cogombre	k u ɣ 'o m b ɾ ə	 k u ɣ 'ɔ m b ɾ ə 
coherentment	k u ə ɾ ə m m 'e n	 k u β ə ɾ ə n ə m 'e n 
coit	k 'ɔ j t	 k u 'i t 
colesteatoma	k u l ə s t e ə t 'ɔ m ə	 k u l ə s t ə ə t 'o m ə 
colesteatomes	k u l ə s t e ə t 'ɔ m ə s	 k u l ə s t ə ə t 'o m ə s 
coll	k 'ɔ ʎ	 k 'o ʎ 
colossos	k u l 'o s u s	 k u l 'ɔ s u s 
colze	k 'o l z ə	 k 'ɔ l z ə 
colzes	k 'o l z ə s	 k 'ɔ l z ə s 
comboi	k u m b 'ɔ j	 k u m b 'o i 
Comores	k u m 'ɔ ɾ ə s	 k u m 'o ɾ ə s 
compareixença	k u m p ə ɾ ə ʃ 'ɛ n s ə	 k u m p ə ɾ ə ʃ 'e n s ə 
complerts	k u m p l 'ɛ r s	 k u m p l 'ɛ r t s 
còmplices	k 'ɔ m p l i s ə s	 k u m p l 'i s ə s 
compon	k u m p 'ɔ n	 k u m p 'o n 
compost	k u m p 'ɔ s t	 k u m p 'o s t 
compra	k 'o m p ɾ ə	 k 'ɔ m p ɾ ə 
compren	k 'o m p ɾ ə n	 k 'ɔ m p ɾ ə n 
compres	k 'o m p ɾ ə s	 k 'ɔ m p ɾ ə s 
compro	k 'o m p ɾ u	 k 'ɔ m p ɾ u 
compta	k 'o m t ə	 k 'ɔ m t ə 
comptar	k u m t 'a	 k u m p t 'a 
comptat	k u m t 'a t	 k u m p t 'a t 
comptatge	k u m t 'a d ʒ ə	 k u m p t 'a d ʒ ə 
comptatges	k u m t 'a d ʒ ə s	 k u m p t 'a d ʒ ə s 
comptats	k u m t 'a t s	 k u m p t 'a t s 
compte	k 'o m t ə	 k 'ɔ m p t ə 
compten	k 'o m t ə n	 k 'ɔ m p t ə n 
comptes	k 'o m t ə s	 k 'ɔ m p t ə s 
compti	k 'o m t i	 k 'ɔ m p t i 
comptin	k 'o m t i n	 k 'ɔ m p t i n 
compto	k 'o m t u	 k 'ɔ m p t u 
comte	k 'o m t ə	 k 'ɔ m t ə 
comtes	k 'o m t ə s	 k 'ɔ m t ə s 
comtessa	k u m t 'ɛ s ə	 k u m t 'e s ə 
conca	k 'o ŋ k ə	 k 'ɔ ŋ k ə 
concepte	k u n s 'e p t ə	 k u n s 'ɛ p t ə 
concloses	k u ŋ k l 'ɔ z ə s	 k u ŋ k l 'o z ə s 
conclosos	k u ŋ k l 'ɔ z u s	 k u ŋ k l 'o z u s 
concórrer	k u ŋ k 'o r ə	 k u ŋ k u r 'e 
concret	k u ŋ k ɾ 'e t	 k u ŋ k ɾ 'ɛ t 
còndor	k 'ɔ n d u r	 k u n d 'o 
conéixer	k u n 'e ʃ ə	 k u n ə ʃ 'e 
conques	k 'o ŋ k ə s	 k 'ɔ ŋ k ə s 
conquesta	k u ŋ k 'e s t ə	 k u ŋ k 'ɛ s t ə 
conscientment	k u n s i ə m m 'e n	 k u n s i ə n ə m 'e n 
consell	k u n s 'ɛ ʎ	 k u n s 'e ʎ 
consens	k u n s 'ɛ n s	 k u n s 'e n s 
conseqüentment	k u n s ə k w ə m m 'e n	 k u n s ə k w ə n ə m 'e n 
consta	k 'o n s t ə	 k 'ɔ n s t ə 
constantment	k u n s t ə m m 'e n	 k u n s t ə n ə m 'e n 
consten	k 'o n s t ə n	 k 'ɔ n s t ə n 
consuetud	k u n s u ə t 'u t	 k u n s ə t 'u t 
consular	k u n s u l 'a r	 k u n s u l 'a 
conta	k 'o n t ə	 k 'ɔ n t ə 
conte	k 'o n t ə	 k 'ɔ n t ə 
conten	k 'o n t ə n	 k 'ɔ n t ə n 
contes	k 'o n t ə s	 k 'ɔ n t ə s 
context	k u n t 'e k s t	 k u n t 'ɛ k s t 
contret	k u n t ɾ 'e t	 k u n t ɾ 'ɛ t 
contreta	k u n t ɾ 'e t ə	 k u n t ɾ 'ɛ t ə 
contrets	k u n t ɾ 'e t s	 k u n t ɾ 'ɛ t s 
convèncer	k u m b 'ɛ n s ə	 k u m b 'ɛ n s ə r 
convenientment	k u m b ə n i ə m m 'e n	 k u m b ə n i ə n ə m 'e n 
copa	k 'o p ə	 k 'ɔ p ə 
Copenhaguen	k u p ə n 'a ɣ ə n	 k u p ə n u 'a ɣ ə n 
copes	k 'o p ə s	 k 'ɔ p ə s 
copsa	k 'o p s ə	 k 'ɔ p s ə 
coquessa	k u k 'ɛ s ə	 k u k 'e s ə 
cor	k 'ɔ r	 k 'o 
cora	k 'ɔ ɾ ə	 k 'o ɾ ə 
coreana	k u ɾ e 'a n ə	 k u ɾ ə 'a n ə 
coreanes	k u ɾ e 'a n ə s	 k u ɾ ə 'a n ə s 
coreans	k u ɾ e 'a n s	 k u ɾ ə 'a n s 
córner	k 'o r n ə	 k u r n 'e 
corre	k 'o r ə	 k 'ɔ r ə 
corren	k 'o r ə n	 k 'ɔ r ə n 
córrer	k 'o r ə	 k u r 'e 
corri	k 'o r i	 k 'ɔ r i 
corrin	k 'o r i n	 k 'ɔ r i n 
corro	k 'o r u	 k 'ɔ r u 
corrompre	k u r 'o m p ɾ ə	 k u r 'ɔ m p ɾ ə 
cors	k 'ɔ r s	 k 'o s 
corsa	k 'o r s ə	 k 'ɔ r s ə 
corses	k 'o r s ə s	 k 'ɔ r s ə s 
corsos	k 'o r s u s	 k 'ɔ r s u s 
Corts	k 'o r s	 k 'o r t s 
cos	k 'ɔ s	 k 'o s 
cosa	k 'ɔ z ə	 k 'o z ə 
coses	k 'ɔ z ə s	 k 'o z ə s 
cosinus	k u s 'i n u s	 k u z 'i n u s 
cost	k 'ɔ s t	 k 'o s t 
cotxe	k 'o t ʃ ə	 k 'ɔ t ʃ ə 
cotxes	k 'o t ʃ ə s	 k 'ɔ t ʃ ə s 
cou	k 'ɔ w	 k 'o w 
creada	k ɾ e 'a ð ə	 k ə e 'a ð ə 
creades	k ɾ e 'a ð ə s	 k ə e 'a ð ə s 
creen	k ɾ 'e ə n	 k ɾ 'ɛ ə n 
creença	k ɾ ə 'ɛ n s ə	 k ɾ ə 'e n s ə 
creï	k ɾ 'e i	 k ɾ 'ɛ i 
creient	k ɾ ə j 'e n	 k ɾ ə i 'e n 
creïn	k ɾ 'e i n	 k ɾ ə 'i n 
creixen	k ɾ 'e ʃ ə n	 k ɾ 'ɛ ʃ ə n 
créixer	k ɾ 'e ʃ ə	 k ɾ ə ʃ 'e 
crema	k ɾ 'e m ə	 k ɾ 'ɛ m ə 
cremen	k ɾ 'e m ə n	 k ɾ 'ɛ m ə n 
cremes	k ɾ 'e m ə s	 k ɾ 'ɛ m ə s 
cremi	k ɾ 'e m i	 k ɾ 'ɛ m i 
cremin	k ɾ 'e m i n	 k ɾ 'ɛ m i n 
crepuscular	k ɾ ə p u s k u l 'a r	 k ɾ ə p u s k u l 'a 
cretenc	k ɾ ə t 'ɛ ŋ	 k ɾ ə t 'ɛ n s 
cuidada	k u j ð 'a ð ə	 k u i ð 'a ð ə 
cuidades	k u j ð 'a ð ə s	 k u i ð 'a ð ə s 
cuidar	k u j ð 'a	 k u i ð 'a 
cuidares	k u j ð 'a ɾ ə s	 k u i ð 'a ɾ ə s 
cuidat	k u j ð 'a t	 k u i ð 'a t 
cuidats	k u j ð 'a t s	 k u i ð 'a t s 
cuidava	k u j ð 'a β ə	 k u i ð 'a β ə 
cuidem	k u j ð 'ɛ m	 k u i ð 'ɛ m 
cuinada	k u j n 'a ð ə	 k u i n 'a ð ə 
cuinades	k u j n 'a ð ə s	 k u i n 'a ð ə s 
cuinar	k u j n 'a	 k u i n 'a 
cuinat	k u j n 'a t	 k u i n 'a t 
cuinats	k u j n 'a t s	 k u i n 'a t s 
cuiner	k u j n 'e	 k u i n 'e 
cuir	k 'u j r	 k 'u ʃ 
cuitada	k u j t 'a ð ə	 k u i t 'a ð ə 
cuitades	k u j t 'a ð ə s	 k u i t 'a ð ə s 
cuitar	k u j t 'a	 k u i t 'a 
cuitat	k u j t 'a t	 k u i t 'a t 
cuitats	k u j t 'a t s	 k u i t 'a t s 
curricular	k u r i k u l 'a r	 k u r i k u l 'a 
currículum	k u r 'i k u l u m	 k u r i k u l 'u m 
currículums	k u r 'i k u l u m s	 k u r i k u l 'u m s 
curts	k 'u r s	 k 'u r t s 
d'acord	d ə k 'ɔ r t	 d ə k 'o r t 
d'hora	d 'ɔ ɾ ə	 d i 'o ɾ ə 
dard	d 'a r t	 d 'a r 
darrere	d ə r 'e ɾ ə	 d ə r 'ɛ ɾ ə 
de	d 'ə	 d ə 
dècade	d 'ɛ k ə ð ə	 d ə k 'a ð ə 
decor	d ə k 'o r	 d ə k 'o 
decréixer	d ə k ɾ 'e ʃ ə	 d ə k ɾ ə ʃ 'e 
decret	d ə k ɾ 'e t	 d ə k ɾ 'ɛ t 
Deessa	d ə 'ɛ s ə	 d ə 'e s ə 
deessa	d ə 'ɛ s ə	 d ə 'e s ə 
dèficit	d 'ɛ f i s i t	 d ə f i s 'i t 
defora	d ə f 'ɔ ɾ ə	 d ə f 'o ɾ ə 
degoteig	d ə ɣ u t 'ɛ t ʃ	 d ə ɣ u t 'ɛ ʃ 
dei	d 'ɛ j	 d 'ɛ i 
deis	d 'ɛ j s	 d 'ɛ i s 
deixeble	d ə ʃ 'e b b l ə	 d ə ʃ 'ɛ b b l ə 
deixis	d 'e ʃ i s	 d 'ɛ ʃ i s 
deler	d ə l 'ɛ	 d ə l 'e 
delinqüència	d ə l i ŋ k w 'ɛ n s i ə	 d ə l i n ə w 'ɛ n s i ə 
demagog	d ə m ə ɣ 'ɔ k	 d ə m ə ɣ 'o 
Dénia	d 'e n i ə	 d ə n 'i ə 
dens	d 'ɛ n s	 d 'e n s 
desa	d 'e z ə	 d 'ɛ z ə 
desaigüe	d ə z 'a j ɣ w ə	 d ə z 'a i ɣ w ə 
desamor	d ə z ə m 'o r	 d ə z ə m 'o 
desatendre	d ə z ə t 'e n d ɾ ə	 d ə z ə t 'ɛ n d ɾ ə 
desavinença	d ə z ə β i n 'ɛ n s ə	 d ə z ə β i n 'e n s ə 
descompte	d ə s k 'o m t ə	 d ə s k 'ɔ m p t ə 
desembeinar	d ə z ə m b ə j n 'a	 d ə z ə m b ə i n 'a 
desembre	d ə z 'e m b ɾ ə	 d ə z 'ɛ m b ɾ ə 
desfet	d ə s f 'e t	 d ə s f 'ɛ t 
desfeta	d ə s f 'e t ə	 d ə s f 'ɛ t ə 
deshonest	d ə z u n 'e s t	 d ə z u n 'ɛ s t 
desi	d 'e z i	 d 'ɛ z i 
desig	d ə z 'i t ʃ	 d ə z 'i ə 
desigs	d ə z 'i t ʃ s	 d ə z 'i g s 
desmai	d ə z m 'a j	 d ə z m 'a i 
deso	d 'e z u	 d 'ɛ z u 
Despuig	d ə s p 'u t ʃ	 d ə s p 'u ʃ 
dessota	d ə s 'o t ə	 d ə s 'ɔ t ə 
destorb	d ə s t 'o r p	 d ə s t 'o r 
destra	d 'e s t ɾ ə	 d 'ɛ s t ɾ ə 
destres	d 'e s t ɾ ə s	 d 'ɛ s t ɾ ə s 
desuetud	d ə z u ə t 'u t	 d ə s ə t 'u t 
detona	d ə t 'ɔ n ə	 d ə t 'o n ə 
detones	d ə t 'ɔ n ə s	 d ə t 'o n ə s 
detono	d ə t 'ɔ n u	 d ə t 'o n u 
deutor	d ə w t 'o	 d ə u t 'o 
devers	d ə β 'ɛ r s	 d ə β 'e s 
diatomea	d i ə t u m 'ɛ ə	 d i ə t u m 'e ə 
difondre	d i f 'o n d ɾ ə	 d i f 'ɔ n d ɾ ə 
dijous	d i ʒ 'ɔ w s	 d i ʒ u 'u s 
diligentment	d i l i ʒ ə m m 'e n	 d i l i ʒ ə n ə m 'e n 
dimarts	d i m 'a r s	 d i m 'a r t s 
dimecres	d i m 'e k ɾ ə s	 d i m 'ɛ k ɾ ə s 
dimoni	d i m 'ɔ n i	 d i m 'o n i 
dimonis	d i m 'ɔ n i s	 d i m 'o n i s 
dinou	d i n 'ɔ w	 d i n 'o 
dirimiu	d i ɾ i m 'i w	 d i ɾ i m 'i u 
discórrer	d i s k 'o r ə	 d i s k u r 'e 
discret	d i s k ɾ 'e t	 d i s k ɾ 'ɛ t 
discreta	d i s k ɾ 'e t ə	 d i s k ɾ 'ɛ t ə 
discretes	d i s k ɾ 'e t ə s	 d i s k ɾ 'ɛ t ə s 
discrets	d i s k ɾ 'e t s	 d i s k ɾ 'ɛ t s 
dispers	d i s p 'ɛ r s	 d i s p 'e s 
displicent	d i s p l i s 'e n	 d i s p l i k 'e n 
dissabte	d i s 'a p t ə	 d i s 'a b b t ə 
dissolt	d i s 'ɔ l t	 d i s 'o l t 
dissort	d i s 'ɔ r t	 d i s 'o r t 
distendre	d i s t 'e n d ɾ ə	 d i s t 'ɛ n d ɾ ə 
distret	d i s t ɾ 'e t	 d i s t ɾ 'ɛ t 
distreta	d i s t ɾ 'e t ə	 d i s t ɾ 'ɛ t ə 
distrets	d i s t ɾ 'e t s	 d i s t ɾ 'ɛ t s 
diumenge	d i w m 'e n ʒ ə	 d i u m 'ɛ n ʒ ə 
divers	d i β 'ɛ r s	 d i β 'e s 
dividend	d i β i ð 'e n	 d i β i ð 'ɛ n d 
Djibouti	d ʒ i β 'ɔ w t i	 d ʒ i β u 'u t i 
do	d 'ɔ	 d 'o 
dobla	d 'o b b l ə	 d 'ɔ b b l ə 
doble	d 'o b b l ə	 d 'ɔ b b l ə 
doblec	d u b b l 'ɛ k	 d u p l 'ɛ k 
doblen	d 'o b b l ə n	 d 'ɔ b b l ə n 
dobles	d 'o b b l ə s	 d 'ɔ b b l ə s 
dolça	d 'o l s ə	 d 'ɔ l s ə 
dolces	d 'o l s ə s	 d 'ɔ l s ə s 
dolços	d 'o l s u s	 d 'ɔ l s u s 
dona	d 'ɔ n ə	 d 'o n ə 
donen	d 'o n ə n	 d 'ɔ n ə n 
dones	d 'ɔ n ə s	 d 'o n ə s 
dons	d 'ɔ n s	 d 'o n s 
dors	d 'ɔ r s	 d 'o s 
dotze	d 'o d z ə	 d 'ɔ d z ə 
dramaturg	d ɾ ə m ə t 'u r k	 d ɾ ə m ə t 'u r 
dreces	d ɾ 'ɛ s ə s	 d ɾ 'e s ə s 
driblar	d ɾ i b b l 'a	 d ɾ i β l 'a 
dubtada	d u p t 'a ð ə	 d u ə t 'a ð ə 
dubtades	d u p t 'a ð ə s	 d u ə t 'a ð ə s 
duquessa	d u k 'ɛ s ə	 d u k 'e s ə 
duus	d 'u w s	 d u 'u s 
Ebre	'e β ɾ ə	 'ɛ β ɾ ə 
ebrenc	ə β ɾ 'ɛ ŋ	 ə β ɾ 'ɛ ŋ k 
ecosistema	ə k u s i s t 'e m ə	 ə k u z i s t 'ɛ m ə 
Edimburg	ə ð i m b 'u r k	 ə ð i m b 'u r 
egües	'ɛ ɣ w ə s	 'ɛ g w ə s 
ei	'e j	 'ɛ i 
Eivissa	ə j β 'i s ə	 ə i β 'i s ə 
eivissenc	ə j β i s 'ɛ ŋ	 ə j β i s 'ɛ n s 
eixarm	ə ʃ 'a r m	 ə i k s 'a r m 
ela	'e l ə	 'ɛ l ə 
eland	ə l 'a n	 ə l 'a n ə 
elèctrica	ə l 'ɛ k t ɾ i k ə	 ə l ə k t ɾ 'i k ə 
elèctrics	ə l 'ɛ k t ɾ i k s	 ə l ə k t ɾ 'i k s 
elèctrode	ə l 'ɛ k t ɾ u ð ə	 ə l ə k t ɾ 'ɔ ð ə 
elegantment	ə l ə ɣ ə m m 'e n	 ə l ə ɣ ə n ə m 'e n 
element	ə l ə m 'e n	 ɛ l ə m 'e n 
elenc	ə l 'ɛ ŋ	 ə l 'ɛ n s 
Eloi	ə l 'ɔ j	 ə l 'o i 
eloqüent	ə l u k w 'e n	 ə l u ə w 'e n 
em	'ə m	 ə m 
ema	'e m ə	 'ɛ m ə 
emboirar	ə m b u j ɾ 'a	 ə m b u i ɾ 'a 
embruixar	ə m b ɾ u ʃ 'a	 ə m b ɾ u i ʃ 'a 
eminentment	ə m i n ə m m 'e n	 ə m i n ə n ə m 'e n 
emir	ə m 'i r	 ə m 'i 
empaitar	ə m p ə j t 'a	 ə m p ə i t 'a 
empelt	ə m p 'ɛ l	 ə m p 'ɛ l t 
empenta	ə m p 'ɛ n t ə	 ə m p 'e n t ə 
empra	'e m p ɾ ə	 'ɛ m p ɾ ə 
empremta	ə m p ɾ 'e m t ə	 ə m p ɾ 'ɛ m t ə 
empren	'e m p ɾ ə n	 'ɛ m p ɾ ə n 
empri	'e m p ɾ i	 'ɛ m p ɾ i 
en	'ə n	 ə n 
ena	'e n ə	 'ɛ n ə 
enagües	ə n 'a ɣ w ə s	 ə n 'a ɣ ə s 
encendre	ə n s 'e n d ɾ ə	 ə n s 'ɛ n d ɾ ə 
encórrer	ə ŋ k 'o r ə	 ə ŋ k u r 'e 
endarrere	ə n d ə r 'e ɾ ə	 ə n d ə r 'ɛ ɾ ə 
endinsar	ə n d i n z 'a	 ə n d i n s 'a 
endinsat	ə n d i n z 'a t	 ə n d i n s 'a t 
ene	'e n ə	 'ɛ n ə 
enhorabona	ə n u ɾ ə β 'ɔ n ə	 ə n u ɾ ə β 'o n ə 
enmig	ə m m 'i t ʃ	 ə n m 'i ə 
enorme	ə n 'o r m ə	 ə n 'ɔ r m ə 
enormes	ə n 'o r m ə s	 ə n 'ɔ r m ə s 
enquesta	ə ŋ k 'e s t ə	 ə ŋ k 'ɛ s t ə 
enreixar	ə n r ə ʃ 'a	 ə n r ə i ʃ 'a 
enrenou	ə n r ə n 'ɔ w	 ə n r ə n 'o 
enrere	ə n r 'e ɾ ə	 ə n r 'ɛ ɾ ə 
ens	'ə n s	 ə n s 
entendre	ə n t 'e n d ɾ ə	 ə n t 'ɛ n d ɾ ə 
enter	ə n t 'e r	 ə n t 'e 
entre	'e n t ɾ ə	 'ɛ n t ɾ ə 
entrebanc	ə n t ɾ ə β 'a ŋ	 ə n t ɾ ə β 'a ŋ k 
entren	'e n t ɾ ə n	 'ɛ n t ɾ ə n 
entres	'e n t ɾ ə s	 'ɛ n t ɾ ə s 
entri	'e n t ɾ i	 'ɛ n t ɾ i 
entrin	'e n t ɾ i n	 'ɛ n t ɾ i n 
entris	'e n t ɾ i s	 'ɛ n t ɾ i s 
entro	'e n t ɾ u	 'ɛ n t ɾ u 
enuig	ə n 'u t ʃ	 ə n 'u ʃ 
envers	ə m b 'ɛ r s	 ə m b 'e s 
Èol	'ɛ u l	 ɛ 'ɔ l 
Eos	'ɛ u s	 ɛ 'ɔ s 
ep	'e p	 'ɛ p 
epicens	ə p i s 'ɛ n s	 ə p i k 'e n s 
equivaler	ə k i β ə l 'ɛ	 ə k i β ə l 'e 
equivoco	ə k i β 'o k u	 ə k i β 'ɔ k u 
érem	'e ɾ ə m	 e ɾ 'ɛ m 
eren	'e ɾ ə n	 'ɛ ɾ ə n 
éreu	'e ɾ ə w	 e ɾ 'ɛ w 
erra	'e r ə	 'ɛ r ə 
errabund	ə r ə β 'u n	 ə r ə β 'u n d 
erres	'e r ə s	 'ɛ r ə s 
erroni	ə r 'ɔ n i	 ə r 'o n i 
error	ə r 'o r	 ə r 'o 
es	'ə s	 ə s 
escaig	ə s k 'a t ʃ	 ə s k 'a ʃ 
escairada	ə s k ə j ɾ 'a ð ə	 ə s k ə i ɾ 'a ð ə 
escairades	ə s k ə j ɾ 'a ð ə s	 ə s k ə i ɾ 'a ð ə s 
escairar	ə s k ə j ɾ 'a	 ə s k ə i ɾ 'a 
escairat	ə s k ə j ɾ 'a t	 ə s k ə i ɾ 'a t 
escairats	ə s k ə j ɾ 'a t s	 ə s k ə i ɾ 'a t s 
escalens	ə s k ə l 'ɛ n s	 ə s k ə l 'e n s 
escàner	ə s k 'a n ə	 ə s k 'a n ə r 
escletxa	ə s k l 'e t ʃ ə	 ə s k l 'ɛ t ʃ ə 
escolar	ə s k u l 'a r	 ə s k u l 'a 
escolta	ə s k 'o l t ə	 ə s k 'ɔ l t ə 
escombra	ə s k 'o m b ɾ ə	 ə s k 'ɔ m b ɾ ə 
escombriaire	ə s k u m b ɾ i 'a j ɾ ə	 ə s k u m b ɾ i ə 'i ɾ ə 
escórrer	ə s k 'o r ə	 ə s k u r 'e 
escrot	ə s k ɾ 'o t	 ə s k ɾ 'ɔ t 
esfinx	ə s f 'i n ʃ	 ə s f 'i n 
esforç	ə s f 'ɔ r s	 ə s f 'o r s 
esglai	ə z ɣ l 'a j	 ə z ə l 'a i 
esguard	ə z ɣ w 'a r t	 ə z ɣ u 'a r t 
esguerro	ə z ɣ 'ɛ r u	 ə z ɣ u 'ɛ r u 
esment	ə z m 'e n	 e z m 'e n 
espagueti	ə s p ə ɣ 'ɛ t i	 ə s p ə ɣ u 'ɛ t i 
espai	ə s p 'a j	 ə s p 'a i 
espais	ə s p 'a j s	 ə s p 'a i s 
espart	ə s p 'a r	 ə s p 'a r t 
espectacular	ə s p ə k t ə k u l 'a r	 ə s p ə k t ə k u l 'a 
espectre	ə s p 'e k t ɾ ə	 ə s p 'ɛ k t ɾ ə 
espinavessa	ə s p i n ə β 'ɛ s ə	 ə s p i n ə β 'e s ə 
esplai	ə s p l 'a j	 ə s p l 'a i 
esplèndid	ə s p l 'ɛ n d i t	 ə s p l 'ɛ n d i ð 
espona	ə s p 'ɔ n ə	 ə s p 'o n ə 
esposa	ə s p 'ɔ z ə	 ə s p 'o z ə 
esprémer	ə s p ɾ 'e m ə	 ə s p ɾ ə m 'e 
esqueix	ə s k 'ɛ ʃ	 ə s k 'e ʃ 
esquellerinc	ə s k ə ʎ ə ɾ 'i ŋ	 ə s k ə ʎ ə ɾ 'i ŋ k 
esquetx	ə s k 'e t ʃ	 ə s k 'ɛ t ʃ 
esquiu	ə s k 'i w	 ə s k 'i u 
essa	'ɛ s ə	 'e s ə 
esser	ə s 'ɛ	 ə s 'e 
ésser	'e s ə r	 'e s ə 
est	'e s t	 'ɛ s t 
esta	'e s t ə	 'ɛ s t ə 
estabeig	ə s t ə β 'ɛ t ʃ	 ə s t ə β 'ɛ ʃ 
establerts	ə s t ə b b l 'ɛ r s	 ə s t ə b b l 'ɛ r t s 
estai	ə s t 'a j	 ə s t 'a i 
estament	ə s t ə m 'e n	 ɛ s t ə m 'e n 
estàndard	ə s t 'a n d ə r t	 ə s t 'a n d ə r 
estatunidenc	ə s t ə t u n i ð 'ɛ ŋ	 ə s t ə t u n i ð 'ɛ n s 
estendre	ə s t 'e n d ɾ ə	 ə s t 'ɛ n d ɾ ə 
Ester	ə s t 'e r	 ə s t 'e 
estiueig	ə s t i w 'ɛ t ʃ	 ə s t i u 'ɛ ʃ 
estiuenc	ə s t i w 'ɛ ŋ	 ə s t i w 'ɛ n s 
estofa	ə s t 'o f ə	 ə s t 'ɔ f ə 
estoig	ə s t 'ɔ t ʃ	 ə s t u 'i ə 
estómac	ə s t 'o m ə k	 ə s t u m 'a k 
estos	'e s t u s	 'ɛ s t u s 
estramoni	ə s t ɾ ə m 'ɔ n i	 ə s t ɾ ə m 'o n i 
estrateg	ə s t ɾ ə t 'ɛ k	 ə s t ɾ ə t 'ɛ g 
esvoranc	ə z β u ɾ 'a ŋ	 ə z β u ɾ 'a n s 
ètnia	'ɛ d n i ə	 'ɛ t n i ə 
etnòleg	ə d n 'ɔ l ə k	 ə t n 'ɔ l ə k 
etnòlegs	ə d n 'ɔ l ə k s	 ə t n 'ɔ l ə k s 
etnòloga	ə d n 'ɔ l u ɣ ə	 ə t n 'ɔ l u ɣ ə 
ets	'e t s	 'ɛ t s 
eufoni	ə w f 'ɔ n i	 ə u f 'o n i 
Eulàlia	ə w l 'a l i ə	 ə u l 'a l i ə 
Eurídice	ə w ɾ 'i ð i s ə	 ə u ɾ 'i ð i s ə 
èuscar	'ɛ w s k ə r	 ɛ w s k 'a 
evidentment	ə β i ð ə m m 'e n	 ə β i ð ə n ə m 'e n 
evolucionis	ə β u l u s i 'ɔ n i s	 ə β u l u s i 'o n i s 
excepte	ə k s 'e p t ə	 ə k s 'ɛ p t ə 
exclosa	ə k s k l 'ɔ z ə	 ə k s k l 'o z ə 
excloses	ə k s k l 'ɔ z ə s	 ə k s k l 'o z ə s 
exclosos	ə k s k l 'ɔ z u s	 ə k s k l 'o z u s 
experts	ə k s p 'ɛ r s	 ə k s p 'ɛ r t s 
expresses	ə k s p ɾ 'e s ə s	 ə k s p ɾ 'ɛ s ə s 
expressos	ə k s p ɾ 'e s u s	 ə k s p ɾ 'ɛ s u s 
exsenador	ə k s ə n ə ð 'o	 ə k s s ə n ə ð 'o 
exsoviètic	ə k s u β i 'ɛ t i k	 ə k s s u β i 'ɛ t i k 
exsoviètica	ə k s u β i 'ɛ t i k ə	 ə k s s u β i 'ɛ t i k ə 
exsudar	ə k s u ð 'a	 ə s u ð 'a 
extens	ə k s t 'ɛ n s	 ə k s t 'e n s 
exterior	ə k s t ə ɾ i 'o r	 ə k s t ə ɾ i 'o 
extrem	ə k s t ɾ 'e m	 ə k s t ɾ 'ɛ m 
extrema	ə k s t ɾ 'e m ə	 ə k s t ɾ 'ɛ m ə 
extret	ə k s t ɾ 'e t	 ə k s t ɾ 'ɛ t 
extreta	ə k s t ɾ 'e t ə	 ə k s t ɾ 'ɛ t ə 
extretes	ə k s t ɾ 'e t ə s	 ə k s t ɾ 'ɛ t ə s 
extrets	ə k s t ɾ 'e t s	 ə k s t ɾ 'ɛ t s 
Fàbregas	f 'a β ɾ ə ɣ ə s	 f ə β ɾ ə ɣ 'a s 
fagosoma	f ə ɣ u z 'ɔ m ə	 f ə ɣ u z 'o m ə 
faig	f 'a t ʃ	 f 'a ʃ 
familiar	f ə m i l i 'a r	 f ə m i l i 'a 
famolenc	f ə m u l 'ɛ ŋ	 f ə m u l 'ɛ n s 
faquir	f ə k 'i r	 f ə k 'i 
far	f 'a r	 f 'a 
farigola	f ə ɾ i ɣ 'o l ə	 f ə ɾ i ɣ 'ɔ l ə 
farts	f 'a r s	 f 'a r t s 
fauna	f 'a w n ə	 f ə 'u n ə 
faune	f 'a w n ə	 f ə 'u n ə 
favor	f ə β 'o r	 f ə β 'o 
feble	f 'e b b l ə	 f 'ɛ b b l ə 
febles	f 'e b b l ə s	 f 'ɛ b b l ə s 
febre	f 'e β ɾ ə	 f 'ɛ β ɾ ə 
febres	f 'e β ɾ ə s	 f 'ɛ β ɾ ə s 
fecund	f ə k 'u n	 f ə k 'u n d 
fecunds	f ə k 'u n s	 f ə k 'u n d s 
feinada	f ə j n 'a ð ə	 f ə i n 'a ð ə 
feiner	f ə j n 'e	 f ə i n 'e 
feldspat	f ə l t s p 'a t	 f ə l s p 'a t 
femellenc	f ə m ə ʎ 'ɛ ŋ	 f ə m ə ʎ 'ɛ n s 
fen	f 'e n	 f 'ɛ n 
fenc	f 'ɛ ŋ	 f 'ɛ n s 
Fènix	f 'ɛ n i k s	 f 'ɛ n ʃ 
fènix	f 'ɛ n i k s	 f 'ɛ n ʃ 
fens	f 'ɛ n s	 f 'e n s 
feren	f 'e ɾ ə n	 f 'ɛ ɾ ə n 
fes	f 'e s	 f 'ɛ s 
Fes	f 'e s	 f 'ɛ s 
fessin	f 'e s i n	 f 'ɛ s i n 
fessis	f 'e s i s	 f 'ɛ s i s 
festa	f 'e s t ə	 f 'ɛ s t ə 
festeig	f ə s t 'ɛ t ʃ	 f ə s t 'ɛ ʃ 
festes	f 'e s t ə s	 f 'ɛ s t ə s 
fet	f 'e t	 f 'ɛ t 
feta	f 'e t ə	 f 'ɛ t ə 
fetes	f 'e t ə s	 f 'ɛ t ə s 
fetge	f 'e d ʒ ə	 f 'ɛ d ʒ ə 
fets	f 'e t s	 f 'ɛ t s 
feudal	f ə w ð 'a l	 f ə u ð 'a l 
figuerenc	f i ɣ ə ɾ 'ɛ ŋ	 f i ɣ ə ɾ 'ɛ n s 
fímbria	f 'i m b ɾ i ə	 f i m b ɾ 'i ə 
finestra	f i n 'e s t ɾ ə	 f i n 'ɛ s t ɾ ə 
flairada	f l ə j ɾ 'a ð ə	 f l ə i ɾ 'a ð ə 
flairades	f l ə j ɾ 'a ð ə s	 f l ə i ɾ 'a ð ə s 
flairar	f l ə j ɾ 'a	 f l ə i ɾ 'a 
flairat	f l ə j ɾ 'a t	 f l ə i ɾ 'a t 
flairats	f l ə j ɾ 'a t s	 f l ə i ɾ 'a t s 
flamenc	f l ə m 'ɛ ŋ	 f l ə m 'ɛ n s 
flamencs	f l ə m 'ɛ ŋ s	 f l ə m 'ɛ ŋ k s 
fletxa	f l 'e t ʃ ə	 f l 'ɛ t ʃ ə 
fletxes	f l 'e t ʃ ə s	 f l 'ɛ t ʃ ə s 
flor	f l 'ɔ	 f l 'o 
flora	f l 'ɔ ɾ ə	 f l 'o ɾ ə 
floristeria	f l u ɾ i s t ə ɾ 'i ə	 f l 'ɔ ɾ 'i s t ə ɾ 'i ə 
flors	f l 'ɔ s	 f l 'o s 
fluid	f l 'u j t	 f l 'u j ð 
fluorur	f l u u ɾ 'u r	 f l u u ɾ 'u 
foca	f 'o k ə	 f 'ɔ k ə 
focus	f 'o k u s	 f 'ɔ k u s 
folla	f 'o ʎ ə	 f 'ɔ ʎ ə 
folles	f 'o ʎ ə s	 f 'ɔ ʎ ə s 
folre	f 'o l r ə	 f 'ɔ l r ə 
folren	f 'ɔ l r ə n	 f 'ɔ l ə n 
fonda	f 'o n d ə	 f 'ɔ n d ə 
fondes	f 'o n d ə s	 f 'ɔ n d ə s 
fondo	f 'o n d u	 f 'ɔ n d u 
fondos	f 'o n d u s	 f 'ɔ n d u s 
fondre	f 'o n d ɾ ə	 f 'ɔ n d ɾ ə 
font	f 'ɔ n	 f 'o n 
foques	f 'o k ə s	 f 'ɔ k ə s 
fora	f 'ɔ ɾ ə	 f 'o ɾ ə 
forassenyat	f u ɾ ə s ə ɲ 'a t	 f 'o ɾ 'a s ə ɲ 'a t 
forca	f 'o r k ə	 f 'ɔ r k ə 
foren	f 'o ɾ ə n	 f 'ɔ ɾ ə n 
forma	f 'o r m ə	 f 'ɔ r m ə 
formen	f 'o r m ə n	 f 'ɔ r m ə n 
formes	f 'o r m ə s	 f 'ɔ r m ə s 
formi	f 'o r m i	 f 'ɔ r m i 
formigueig	f u r m i ɣ 'ɛ t ʃ	 f u r m i ɣ u 'ɛ ʃ 
formin	f 'o r m i n	 f 'ɔ r m i n 
formo	f 'o r m u	 f 'ɔ r m u 
forques	f 'o r k ə s	 f 'ɔ r k ə s 
fort	f 'ɔ r t	 f 'o r t 
fosca	f 'o s k ə	 f 'ɔ s k ə 
foscos	f 'o s k u s	 f 'ɔ s k u s 
fosques	f 'o s k ə s	 f 'ɔ s k ə s 
fossin	f 'o s i n	 f 'ɔ s i n 
fossis	f 'o s i s	 f 'ɔ s i s 
foten	f 'o t ə n	 f 'ɔ t ə n 
foti	f 'o t i	 f 'ɔ t i 
fotin	f 'o t i n	 f 'ɔ t i n 
fotis	f 'o t i s	 f 'ɔ t i s 
foto	f 'o t u	 f 'ɔ t u 
fotos	f 'o t u s	 f 'ɔ t u s 
fotovoltaic	f u t u β u l t 'a j k	 f u t u β u l t 'a i k 
fotovoltaics	f u t u β u l t 'a j k s	 f u t u β u l t ə 'i k s 
fotovoltaiques	f u t u β u l t 'a j k ə s	 f u t u β u l t 'a i k ə s 
fotre	f 'o t ɾ ə	 f 'ɔ t ɾ ə 
franctirador	f ɾ ə ŋ t i ɾ ə ð 'o	 f ɾ ə ŋ k t i ɾ ə ð 'o 
frankfurt	f ɾ ə ŋ k f 'u r t	 f ɾ ə n ə f 'u r t 
fred	f ɾ 'ɛ t	 f ɾ 'e d 
frens	f ɾ 'ɛ n s	 f ɾ 'e n s 
freqüentment	f ɾ ə k w ə m m 'e n	 f ɾ ə k w ə n ə m 'e n 
fressa	f ɾ 'ɛ s ə	 f ɾ 'e s ə 
fuig	f 'u t ʃ	 f 'u ʃ 
funicular	f u n i k u l 'a r	 f u n i k u l 'a 
furibund	f u ɾ i β 'u n	 f u ɾ i β 'u n d 
furor	f u ɾ 'o r	 f u ɾ 'o 
futur	f u t 'u r	 f u t 'u 
gemec	ʒ ə m 'e k	 ʒ ə m 'ɛ k 
gemma	ʒ 'e m m ə	 ʒ 'ɛ m m ə 
Gemma	ʒ 'e m m ə	 ʒ 'ɛ m m ə 
geocèntrics	ʒ ə u s 'ɛ n t ɾ i k s	 ʒ ə u s ə n t ɾ 'i k s 
gerd	ʒ 'ɛ r	 ʒ 'ɛ r t 
gespa	ʒ 'e s p ə	 ʒ 'ɛ s p ə 
gest	ʒ 'e s t	 ʒ 'ɛ s t 
gesta	ʒ 'e s t ə	 ʒ 'ɛ s t ə 
gestes	ʒ 'e s t ə s	 ʒ 'ɛ s t ə s 
gestos	ʒ 'e s t u s	 ʒ 'ɛ s t u s 
ginebra	ʒ i n 'e β ɾ ə	 ʒ i n 'ɛ β ɾ ə 
Ginebra	ʒ i n 'e β ɾ ə	 ʒ i n 'ɛ β ɾ ə 
ginesta	ʒ i n 'e s t ə	 ʒ i n 'ɛ s t ə 
gir	ʒ 'i r	 ʒ 'i 
hàbil	'a β i l	 ə β i l 
hàbit	'a β i t	 ə β i t 
hàbitat	'a β i t ə t	 ə β i t 'a t 
hàbitats	'a β i t ə t s	 ə β i t 'a t s 
hac	'a k	 i 'a k 
hacs	'a k s	 i 'a k s 
hafni	'a f n i	 i 'a f n i 
hagi	'a ʒ i	 i 'a ʒ i 
hàgim	'a ʒ i m	 'ɔ ʒ i m 
hàgiu	'a ʒ i w	 i 'a ʒ i w 
Haia	'a j ə	 ə 'i ə 
haig	'a t ʃ	 ə 'i ə 
Hainan	ə j n 'a n	 ə i n 'a n 
Hainaut	ə j n 'a w t	 ə i n ə 'u t 
Haití	ə j t 'i	 ə i t 'i 
hala	'a l ə	 i 'a l ə 
halada	ə l 'a ð ə	 i ə l 'a ð ə 
halades	ə l 'a ð ə s	 i ə l 'a ð ə s 
halal	ə l 'a l	 i ə l 'a l 
halat	ə l 'a t	 i ə l 'a t 
halats	ə l 'a t s	 i ə l 'a t s 
halur	ə l 'u r	 ə l 'u 
hamaca	ə m 'a k ə	 u ə m 'a k ə 
Hamburg	ə m b 'u r k	 ə m b 'u r 
hàmster	'a m s t ə r	 a m s t 'e 
han	'a n	 i 'a n 
has	'a s	 i 'a s 
hassi	'a s i	 'ɔ s i 
haver	ə β 'ɛ	 ə β 'e 
he	'e	 'ɛ 
hebraic	ə β ɾ 'a j k	 ə β ɾ 'a i k 
Hèbrides	'ɛ β ɾ i ð ə s	 i 'ɛ β ɾ i ð ə s 
Hècate	'ɛ k ə t ə	 ɛ k 'a t ə 
hectàrea	ə k t 'a ɾ e ə	 ə k t 'a ɾ ə ə 
hedra	'ɛ ð ɾ ə	 i 'ɛ ð ɾ ə 
hegui	'ɛ ɣ i	 i 'ɛ ɣ i 
heguin	'ɛ ɣ i n	 i 'ɛ ɣ i n 
heguis	'ɛ ɣ i s	 i 'ɛ ɣ i s 
heli	'ɛ l i	 i 'ɛ l i 
Hèlios	'ɛ l i u s	 i 'ɛ l i u s 
hèlix	'ɛ l i k s	 i 'ɛ l i k s 
hemangioma	ə m ə n ʒ i 'ɔ m ə	 ə m ə n ʒ i 'o m ə 
Hèmera	'ɛ m ə ɾ ə	 u m ə ɾ ə 
hèrnia	'ɛ r n i ə	 ə r n i ə 
heroi	ə ɾ 'ɔ j	 i ə ɾ 'o i 
heroic	ə ɾ 'ɔ j k	 i ə ɾ u 'i k 
herpes	'ɛ r p ə s	 ə r p ə s 
hèrptil	'ɛ r p t i l	 ə r p t 'i l 
heu	'ɛ w	 'ɛ u 
heura	'ɛ w ɾ ə	 i 'ɛ w ɾ ə 
heure	'ɛ w ɾ ə	 i 'ɛ w ɾ ə 
heus	'ɛ w s	 ɛ 'u s 
hevea	ə β 'ɛ ə	 ə β 'e ə 
hi	'i	 i 
híbrid	'i β ɾ i t	 ə β ɾ i ð 
hidroelèctrica	i ð ɾ u ə l 'ɛ k t ɾ i k ə	 i ð ɾ u ə l ə k t ɾ 'i k ə 
hidroelèctrics	i ð ɾ u ə l 'ɛ k t ɾ i k s	 i ð ɾ u ə l ə k t ɾ 'i k s 
hidrozou	i ð ɾ u z 'o w	 i ð ɾ u z 'o 
hieràtic	j ə ɾ 'a t i k	 i ə ɾ 'a t i k 
hieràtics	j ə ɾ 'a t i k s	 i ə ɾ 'a t i k s 
himen	'i m ə n	 ə m ə n 
himne	'i m n ə	 u 'i m n ə 
hiperespai	i p ə ɾ ə s p 'a j	 i p ə ɾ ə s p 'a i 
hiperespais	i p ə ɾ ə s p 'a j s	 i p ə ɾ ə s p 'a i s 
hipnosi	i b n 'ɔ z i	 i p n 'ɔ z i 
hipnòtic	i b n 'ɔ t i k	 i p n 'ɔ t i k 
hipnotisme	i b n u t 'i z m ə	 i p n u t 'i z m ə 
hipocamp	i p u k 'a m	 i p u k 'a m p 
hitlerià	i l l ə ɾ i 'a	 i t l ə ɾ i 'a 
hivernenc	i β ə r n 'ɛ ŋ	 i β ə r n 'ɛ n s 
hòbbit	'ɔ b b i t	 i b b i t 
hola	'ɔ l ə	 i 'ɔ l ə 
holmi	'ɔ l m i	 i 'ɔ l m i 
hom	'ɔ m	 i 'o 
home	'ɔ m ə	 u m ə 
homenenc	u m ə n 'ɛ ŋ	 u m ə n 'ɛ n s 
homenencs	u m ə n 'ɛ ŋ s	 u m ə n 'ɛ ŋ k s 
homes	'ɔ m ə s	 u m ə s 
honest	u n 'e s t	 u n 'ɛ s t 
honor	u n 'o r	 u u n 'o 
honors	u n 'o r s	 u u n 'o s 
honra	'o n r ə	 i n r ə 
honren	'ɔ n r ə n	 i n r ə n 
honri	'ɔ n r i	 i n r i 
honris	'ɔ n r i s	 i n r i s 
honro	'ɔ n r u	 i n r u 
hoquei	u k 'ɛ j	 u k 'ɛ i 
hora	'ɔ ɾ ə	 i 'o ɾ ə 
hores	'ɔ ɾ ə s	 i 'o ə s 
hort	'ɔ r t	 i 'o t 
horta	'ɔ r t ə	 u r t ə 
hoste	'ɔ s t ə	 u s t ə 
hostes	'ɔ s t ə s	 u s t ə s 
hostessa	u s t 'ɛ s ə	 u s t 'e s ə 
hòstia	'ɔ s t i ə	 u s t i ə 
hòsties	'ɔ s t i ə s	 u s t i ə s 
húmer	'u m ə r	 u m ə r 
humor	u m 'o r	 u m 'o 
humus	'u m u s	 u m u s 
i	'i	 i 
iaia	j 'a j ə	 i 'a j ə 
iaies	j 'a j ə s	 i 'a j ə s 
iaio	j 'a j u	 i 'a j u 
iber	i β 'e r	 i β 'e 
idealisme	i ð e ə l 'i z m ə	 i ð ə ə l 'i z m ə 
idealista	i ð e ə l 'i s t ə	 i ð ə ə l 'i s t ə 
ideia	i ð 'ɛ j ə	 i ð ə 'i ə 
iemenita	j ə m ə n 'i t ə	 i ə m ə n 'i t ə 
Igualada	i ɣ w ə l 'a ð ə	 i ɣ u ə l 'a ð ə 
igualar	i ɣ w ə l 'a	 i ɣ u ə l 'a 
illenc	i ʎ 'ɛ ŋ	 i ʎ 'ɛ n s 
immens	i m m 'ɛ n s	 i m m 'e n s 
immers	i m m 'ɛ r s	 i m m 'e s 
imparell	i m p ə ɾ 'ɛ ʎ	 i m p ə ɾ 'e ʎ 
imperfecta	i m p ə r f 'e k t ə	 i m p ə r f 'ɛ k t ə 
imperfecte	i m p ə r f 'e k t ə	 i m p ə r f 'ɛ k t ə 
imperfectes	i m p ə r f 'e k t ə s	 i m p ə r f 'ɛ k t ə s 
ímpetu	'i m p ə t u	 i m p 'ɛ t u 
imposes	i m p 'ɔ z ə s	 i m p 'o z ə s 
impremta	i m p ɾ 'e m t ə	 i m p ɾ 'ɛ m t ə 
imprudentment	i m p ɾ u ð ə m m 'e n	 i m p ɾ u ð ə n ə m 'e n 
impur	i m p 'u r	 i m p 'u 
inadequat	i n ə ð ə k w 'a t	 i n ə ð ə k 'a t 
inaudible	i n ə w ð 'i b b l ə	 i n ə u ð 'i b b l ə 
independentment	i n d ə p ə n d ə m m 'e n	 i n d ə p ə n d ə n ə m 'e n 
indústria	i n d 'u s t ɾ i ə	 i n d u s t ɾ 'i ə 
inerts	i n 'ɛ r s	 i n 'ɛ r t s 
inhalada	i n ə l 'a ð ə	 i n u ə l 'a ð ə 
inhalades	i n ə l 'a ð ə s	 i n u ə l 'a ð ə s 
inhalant	i n ə l 'a n	 i n u ə l 'a n 
inhalar	i n ə l 'a	 i n u ə l 'a 
inhalat	i n ə l 'a t	 i n u ə l 'a t 
inhalats	i n ə l 'a t s	 i n u ə l 'a t s 
ininterromput	i n i n t ə r u m p 'u t	 i n 'i n t ə r 'o m p 'u t 
innocentment	i n n u s ə m m 'e n	 i n n u s ə n ə m 'e n 
inodor	i n u ð 'o r	 i n u ð 'o 
inquiet	i ŋ k i 'e t	 i ŋ k i 'ɛ t 
insecte	i n s 'e k t ə	 i n s 'ɛ k t ə 
insistentment	i n s i s t ə m m 'e n	 i n s i s t ə n ə m 'e n 
insular	i n s u l 'a r	 i n s u l 'a 
insulinoma	i n s u l i n 'ɔ m ə	 i n s u l i n 'o m ə 
insult	i n s 'u l	 i n s 'u l t 
intens	i n t 'ɛ n s	 i n t 'e n s 
interior	i n t ə ɾ i 'o r	 i n t ə ɾ i 'o 
intermitentment	i n t ə r m i t ə m m 'e n	 i n t ə r m i t ə n ə m 'e n 
intèrpret	i n t 'ɛ r p ɾ ə t	 i n t ə r p ɾ 'ɛ t 
interrompre	i n t ə r 'o m p ɾ ə	 i n t ə r 'ɔ m p ɾ ə 
intransitiu	i n t ɾ ə n z i t 'i w	 i n t ɾ ə n s i t 'i w 
intransitius	i n t ɾ ə n z i t 'i w s	 i n t ɾ ə n s i t 'i w s 
intransitiva	i n t ɾ ə n z i t 'i β ə	 i n t ɾ ə n s i t 'i β ə 
intransitives	i n t ɾ ə n z i t 'i β ə s	 i n t ɾ ə n s i t 'i β ə s 
intrèpid	i n t ɾ 'ɛ p i t	 i n t ɾ 'ɛ p i ð 
invers	i m b 'ɛ r s	 i m b 'e s 
ioga	j 'ɔ ɣ ə	 i 'ɔ ɣ ə 
iogui	j 'ɔ ɣ i	 i 'ɔ ɣ i 
iogurt	j u ɣ 'u r t	 i u ɣ 'u r t 
iònica	j 'ɔ n i k ə	 i 'ɔ n i k ə 
irregular	i r ə ɣ u l 'a r	 i r ə ɣ u l 'a 
irremeiable	i r ə m ə j 'a b b l ə	 i r ə m ə i 'a b b l ə 
isard	i z 'a r	 i z 'a ɾ ə 
Israel	i z r ə 'ɛ l	 i s ə 'ɛ l 
israelià	i z r ə e l i 'a	 i z r ə ə l i 'a 
Ístria	'i s t ɾ i ə	 i s t ɾ 'i ə 
iugoslau	j u ɣ u z l 'a w	 i w ɣ u z l 'a w 
Iugoslàvia	j u ɣ u z l 'a β i ə	 i w ɣ u z l 'a β i ə 
jaguar	ʒ ə ɣ w 'a r	 ʒ ə ɣ w 'a 
jazz	ʒ 'a s	 ʒ 'a z ə 
jersei	ʒ ə r s 'ɛ j	 ʒ ə r s 'ɛ i 
Josep	ʒ u z 'ɛ p	 ʒ u s 'ɛ p 
jou	ʒ 'o w	 ʒ 'o 
jove	ʒ 'o β ə	 ʒ 'ɔ β ə 
jóvens	ʒ 'o β ə n s	 ʒ u β 'e n s 
joves	ʒ 'o β ə s	 ʒ 'ɔ β ə s 
jueu	ʒ u 'e w	 ʒ u 'ɛ w 
juguesca	ʒ u ɣ 'ɛ s k ə	 ʒ u ɣ u 'ɛ s k ə 
júnyer	ʒ 'u ɲ ə	 ʒ u ɲ 'e 
jutgessa	ʒ u d ʒ 'ɛ s ə	 ʒ u d ʒ 'e s ə 
kafkià	k ə f k i 'a	 k ə f i i 'a 
khmer	k m 'e r	 k ə m 'e 
kilocaloria	k i l u k ə l u ɾ 'i ə	 s i l u k ə l u ɾ 'i ə 
kilòmetre	k i l 'ɔ m ə t ɾ ə	 b i l 'ɔ m ə t ɾ ə 
kiwi	k 'i β i	 ə 'i β i 
kuwaitià	k u β ə j t i 'a	 k u β ə i t i 'a 
la	l 'ə	 l ə 
labor	l ə β 'o r	 l ə β 'o 
lacrosse	l ə k ɾ 'o s ə	 l ə k ɾ 'ɔ s ə 
Laos	l 'a u s	 l ə 'ɔ s 
lema	l 'e m ə	 l 'ɛ m ə 
lemes	l 'e m ə s	 l 'ɛ m ə s 
lèmur	l 'ɛ m u	 l 'ɛ m u r 
lepra	l 'e p ɾ ə	 l 'ɛ p ɾ ə 
les	l 'ə s	 l ə s 
li	l 'i	 l i 
líber	l 'i β ə	 l 'i β ə r 
liceu	l i s 'ɛ w	 l i k 'ɛ w 
Liceu	l i s 'ɛ w	 l i k 'ɛ w 
licor	l i k 'o r	 l i k 'o 
limburgués	l i m b u ɾ ɣ 'e s	 l i m b u r k 'e s 
líquid	l 'i k i t	 l 'i k i ð 
lisosoma	l i z u z 'ɔ m ə	 l i z u z 'o m ə 
llagosta	ʎ ə ɣ 'o s t ə	 ʎ ə ɣ 'ɔ s t ə 
llamenc	ʎ ə m 'ɛ ŋ	 ʎ ə m 'ɛ n s 
llar	ʎ 'a r	 ʎ 'a 
llarg	ʎ 'a r k	 ʎ 'a r 
llargs	ʎ 'a r k s	 ʎ 'a r s 
llauna	ʎ 'a w n ə	 ʎ ə 'u n ə 
llebeig	ʎ ə β 'ɛ t ʃ	 ʎ ə β 'ɛ ʃ 
llebre	ʎ 'e β ɾ ə	 ʎ 'ɛ β ɾ ə 
llega	ʎ 'e ɣ ə	 ʎ 'ɛ ɣ ə 
llegenda	ʎ ə ʒ 'e n d ə	 ʎ ə ʒ 'ɛ n d ə 
llegendes	ʎ ə ʒ 'e n d ə s	 ʎ ə ʒ 'ɛ n d ə s 
llegües	ʎ 'e ɣ w ə s	 ʎ 'ɛ ɣ w ə s 
llei	ʎ 'e j	 ʎ 'ɛ i 
Lleida	ʎ 'e j ð ə	 ʎ 'ɛ j ð ə 
lleig	ʎ 'e t ʃ	 ʎ 'ɛ ʃ 
lleis	ʎ 'e j s	 ʎ 'ɛ i s 
lleixa	ʎ 'e ʃ ə	 ʎ 'ɛ ʃ ə 
llença	ʎ 'ɛ n s ə	 ʎ 'e n s ə 
llences	ʎ 'ɛ n s ə s	 ʎ 'e n s ə s 
llenços	ʎ 'e n s u s	 ʎ 'ɛ n s u s 
llenya	ʎ 'e ɲ ə	 ʎ 'ɛ ɲ ə 
llepa	ʎ 'e p ə	 ʎ 'ɛ p ə 
llepen	ʎ 'e p ə n	 ʎ 'ɛ p ə n 
llépol	ʎ 'e p u l	 ʎ ə p 'ɔ l 
llest	ʎ 'e s t	 ʎ 'ɛ s t 
llesta	ʎ 'e s t ə	 ʎ 'ɛ s t ə 
llestes	ʎ 'e s t ə s	 ʎ 'ɛ s t ə s 
llestos	ʎ 'e s t u s	 ʎ 'ɛ s t u s 
llet	ʎ 'e t	 ʎ 'ɛ t 
lletges	ʎ 'e d ʒ ə s	 ʎ 'ɛ d ʒ ə s 
lletja	ʎ 'e d ʒ ə	 ʎ 'ɛ d ʒ ə 
lletjos	ʎ 'e d ʒ u s	 ʎ 'ɛ d ʒ u s 
lleu	ʎ 'e w	 ʎ 'ɛ w 
lleus	ʎ 'e w s	 ʎ 'ɛ w s 
lleva	ʎ 'e β ə	 ʎ 'ɛ β ə 
lleves	ʎ 'e β ə s	 ʎ 'ɛ β ə s 
llevo	ʎ 'e β u	 ʎ 'ɛ β u 
lliurada	ʎ i w ɾ 'a ð ə	 ʎ i u ɾ 'a ð ə 
lliurades	ʎ i w ɾ 'a ð ə s	 ʎ i u ɾ 'a ð ə s 
lliurament	ʎ i w ɾ ə m 'e n	 ʎ i u ɾ ə m 'e n 
lliurar	ʎ i w ɾ 'a	 ʎ i u ɾ 'a 
lloa	ʎ 'o ə	 ʎ 'ɔ ə 
lloba	ʎ 'o β ə	 ʎ 'ɔ β ə 
llobregatenc	ʎ u β ɾ ə ɣ ə t 'ɛ ŋ	 ʎ u β ɾ ə ɣ ə t 'ɛ n s 
lloen	ʎ 'o ə n	 ʎ 'ɔ ə n 
llop	ʎ 'o p	 ʎ 'ɔ p 
Llorach	ʎ u ɾ 'a k	 ʎ u ɾ 'a k ə 
llord	ʎ 'o r t	 ʎ 'o r 
llosa	ʎ 'ɔ z ə	 ʎ 'o z ə 
lloses	ʎ 'ɔ z ə s	 ʎ 'o z ə s 
lluitada	ʎ u j t 'a ð ə	 ʎ u i t 'a ð ə 
lluitades	ʎ u j t 'a ð ə s	 ʎ u i t 'a ð ə s 
lluitant	ʎ u j t 'a n	 ʎ u i t 'a n 
lluitar	ʎ u j t 'a	 ʎ u i t 'a 
lluitat	ʎ u j t 'a t	 ʎ u i t 'a t 
lluitats	ʎ u j t 'a t s	 ʎ u i t 'a t s 
llur	ʎ 'u r	 ʎ 'u 
londinenc	l u n d i n 'ɛ ŋ	 l u n d i n 'ɛ n s 
Londres	l 'o n d ɾ ə s	 l 'ɔ n d ɾ ə s 
lumbar	l u m b 'a r	 l u m b 'a 
lunar	l u n 'a r	 l u n 'a 
Luxemburg	l u k s ə m b 'u r k	 l u k s ə m b 'u r 
ma	m 'ə	 m ə 
macedoni	m ə s ə ð 'ɔ n i	 m ə s ə ð 'o n i 
Madrid	m ə ð ɾ 'i t	 m ə ð ɾ 'i ð 
magenc	m ə ʒ 'ɛ ŋ	 m ə ʒ 'ɛ n s 
Mahoma	m ə 'ɔ m ə	 m ə u m ə 
maig	m 'a t ʃ	 m 'a ʃ 
mainada	m ə j n 'a ð ə	 m ə i n 'a ð ə 
malaisi	m ə l 'a j z i	 m ə l ə 'i z i 
Malàisia	m ə l 'a j z i ə	 m ə l 'a i z i ə 
maldestre	m ə l d 'e s t ɾ ə	 m ə l d 'ɛ s t ɾ ə 
malicioses	m ə l i s i 'o z ə s	 m ə l i s i 'o s ə s 
malifeta	m ə l i f 'e t ə	 m ə l i f 'ɛ t ə 
malnom	m ə l n 'ɔ m	 m ə l n 'o m 
malson	m ə l s 'ɔ n	 m ə l s 'o n 
malur	m ə l 'u r	 m ə l 'u 
malvolença	m ə l β u l 'ɛ n s ə	 m ə l β u l 'e n s ə 
mànager	m 'a n ə ʒ ə r	 m ə n ə ʒ 'e 
manc	m 'a ŋ	 m 'a n s 
maneig	m ə n 'ɛ t ʃ	 m ə n 'ɛ ʃ 
manifest	m ə n i f 'e s t	 m ə n i f 'ɛ s t 
manifesti	m ə n i f 'e s t i	 m ə n i f 'ɛ s t i 
marcenc	m ə r s 'ɛ ŋ	 m ə r s 'ɛ n s 
mareig	m ə ɾ 'ɛ t ʃ	 m ə ɾ 'ɛ ʃ 
maresmenc	m ə ɾ ə z m 'ɛ ŋ	 m ə ɾ ə z m 'ɛ n s 
màrqueting	m 'a r k ə t i ŋ	 m ə r k ə t 'i ŋ 
martinenc	m ə r t i n 'ɛ ŋ	 m ə r t i n 'ɛ n s 
màrtir	m 'a r t i r	 m 'a r t i 
màser	m 'a z ə	 m 'a z ə r 
mastodont	m ə s t u ð 'ɔ n	 m ə s t u ð 'o n 
matallops	m ə t ə ʎ 'o p s	 m ə t ə ʎ 'ɔ p s 
matriu	m ə t ɾ 'i w	 m ə t ɾ 'i u 
me	m 'ə	 m ə 
meitat	m ə j t 'a t	 m ə i t 'a t 
melillenc	m ə l i ʎ 'ɛ ŋ	 m ə l i ʎ 'ɛ n s 
membre	m 'e m b ɾ ə	 m 'ɛ m b ɾ ə 
membres	m 'e m b ɾ ə s	 m 'ɛ m b ɾ ə s 
mencionis	m ə n s i 'ɔ n i s	 m ə n s i 'o n i s 
mengen	m 'e n ʒ ə n	 m 'ɛ n ʒ ə n 
menges	m 'e n ʒ ə s	 m 'ɛ n ʒ ə s 
mengi	m 'e n ʒ i	 m 'ɛ n ʒ i 
mengin	m 'e n ʒ i n	 m 'ɛ n ʒ i n 
menja	m 'e n ʒ ə	 m 'ɛ n ʒ ə 
menjo	m 'e n ʒ u	 m 'ɛ n ʒ u 
menor	m ə n 'o r	 m ə n 'o 
menstrus	m 'ɛ n s t ɾ u s	 m ə n s t ɾ 'u s 
mentre	m 'e n t ɾ ə	 m 'ɛ n t ɾ ə 
menyspreada	m ə ɲ s p ɾ e 'a ð ə	 m ə ɲ s p ə ə 'a ð ə 
menyspreades	m ə ɲ s p ɾ e 'a ð ə s	 m ə ɲ s p ə ə 'a ð ə s 
menyspreat	m ə ɲ s p ɾ e 'a t	 m ə ɲ s p ɾ ə 'a t 
menyspreats	m ə ɲ s p ɾ e 'a t s	 m ə ɲ s p ɾ ə 'a t s 
mer	m 'e r	 m 'e 
meréixer	m ə ɾ 'e ʃ ə	 m ə ɾ ə ʃ 'e 
meretriu	m ə ɾ ə t ɾ 'i w	 m ə ɾ ə t ɾ 'i u 
mero	m 'e ɾ u	 m 'ɛ ɾ u 
mes	m 'e s	 m 'ɛ s 
mesos	m 'e z u s	 m 'ɛ z u s 
mestressa	m ə s t ɾ 'ɛ s ə	 m ə s t ɾ 'e s ə 
metge	m 'e d ʒ ə	 m 'ɛ d ʒ ə 
metges	m 'e d ʒ ə s	 m 'ɛ d ʒ ə s 
metgessa	m ə d ʒ 'ɛ s ə	 m ə d ʒ 'e s ə 
metxa	m 'e t ʃ ə	 m 'ɛ t ʃ ə 
meu	m 'e w	 m 'ɛ w 
meus	m 'e w s	 m 'ɛ w s 
meva	m 'e β ə	 m 'ɛ β ə 
meves	m 'e β ə s	 m 'ɛ β ə s 
mig	m 'i t ʃ	 m 'i ə 
miliard	m i l i 'a r	 m i l i 'a r ə 
militar	m i l i t 'a r	 m i l i t 'a 
Mireia	m i ɾ 'ɛ j ə	 m i ɾ ə 'i ə 
misàndria	m i z 'a n d ɾ i ə	 m i z ə n d ɾ 'i ə 
mistralenc	m i s t ɾ ə l 'ɛ ŋ	 m i s t ɾ ə l 'ɛ n s 
mitjancer	m i d ʒ ə n s 'e	 m i d ʒ ə ŋ 'e 
mocs	m 'o k s	 m 'ɔ k s 
modest	m u ð 'e s t	 m u ð 'ɛ s t 
moher	m u 'ɛ r	 m u 'e 
Moisès	m u j z 'ɛ s	 m u i s 'ɛ s 
molecular	m u l ə k u l 'a r	 m u l ə k u l 'a 
moll	m 'ɔ ʎ	 m 'o ʎ 
molsa	m 'o l s ə	 m 'ɔ l s ə 
molta	m 'o l t ə	 m 'ɔ l t ə 
moltes	m 'o l t ə s	 m 'ɔ l t ə s 
Mon	m 'u n	 m 'o n 
monàrquica	m u n 'a r k i k ə	 m u n ə r k 'i k ə 
monàrquics	m u n 'a r k i k s	 m u n ə r k 'i k s 
monocroma	m u n u k ɾ 'ɔ m ə	 m u n u k ɾ 'o m ə 
monocromes	m u n u k ɾ 'ɔ m ə s	 m u n u k ɾ 'o m ə s 
monologuista	m u n u l u ɣ 'i s t ə	 m u n u l u ɣ u 'i s t ə 
Montblanc	m u m b l 'a ŋ	 m u n ə l 'a ŋ 
Montcada	m u ŋ k 'a ð ə	 m u n ə k 'a ð ə 
montsianenc	m u n s i ə n 'ɛ ŋ	 m u n s i ə n 'ɛ n s 
mora	m 'ɔ ɾ ə	 m 'o ɾ ə 
mores	m 'ɔ ɾ ə s	 m 'o ɾ ə s 
morro	m 'o r u	 m 'ɔ r u 
morros	m 'o r u s	 m 'ɔ r u s 
mort	m 'ɔ r t	 m 'o r t 
mosaic	m u z 'a j k	 m u z 'a i k 
mosca	m 'o s k ə	 m 'ɔ s k ə 
moscard	m u s k 'a r	 m u s k 'a r t 
mosques	m 'o s k ə s	 m 'ɔ s k ə s 
mossa	m 'o s ə	 m 'ɔ s ə 
mossegaire	m u s ə ɣ 'a j ɾ ə	 m u s ə ɣ ə 'i ɾ ə 
mosso	m 'o s u	 m 'ɔ s u 
mossos	m 'o s u s	 m 'ɔ s u s 
mot	m 'o t	 m 'ɔ t 
moto	m 'o t u	 m 'ɔ t u 
motor	m u t 'o r	 m u t 'o 
motors	m u t 'o r s	 m u t 'o s 
motos	m 'o t u s	 m 'ɔ t u s 
motriu	m u t ɾ 'i w	 m u t ɾ 'i u 
mou	m 'ɔ w	 m 'o w 
mous	m 'ɔ w s	 m 'o w s 
mudèjar	m u ð 'ɛ ʒ ə	 m u ð ə ʒ 'a 
muhàrram	m u 'a r ə m	 m u i 'a r ə m 
multivers	m u l t i β 'ɛ r s	 m u l t i β 'e s 
muntanyenc	m u n t ə ɲ 'ɛ ŋ	 m u n t ə ɲ 'ɛ n s 
muscular	m u s k u l 'a r	 m u s k u l 'a 
nadalenc	n ə ð ə l 'ɛ ŋ	 n ə ð ə l 'ɛ n s 
naixença	n ə ʃ 'ɛ n s ə	 n ə ʃ 'e n s ə 
nàufrag	n 'a w f ɾ ə k	 n ə w f ɾ 'a ɣ 
nàusea	n 'a w z e ə	 n 'a w z ə ə 
nauseabund	n ə w z e ə β 'u n	 n ə w z e ə β 'u n d 
nauseabunds	n ə w z e ə β 'u n s	 n ə w z e ə β 'u n d s 
neboda	n ə β 'o ð ə	 n ə β 'ɔ ð ə 
nebot	n ə β 'o t	 n ə β 'ɔ t 
neda	n 'e ð ə	 n 'ɛ ð ə 
neden	n 'e ð ə n	 n 'ɛ ð ə n 
nedes	n 'e ð ə s	 n 'ɛ ð ə s 
nefand	n ə f 'a n	 n ə f 'a n ə 
nega	n 'e ɣ ə	 n 'ɛ ɣ ə 
negrenc	n ə ɣ ɾ 'ɛ ŋ	 n ə ɣ ɾ 'ɛ n s 
neguen	n 'e ɣ ə n	 n 'ɛ ɣ ə n 
negues	n 'e ɣ ə s	 n 'ɛ ɣ ə s 
negui	n 'e ɣ i	 n 'ɛ ɣ i 
neguin	n 'e ɣ i n	 n 'ɛ ɣ i n 
néixer	n 'e ʃ ə	 n ə ʃ 'e 
nens	n 'ɛ n s	 n 'e n s 
neu	n 'e w	 n 'ɛ w 
neulir	n ə w l 'i	 n ə u l 'i 
neulós	n ə w l 'o s	 n ə u l 'o s 
neus	n 'e w s	 n 'ɛ w s 
neva	n 'e β ə	 n 'ɛ β ə 
nicaragüenc	n i k ə ɾ ə ɣ w 'ɛ ŋ	 n i k ə ɾ ə ɣ w 'ɛ n s 
nicens	n i s 'ɛ n s	 n i k 'e n s 
nihilisme	n i i l 'i z m ə	 n i ə l 'i z m ə 
nihoni	n i 'ɔ n i	 n i u n i 
noblesa	n u b b l 'ɛ z ə	 n u β l 'ɛ z ə 
noguerenc	n u ɣ ə ɾ 'ɛ ŋ	 n u ɣ ə ɾ 'ɛ n s 
noi	n 'ɔ j	 n 'o i 
nois	n 'ɔ j s	 n 'o i s 
nom	n 'ɔ m	 n 'o m 
noms	n 'ɔ m s	 n 'o m s 
nora	n 'ɔ ɾ ə	 n 'o ɾ ə 
nord	n 'ɔ r t	 n 'o r 
nores	n 'ɔ ɾ ə s	 n 'o ɾ ə s 
normand	n u r m 'a n	 n u r m 'a n ə 
nosa	n 'ɔ z ə	 n 'o z ə 
noses	n 'ɔ z ə s	 n 'o z ə s 
nou	n 'ɔ w	 n 'o w 
nous	n 'ɔ w s	 n 'o s 
novembre	n u β 'e m b ɾ ə	 n u β 'ɛ m b ɾ ə 
noyes	n 'ɔ j ə s	 n 'ɔ ə s 
nuclear	n u k l e 'a r	 n u k l e 'a 
o	'ɔ	 'o 
objecte	u b ʒ 'e k t ə	 u b ʒ 'ɛ k t ə 
obliqüitat	u β l i k w i t 'a t	 u β l i k i t 'a t 
oblit	u β l 'i t	 u p l 'i t 
oblong	u b b l 'o ŋ	 u p l 'o ŋ 
obrellaunes	u β ɾ ə ʎ 'a w n ə s	 u β ɾ ə ʎ ə 'u n ə s 
obscè	u p s 'ɛ	 u p s k 'ɛ 
obscens	u p s 'ɛ n s	 u p s k 'e n s 
obscur	u p s k 'u r	 u p s k 'u 
obtús	u p t 'u s	 ɔ β t 'u s 
Oceania	u s e ə n 'i ə	 u s ə ə n 'i ə 
ocórrer	u k 'o r ə	 u k u r 'e 
octubre	u k t 'u β ɾ ə	 ɔ k t 'u β ɾ ə 
ocular	u k u l 'a r	 u k u l 'a 
Odessa	u ð 'ɛ s ə	 u ð 'e s ə 
oest	u 'e s t	 u 'ɛ s t 
oi	'ɔ j	 'o i 
oligàrquica	u l i ɣ 'a r k i k ə	 u l i ɣ ə r k 'i k ə 
oligàrquics	u l i ɣ 'a r k i k s	 u l i ɣ ə r k 'i k s 
Olimp	u l 'i m	 u l 'i m p 
ombra	'o m b ɾ ə	 'ɔ m b ɾ ə 
ombreig	u m b ɾ 'ɛ t ʃ	 u m b ɾ 'ɛ ʃ 
ombres	'o m b ɾ ə s	 'ɔ m b ɾ ə s 
òmicron	'ɔ m i k ɾ u n	 ɔ m i k ɾ 'o n 
omple	'o m p l ə	 'ɔ m p l ə 
omplen	'o m p l ə n	 'ɔ m p l ə n 
omples	'o m p l ə s	 'ɔ m p l ə s 
omplo	'o m p l u	 'ɔ m p l u 
oncle	'o ŋ k l ə	 'ɔ ŋ k l ə 
oncles	'o ŋ k l ə s	 'ɔ ŋ k l ə s 
onomatopeic	u n u m ə t u p 'ɛ j k	 u n u m ə t u p 'ɛ i k 
onzes	'o n z ə s	 'ɔ n z ə s 
opta	'o p t ə	 'ɔ p t ə 
opten	'o p t ə n	 'ɔ p t ə n 
opto	'o p t u	 'ɔ p t u 
or	'ɔ r	 'o 
orca	'o r k ə	 'ɔ r k ə 
orella	u ɾ 'ɛ ʎ ə	 u ɾ 'e ʎ ə 
ores	'ɔ ɾ ə s	 'o ɾ ə s 
ormeig	u r m 'ɛ t ʃ	 u r m 'ɛ ʃ 
ornament	u r n ə m 'e n	 ɔ r n ə m 'e n 
ornitorrinc	u r n i t u r 'i ŋ	 u r n i t u r 'i ŋ k 
orques	'o r k ə s	 'ɔ r k ə s 
orquestra	u r k 'e s t ɾ ə	 u r k 'ɛ s t ɾ ə 
ortodox	u r t u ð 'ɔ k s	 u r t u ð 'o 
ortodoxa	u r t u ð 'o k s ə	 u r t u ð 'ɔ k s ə 
os	'ɔ s	 'o s 
Òscar	'ɔ s k ə r	 ɔ s k 'a 
osonenc	u z u n 'ɛ ŋ	 u z u n 'ɛ n s 
òstria	'ɔ s t ɾ i ə	 ɔ s t ɾ 'i ə 
ou	'ɔ w	 'o 
ous	'ɔ w s	 o 'u s 
ovella	u β 'ɛ ʎ ə	 u β 'e ʎ ə 
ovelles	u β 'ɛ ʎ ə s	 u β 'e ʎ ə s 
pacientment	p ə s i ə m m 'e n	 p ə s i ə n ə m 'e n 
pairal	p ə j ɾ 'a l	 p ə i ɾ 'a l 
paisatge	p ə j z 'a d ʒ ə	 p ə i z 'a d ʒ ə 
pakistanès	p ə k i s t ə n 'ɛ s	 p ə z i s t ə n 'ɛ s 
pakistanesa	p ə k i s t ə n 'ɛ z ə	 p ə z i s t ə n 'ɛ z ə 
pakistaneses	p ə k i s t ə n 'ɛ z ə s	 p ə z i s t ə n 'ɛ z ə s 
pakistanesos	p ə k i s t ə n 'ɛ z u s	 p ə z i s t ə n 'ɛ z u s 
palenc	p ə l 'ɛ ŋ	 p ə l 'ɛ n s 
palestinenc	p ə l ə s t i n 'ɛ ŋ	 p ə l ə s t i n 'ɛ n s 
Pallars	p ə ʎ 'a s	 p ə ʎ 'a r s 
pandemoni	p ə n d ə m 'ɔ n i	 p ə n d ə m 'o n i 
panteix	p ə n t 'ɛ ʃ	 p ə n t 'e ʃ 
panteixar	p ə n t ə ʃ 'a	 p ə n t ə i k s 'a 
papagai	p ə p ə ɣ 'a j	 p ə p ə ɣ 'a i 
Paraguai	p ə ɾ ə ɣ w 'a j	 p ə ɾ ə ɣ w 'a i 
paraguaià	p ə ɾ ə ɣ w ə j 'a	 p ə ɾ ə ɣ u ə j 'a 
paraguaiana	p ə ɾ ə ɣ w ə j 'a n ə	 p ə ɾ ə ɣ u ə j 'a n ə 
paraigua	p ə ɾ 'a j ɣ w ə	 p ə ɾ 'a i ɣ w ə 
paraigües	p ə ɾ 'a j ɣ w ə s	 p ə ɾ 'a i ɣ w ə s 
parallamps	p ə ɾ ə ʎ 'a m s	 p ə ɾ ə ʎ 'a m p s 
paranoic	p ə ɾ ə n 'ɔ j k	 p ə ɾ ə n u 'i k 
paréixer	p ə ɾ 'e ʃ ə	 p ə ɾ ə ʃ 'e 
parell	p ə ɾ 'ɛ ʎ	 p ə ɾ 'e ʎ 
parella	p ə ɾ 'ɛ ʎ ə	 p ə ɾ 'e ʎ ə 
parença	p ə ɾ 'ɛ n s ə	 p ə ɾ 'e n s ə 
parènquima	p ə ɾ 'ɛ ŋ k i m ə	 p ə ɾ ə ŋ k 'i m ə 
parer	p ə ɾ 'ɛ	 p ə ɾ 'e 
parisenc	p ə ɾ i z 'ɛ ŋ	 p ə ɾ i z 'ɛ n s 
parlessin	p ə r l 'e s i n	 p ə r l 'ɛ s i n 
parpelleig	p ə r p ə ʎ 'ɛ t ʃ	 p ə r p ə ʎ 'ɛ ʃ 
pàrquing	p 'a r k i ŋ	 p ə r k 'i ŋ 
particular	p ə r t i k u l 'a r	 p ə r t i k u l 'a 
pasqüeta	p ə s k w 'ɛ t ə	 p ə z ə w 'ɛ t ə 
passaport	p ə s ə p 'ɔ r t	 p ə s ə p 'o r t 
passaports	p ə s ə p 'ɔ r s	 p ə s ə p 'o r t s 
passatemps	p ə s ə t 'e m s	 p ə s ə t 'ɛ m p s 
passeig	p ə s 'ɛ t ʃ	 p ə s 'ɛ ʃ 
patrimoni	p ə t ɾ i m 'ɔ n i	 p ə t ɾ i m 'o n i 
pecíols	p ə s 'i u l s	 p ə s i 'ɔ l s 
peculiar	p ə k u l i 'a r	 p ə k u l i 'a 
pedra	p 'e ð ɾ ə	 p 'ɛ ð ɾ ə 
pedres	p 'e ð ɾ ə s	 p 'ɛ ð ɾ ə s 
pega	p 'e ɣ ə	 p 'ɛ ɣ ə 
pego	p 'e ɣ u	 p 'ɛ ɣ u 
peguen	p 'e ɣ ə n	 p 'ɛ ɣ ə n 
pegues	p 'e ɣ ə s	 p 'ɛ ɣ ə s 
peixenc	p ə ʃ 'ɛ ŋ	 p ə ʃ 'ɛ ŋ k 
péixer	p 'e ʃ ə	 p ə ʃ 'e 
peixos	p 'e ʃ u s	 p 'ɛ ʃ u s 
pendeloc	p ə n d ə l 'o k	 p ə n d ə l 'ɔ k 
penedesenc	p ə n ə ð ə z 'ɛ ŋ	 p ə n ə ð ə z 'ɛ n s 
penetra	p ə n 'e t ɾ ə	 p ə n 'ɛ t ɾ ə 
pengen	p 'e n ʒ ə n	 p 'ɛ n ʒ ə n 
penges	p 'e n ʒ ə s	 p 'ɛ n ʒ ə s 
pengi	p 'e n ʒ i	 p 'ɛ n ʒ i 
pengin	p 'e n ʒ i n	 p 'ɛ n ʒ i n 
peninsular	p ə n i n s u l 'a r	 p ə n i n s u l 'a 
penja	p 'e n ʒ ə	 p 'ɛ n ʒ ə 
penjo	p 'e n ʒ u	 p 'ɛ n ʒ u 
penombra	p ə n 'o m b ɾ ə	 p ə n 'ɔ m b ɾ ə 
pens	p 'ɛ n s	 p 'e n s 
per	p 'ə r	 p 'e 
pera	p 'ɛ ɾ ə	 p 'e ɾ ə 
Pere	p 'e ɾ ə	 p 'ɛ ɾ ə 
perfecta	p ə r f 'e k t ə	 p ə r f 'ɛ k t ə 
perfecte	p ə r f 'e k t ə	 p ə r f 'ɛ k t ə 
perfectes	p ə r f 'e k t ə s	 p ə r f 'ɛ k t ə s 
perfet	p ə r f 'e t	 p ə r f 'ɛ t 
permanentment	p ə r m ə n ə m m 'e n	 p ə r m ə n ə n ə m 'e n 
perpendicular	p ə r p ə n d i k u l 'a r	 p ə r p ə n d i k u l 'a 
persuasiu	p ə r s u ə z 'i w	 p ə r s u ə s 'i w 
pertinença	p ə r t i n 'ɛ n s ə	 p ə r t i n 'e n s ə 
pesa	p 'e z ə	 p 'ɛ z ə 
pesen	p 'e z ə n	 p 'ɛ z ə n 
peses	p 'e z ə s	 p 'ɛ z ə s 
pesi	p 'e z i	 p 'ɛ z i 
peso	p 'e z u	 p 'ɛ z u 
pessebre	p ə s 'e β ɾ ə	 p ə s 'ɛ β ɾ ə 
pesta	p 'e s t ə	 p 'ɛ s t ə 
petges	p 'e d ʒ ə s	 p 'ɛ d ʒ ə s 
petja	p 'e d ʒ ə	 p 'ɛ d ʒ ə 
pirateig	p i ɾ ə t 'ɛ t ʃ	 p i ɾ ə t 'ɛ ʃ 
pirenenc	p i ɾ ə n 'ɛ ŋ	 p i ɾ ə n 'ɛ n s 
pirinenc	p i ɾ i n 'ɛ ŋ	 p i ɾ i n 'ɛ n s 
piscina	p i s 'i n ə	 p i s k 'i n ə 
Pitiüses	p i t i 'u z ə s	 p i t i 'u s ə s 
piulada	p i w l 'a ð ə	 p i u l 'a ð ə 
piular	p i w l 'a	 p i u l 'a 
placenta	p l ə s 'e n t ə	 p l ə k 'e n t ə 
plaer	p l ə 'ɛ	 p l ə 'e 
plàncton	p l 'a ŋ k t o n	 p l ə ŋ k t 'o n 
plataforma	p l ə t ə f 'o r m ə	 p l ə t ə f 'ɔ r m ə 
plens	p l 'ɛ n s	 p l 'e n s 
plomo	p l 'o m u	 p l 'ɔ m u 
plor	p l 'ɔ	 p l 'o 
plora	p l 'ɔ ɾ ə	 p l 'o ɾ ə 
plores	p l 'ɔ ɾ ə s	 p l 'o ɾ ə s 
plou	p l 'ɔ w	 p l 'o 
plovisqueig	p l u β i s k 'ɛ t ʃ	 p l u β i s k 'ɛ ʃ 
plutoni	p l u t 'ɔ n i	 p l u t 'o n i 
poblen	p 'o b b l ə n	 p 'ɔ b b l ə n 
poder	p u ð 'ɛ	 p u ð 'e 
podi	p 'o ð i	 p 'ɔ ð i 
podis	p 'o ð i s	 p 'ɔ ð i s 
poesia	p u ə z 'i ə	 p u ə s 'i ə 
poetessa	p u ə t 'ɛ s ə	 p u ə t 'e s ə 
polar	p u l 'a r	 p u l 'a 
polla	p 'o ʎ ə	 p 'ɔ ʎ ə 
poloni	p u l 'ɔ n i	 p u l 'o n i 
polpa	p 'o l p ə	 p 'ɔ l p ə 
pols	p 'o l s	 p 'ɔ l s 
poltre	p 'o l t ɾ ə	 p 'ɔ l t ɾ ə 
polze	p 'o l z ə	 p 'ɔ l z ə 
pon	p 'ɔ n	 p 'o n 
pons	p 'ɔ n s	 p 'o n s 
pont	p 'ɔ n	 p 'o n 
Pont	p 'ɔ n	 p 'o n 
pop	p 'o p	 p 'ɔ p 
popa	p 'o p ə	 p 'ɔ p ə 
popular	p u p u l 'a r	 p u p u l 'a 
porc	p 'ɔ r k	 p 'o r k 
porpra	p 'o r p ɾ ə	 p 'ɔ r p ɾ ə 
porro	p 'o r u	 p 'ɔ r u 
porros	p 'o r u s	 p 'ɔ r u s 
port	p 'ɔ r t	 p 'o r t 
portuenc	p u r t u 'ɛ ŋ	 p u r t u 'ɛ n s 
portuguesa	p u r t u ɣ 'ɛ z ə	 p u r t u ɣ u 'ɛ z ə 
portugueses	p u r t u ɣ 'ɛ z ə s	 p u r t u ɣ u 'ɛ z ə s 
portuguesos	p u r t u ɣ 'ɛ z u s	 p u r t u ɣ u 'ɛ z u s 
porus	p 'o ɾ u s	 p 'ɔ ɾ u s 
posa	p 'ɔ z ə	 p 'o z ə 
poses	p 'ɔ z ə s	 p 'o z ə s 
post	p 'ɔ s t	 p 'o s t 
posterior	p u s t ə ɾ i 'o r	 p u s t ə ɾ i 'o 
posttraumàtica	p u s t ɾ ə w m 'a t i k ə	 p u s t t ɾ ə w m 'a t i k ə 
posttraumàtics	p u s t ɾ ə w m 'a t i k s	 p u s t t ɾ ə w m 'a t i k s 
posttraumàtiques	p u s t ɾ ə w m 'a t i k ə s	 p u s t t ɾ ə w m 'a t i k ə s 
pous	p 'o w s	 p u 'u s 
pradenc	p ɾ ə ð 'ɛ ŋ	 p ɾ ə ð 'ɛ n s 
prec	p ɾ 'e k	 p ɾ 'ɛ k 
precepte	p ɾ ə s 'e p t ə	 p ɾ ə s 'ɛ p t ə 
precoç	p ɾ ə k 'ɔ s	 p ɾ ə k 'o s 
precs	p ɾ 'e k s	 p ɾ 'ɛ k s 
predominantment	p ɾ ə ð u m i n ə m m 'e n	 p ɾ ə ð u m i n ə n ə m 'e n 
prefecte	p ɾ ə f 'e k t ə	 p ɾ ə f 'ɛ k t ə 
preferentment	p ɾ ə f ə ɾ ə m m 'e n	 p ɾ ə f ə ɾ ə n ə m 'e n 
preferiu	p ɾ ə f ə ɾ 'i w	 p ɾ ə f ə ɾ 'i u 
prega	p ɾ 'e ɣ ə	 p ɾ 'ɛ ɣ ə 
prego	p ɾ 'e ɣ u	 p ɾ 'ɛ ɣ u 
prematur	p ɾ ə m ə t 'u r	 p ɾ ə m ə t 'u 
prémer	p ɾ 'e m ə	 p ɾ ə m 'e 
premsa	p ɾ 'e m s ə	 p ɾ 'ɛ m s ə 
prendran	p ə n d ɾ 'a n	 p ɾ ə n d ɾ 'a n 
prens	p ɾ 'ɛ n s	 p ɾ 'e n s 
preqüela	p ɾ ə k w 'ɛ l ə	 p ɾ ə k 'ɛ l ə 
pressupost	p ɾ ə s u p 'ɔ s t	 p ɾ ə s u p 'o s t 
presta	p ɾ 'e s t ə	 p ɾ 'ɛ s t ə 
presten	p ɾ 'e s t ə n	 p ɾ 'ɛ s t ə n 
prestes	p ɾ 'e s t ə s	 p ɾ 'ɛ s t ə s 
presti	p ɾ 'e s t i	 p ɾ 'ɛ s t i 
prestin	p ɾ 'e s t i n	 p ɾ 'ɛ s t i n 
presto	p ɾ 'e s t u	 p ɾ 'ɛ s t u 
presumpció	p ɾ ə z u m s i 'o	 p ɾ ə z u m p s i 'o 
presumpte	p ɾ ə z 'u m t ə	 p ɾ ə z 'u m p t ə 
presumptiu	p ɾ ə z u m t 'i w	 p ɾ ə z u m ə t 'i w 
pretendre	p ɾ ə t 'e n d ɾ ə	 p ɾ ə t 'ɛ n d ɾ ə 
prevaler	p ɾ ə β ə l 'ɛ	 p ɾ ə β ə l 'e 
primerenc	p ɾ i m ə ɾ 'ɛ ŋ	 p ɾ i m ə ɾ 'ɛ n s 
prínceps	p ɾ 'i n s ə p s	 p ɾ i n s 'ɛ p s 
prior	p ɾ i 'o r	 p ɾ i 'o 
pro	p ɾ 'ɔ	 p ɾ 'o 
proa	p ɾ 'o ə	 p ɾ 'ɔ ə 
profund	p ɾ u f 'u n	 p ɾ u f 'u n d 
prohom	p ɾ u 'o m	 p ɾ u 'a m 
projecte	p ɾ u ʒ 'e k t ə	 p ɾ u ʒ 'ɛ k t ə 
prona	p ɾ 'ɔ n ə	 p ɾ 'o n ə 
prones	p ɾ 'ɔ n ə s	 p ɾ 'o n ə s 
pronom	p ɾ u n 'ɔ m	 p ɾ u n 'o m 
prosa	p ɾ 'ɔ z ə	 p ɾ 'o z ə 
proteic	p ɾ u t 'ɛ j k	 p ɾ u t 'ɛ i k 
protesta	p ɾ u t 'e s t ə	 p ɾ u t 'ɛ s t ə 
prou	p ɾ 'ɔ w	 p ɾ 'o 
Provença	p ɾ u β 'ɛ n s ə	 p ɾ u β 'e n s ə 
prudentment	p ɾ u ð ə m m 'e n	 p ɾ u ð ə n ə m 'e n 
puig	p 'u t ʃ	 p 'u ʃ 
Puig	p 'u t ʃ	 p 'u ʃ 
pulmonar	p u l m u n 'a r	 p u l m u n 'a 
púlsar	p 'u l s ə	 p u l s 'a 
punk	p 'u ŋ k	 p 'u n 
queixa	k 'e ʃ ə	 k 'ɛ ʃ ə 
quelcom	k ə l k 'ɔ m	 k ə l k 'o m 
quer	k 'ɛ r	 k 'e 
quid	k 'i t	 k 'i ð 
quiet	k i 'e t	 k i 'ɛ t 
quilowatt	k i l u β 'a t	 k i l u β 'a t t 
rabeig	r ə β 'ɛ t ʃ	 r ə β 'ɛ ʃ 
radar	r ə ð 'a r	 r ə ð 'a 
rai	r 'a j	 r 'a i 
raig	r 'a t ʃ	 r ə 'i ə 
raigràs	r ə j ɣ ɾ 'a s	 r ə i ɣ ɾ 'a s 
rar	r 'a r	 r 'a 
rastreig	r ə s t ɾ 'ɛ t ʃ	 r ə s t ɾ 'ɛ ʃ 
Raül	r ə 'u l	 r 'a ʎ 
re	r 'ɛ	 r ə 
rebost	r ə β 'ɔ s t	 r ə β 'o s t 
rebot	r ə β 'o t	 r ə β 'ɔ t 
rebrot	r ə β ɾ 'o t	 r ə β ɾ 'ɔ t 
rebuig	r ə β 'u t ʃ	 r ə β 'u ʃ 
rec	r 'e k	 r 'ɛ k 
reca	r 'e k ə	 r 'ɛ k ə 
recent	r ə s 'e n	 r ə k 'e n 
recentment	r ə s ə m m 'e n	 r ə k ə n ə m 'e n 
recepta	r ə s 'e p t ə	 r ə s 'ɛ p t ə 
recer	r ə s 'e	 r ə k 'e 
recomptar	r ə k u m t 'a	 r ə k u m p t 'a 
recomptat	r ə k u m t 'a t	 r ə k u m p t 'a t 
recomptats	r ə k u m t 'a t s	 r ə k u m p t 'a t s 
recompte	r ə k 'o m t ə	 r ə k 'ɔ m p t ə 
record	r ə k 'ɔ r t	 r ə k 'o r t 
recorre	r ə k 'o r ə	 r ə k 'ɔ r ə 
recórrer	r ə k 'o r ə	 r ə k u r 'e 
redempció	r ə ð ə m s i 'o	 r ə ð ə m p s i 'o 
reeixida	r ə ə ʃ 'i ð ə	 r e ə ʃ 'i ð ə 
reeixides	r ə ə ʃ 'i ð ə s	 r e ə ʃ 'i ð ə s 
reeixir	r ə ə ʃ 'i	 r e ə ʃ 'i 
reeixit	r ə ə ʃ 'i t	 r e ə ʃ 'i t 
reeixits	r ə ə ʃ 'i t s	 r e ə ʃ 'i t s 
reemplaçament	r e ə m p l ə s ə m 'e n	 r ə ə m p l ə s ə m 'e n 
refet	r ə f 'e t	 r ə f 'ɛ t 
refeta	r ə f 'e t ə	 r ə f 'ɛ t ə 
reforç	r ə f 'ɔ r s	 r ə f 'o r s 
reforma	r ə f 'o r m ə	 r ə f 'ɔ r m ə 
reg	r 'ɛ k	 r 'ɛ g 
rega	r 'e ɣ ə	 r 'ɛ ɣ ə 
regateig	r ə ɣ ə t 'ɛ t ʃ	 r ə ɣ ə t 'ɛ ʃ 
rei	r 'e j	 r 'ɛ i 
reialme	r ə j 'a l m ə	 r ə i 'a l m ə 
reiet	r ə j 'ɛ t	 r ə i 'ɛ t 
reietó	r ə j ə t 'o	 r ə i ə t 'o 
reig	r 'e t ʃ	 r 'ɛ ʃ 
reina	r 'e j n ə	 r 'ɛ j n ə 
reis	r 'e j s	 r 'ɛ i s 
reiteració	r ə i t ə ɾ ə s i 'o	 r ə j t ə ɾ ə s i 'o 
reiterada	r ə i t ə ɾ 'a ð ə	 r ə j t ə ɾ 'a ð ə 
reiterades	r ə i t ə ɾ 'a ð ə s	 r ə j t ə ɾ 'a ð ə s 
reiterar	r ə i t ə ɾ 'a	 r ə j t ə ɾ 'a 
reiterat	r ə i t ə ɾ 'a t	 r ə j t ə ɾ 'a t 
reiterats	r ə i t ə ɾ 'a t s	 r ə j t ə ɾ 'a t s 
reixa	r 'e ʃ ə	 r 'ɛ ʃ ə 
reïxo	r ə 'i ʃ u	 r ə 'i k s u 
rella	r 'ɛ ʎ ə	 r 'e ʎ ə 
relleix	r ə ʎ 'ɛ ʃ	 r ə ʎ 'e ʃ 
relles	r 'ɛ ʎ ə s	 r 'e ʎ ə s 
relleu	r ə ʎ 'e w	 r ə ʎ 'ɛ w 
remei	r ə m 'ɛ j	 r ə m 'ɛ i 
remeis	r ə m 'ɛ j s	 r ə m 'ɛ i s 
Renaixença	r ə n ə ʃ 'ɛ n s ə	 r ə n ə ʃ 'e n s ə 
renda	r 'e n d ə	 r 'ɛ n d ə 
rendes	r 'e n d ə s	 r 'ɛ n d ə s 
renebot	r ə n ə β 'o t	 r ə n ə β 'ɔ t 
renec	r ə n 'e k	 r ə n 'ɛ k 
renom	r ə n 'ɔ m	 r ə n 'o m 
renou	r ə n 'ɔ w	 r ə n 'o 
renten	r 'e n t ə n	 r 'ɛ n t ə n 
renti	r 'e n t i	 r 'ɛ n t i 
rentin	r 'e n t i n	 r 'ɛ n t i n 
repta	r 'e p t ə	 r 'ɛ p t ə 
repte	r 'e p t ə	 r 'ɛ p t ə 
reptes	r 'e p t ə s	 r 'ɛ p t ə s 
repto	r 'e p t u	 r 'ɛ p t u 
rere	r 'e ɾ ə	 r 'ɛ ɾ ə 
resa	r 'e z ə	 r 'ɛ z ə 
resclosa	r ə s k l 'ɔ z ə	 r ə s k l 'o z ə 
resen	r 'e z ə n	 r 'ɛ z ə n 
reso	r 'e z u	 r 'ɛ z u 
respir	r ə s p 'i r	 r ə s p 'i 
respon	r ə s p 'ɔ n	 r ə s p 'o n 
respost	r ə s p 'ɔ s t	 r ə s p 'o s t 
resta	r 'e s t ə	 r 'ɛ s t ə 
resten	r 'e s t ə n	 r 'ɛ s t ə n 
restes	r 'e s t ə s	 r 'ɛ s t ə s 
resti	r 'e s t i	 r 'ɛ s t i 
restin	r 'e s t i n	 r 'ɛ s t i n 
resto	r 'e s t u	 r 'ɛ s t u 
ret	r 'e t	 r 'ɛ t 
retard	r ə t 'a r t	 r ə t 'a r 
retir	r ə t 'i r	 r ə t 'i 
retòrcer	r ə t 'ɔ r s ə	 r ə t 'ɔ r s ə r 
retret	r ə t ɾ 'e t	 r ə t ɾ 'ɛ t 
retrets	r ə t ɾ 'e t s	 r ə t ɾ 'ɛ t s 
retrògrad	r ə t ɾ 'ɔ ɣ ɾ ə t	 r ə t ɾ 'ɔ ɣ ɾ ə ð 
reusenc	r ə w z 'ɛ ŋ	 r ə u z 'ɛ n s 
reverend	r ə β ə ɾ 'e n	 r ə β ə ɾ 'ɛ n d 
revetlla	r ə β 'e ʎ ʎ ə	 r ə β 'ɛ ʎ ʎ ə 
revolt	r ə β 'ɔ l	 r ə β 'o ʎ 
Riad	r i 'a t	 r i 'a ð 
Ribagorça	r i β ə ɣ 'o r s ə	 r i β ə ɣ 'ɔ r s ə 
riberenc	r i β ə ɾ 'ɛ ŋ	 r i β ə ɾ 'ɛ n s 
rigor	r i ɣ 'o r	 r i ɣ 'o 
ripollenc	r i p u ʎ 'ɛ ŋ	 r i p u ʎ 'ɛ n s 
rock	r 'ɔ k	 r 'o k k 
rogenc	r u ʒ 'ɛ ŋ	 r u ʒ 'ɛ n s 
roig	r 'ɔ t ʃ	 r u 'i ə 
Roland	r u l 'a n	 r u l 'a n ə 
rombe	r 'o m b ə	 r 'ɔ m b ə 
rombes	r 'o m b ə s	 r 'ɔ m b ə s 
rompre	r 'o m p ɾ ə	 r 'ɔ m p ɾ ə 
ronca	r 'o ŋ k ə	 r 'ɔ ŋ k ə 
ronda	r 'o n d ə	 r 'ɔ n d ə 
rondes	r 'o n d ə s	 r 'ɔ n d ə s 
rosa	r 'ɔ z ə	 r 'o z ə 
rosegaaltars	r u z ə ɣ ə ə l t 'a s	 r u z ə ɣ ə ə l t 'a r s 
roses	r 'ɔ z ə s	 r 'o z ə s 
rossa	r 'o s ə	 r 'ɔ s ə 
rosses	r 'o s ə s	 r 'ɔ s ə s 
rossos	r 'o s u s	 r 'ɔ s u s 
rot	r 'o t	 r 'ɔ t 
rota	r 'o t ə	 r 'ɔ t ə 
rotaboc	r u t ə β 'o k	 r u t ə β 'ɔ k 
roti	r 'o t i	 r 'ɔ t i 
rotonda	r u t 'o n d ə	 r u t 'ɔ n d ə 
rotund	r u t 'u n	 r u t 'u n d 
rou	r 'o w	 r 'o 
roure	r 'o w ɾ ə	 r 'ɔ w ɾ ə 
rovell	r u β 'ɛ ʎ	 r u β 'e ʎ 
rubor	r u β 'o r	 r u β 'o 
ruixada	r u ʃ 'a ð ə	 r u i ʃ 'a ð ə 
ruixades	r u ʃ 'a ð ə s	 r u i ʃ 'a ð ə s 
ruixar	r u ʃ 'a	 r u i ʃ 'a 
ruixat	r u ʃ 'a t	 r u i ʃ 'a t 
ruixats	r u ʃ 'a t s	 r u i ʃ 'a t s 
rumb	r 'u m	 r 'u m b 
rumor	r u m 'o r	 r u m 'o 
sa	s 'ə	 s ə 
sabadellenc	s ə β ə ð ə ʎ 'ɛ ŋ	 s ə β ə ð ə ʎ 'ɛ n s 
saber	s ə β 'ɛ	 s ə β 'e 
sabor	s ə β 'o r	 s ə β 'o 
sacseig	s ə k s 'ɛ t ʃ	 s ə k s 'ɛ ʃ 
safareig	s ə f ə ɾ 'ɛ t ʃ	 s ə f ə ɾ 'ɛ ʃ 
saguaro	s ə ɣ w 'a ɾ u	 s ə ɣ u 'a ɾ u 
saig	s 'a t ʃ	 s ə 'i ə 
sainet	s ə j n 'ɛ t	 s ə i n 'ɛ t 
salt	s 'a l	 s 'a l t 
Salt	s 'a l	 s 'a l t 
salvadorenc	s ə l β ə ð u ɾ 'ɛ ŋ	 s ə l β ə ð u ɾ 'ɛ n s 
sancionin	s ə n s i 'ɔ n i n	 s ə n s i 'o n i n 
saqueig	s ə k 'ɛ t ʃ	 s ə k 'ɛ ʃ 
sard	s 'a r	 s 'a r t 
sastressa	s ə s t ɾ 'ɛ s ə	 s ə s t ɾ 'e s ə 
satisfet	s ə t i s f 'e t	 s ə t i s f 'ɛ t 
satisfeta	s ə t i s f 'e t ə	 s ə t i s f 'ɛ t ə 
satisfetes	s ə t i s f 'e t ə s	 s ə t i s f 'ɛ t ə s 
satisfets	s ə t i s f 'e t s	 s ə t i s f 'ɛ t s 
sauna	s 'a w n ə	 s ə 'u n ə 
saxofon	s ə k s u f 'ɔ n	 s ə k s u f 'o n 
secret	s ə k ɾ 'e t	 s ə k ɾ 'ɛ t 
secreta	s ə k ɾ 'e t ə	 s ə k ɾ 'ɛ t ə 
secretes	s ə k ɾ 'e t ə s	 s ə k ɾ 'ɛ t ə s 
secrets	s ə k ɾ 'e t s	 s ə k ɾ 'ɛ t s 
secular	s ə k u l 'a r	 s ə k u l 'a 
sedenc	s ə ð 'ɛ ŋ	 s ə ð 'ɛ n s 
sega	s 'e ɣ ə	 s 'ɛ ɣ ə 
segarrenc	s ə ɣ ə r 'ɛ ŋ	 s ə ɣ ə r 'ɛ ŋ k 
segrest	s ə ɣ ɾ 'e s t	 s ə ɣ ɾ 'ɛ s t 
segrianenc	s ə ɣ ɾ i ə n 'ɛ ŋ	 s ə ɣ ɾ i ə n 'ɛ n s 
seguici	s ə ɣ 'i s i	 s ə ɣ u 'i s i 
segurs	s ə ɣ 'u s	 s ə ɣ 'u r s 
seient	s ə j 'e n	 s ə i 'e n 
seitó	s ə j t 'o	 s ə i t 'o 
semblantment	s ə m b l ə m m 'e n	 s ə m b l ə n ə m 'e n 
sembra	s 'e m b ɾ ə	 s 'ɛ m b ɾ ə 
sembren	s 'e m b ɾ ə n	 s 'ɛ m b ɾ ə n 
seminoma	s ə m i n 'ɔ m ə	 s ə m i n 'o m ə 
seminomes	s ə m i n 'ɔ m ə s	 s ə m i n 'o m ə s 
sempre	s 'e m p ɾ ə	 s 'ɛ m p ɾ ə 
sencer	s ə n s 'ɛ	 s ə n s 'e 
senda	s 'e n d ə	 s 'ɛ n d ə 
sénia	s 'e n i ə	 s ə n 'i ə 
sènior	s 'ɛ n i u r	 s ə n i 'o 
sense	s 'e n s ə	 s 'ɛ n s ə 
senten	s 'e n t ə n	 s 'ɛ n t ə n 
senti	s 'e n t i	 s 'ɛ n t i 
sentin	s 'e n t i n	 s 'ɛ n t i n 
sentis	s 'e n t i s	 s 'ɛ n t i s 
sento	s 'e n t u	 s 'ɛ n t u 
serp	s 'e r p	 s 'ɛ r p 
serreig	s ə r 'ɛ t ʃ	 s ə r 'ɛ ʃ 
sers	s 'e r s	 s 'e s 
setembre	s ə t 'e m b ɾ ə	 s ə t 'ɛ m b ɾ ə 
setge	s 'e d ʒ ə	 s 'ɛ d ʒ ə 
setges	s 'e d ʒ ə s	 s 'ɛ d ʒ ə s 
seu	s 'e w	 s 'ɛ w 
seus	s 'e w s	 s 'ɛ w s 
seva	s 'e β ə	 s 'ɛ β ə 
sever	s ə β 'e r	 s ə β 'e 
Sever	s ə β 'e r	 s ə β 'e 
seves	s 'e β ə s	 s 'ɛ β ə s 
si	s 'i	 s i 
siboc	s i β 'o k	 s i β 'ɔ k 
similar	s i m i l 'a r	 s i m i l 'a 
síndria	s 'i n d ɾ i ə	 s i n d ɾ 'i ə 
síndrome	s 'i n d ɾ u m ə	 s i n d ɾ 'ɔ m ə 
sisè	s i z 'ɛ	 s i s 'ɛ 
sistema	s i s t 'e m ə	 s i s t 'ɛ m ə 
sobre	s 'o β ɾ ə	 s 'ɔ β ɾ ə 
sobretot	s u β ɾ ə t 'o t	 s u β ɾ ə t 'ɔ t 
sobta	s 'o p t ə	 s 'ɔ b t ə 
sobtis	s 'ɔ p t i s	 s 'ɔ b t i s 
socórrer	s u k 'o r ə	 s u k u r 'e 
soferts	s u f 'ɛ r s	 s u f 'ɛ r t s 
sofre	s 'o f ɾ ə	 s 'ɔ f ɾ ə 
sofrença	s u f ɾ 'ɛ n s ə	 s u f ɾ 'e n s ə 
solar	s u l 'a r	 s u l 'a 
solc	s 'ɔ l k	 s 'o l k 
solell	s u l 'ɛ ʎ	 s u l 'e ʎ 
solquen	s 'o l k ə n	 s 'ɔ l k ə n 
solraig	s u l r 'a t ʃ	 s u l r ə 'i ə 
solsonenc	s u l s u n 'ɛ ŋ	 s u l s u n 'ɛ n s 
son	s 'ɔ n	 s 'o n 
sona	s 'ɔ n ə	 s 'o n ə 
sonda	s 'o n d ə	 s 'ɔ n d ə 
sondeig	s u n d 'ɛ t ʃ	 s u n d 'ɛ ʃ 
sondes	s 'o n d ə s	 s 'ɔ n d ə s 
sones	s 'ɔ n ə s	 s 'o n ə s 
soni	s 'ɔ n i	 s 'o n i 
sonin	s 'ɔ n i n	 s 'o n i n 
sonis	s 'ɔ n i s	 s 'o n i s 
sonor	s u n 'o r	 s u n 'o 
sons	s 'ɔ n s	 s 'o n s 
sopa	s 'o p ə	 s 'ɔ p ə 
sopen	s 'o p ə n	 s 'ɔ p ə n 
sopes	s 'o p ə s	 s 'ɔ p ə s 
sopluig	s u p l 'u t ʃ	 s u p l 'u ʃ 
sopor	s u p 'o r	 s u p 'o 
sorna	s 'o r n ə	 s 'ɔ r n ə 
sorprenentment	s u r p ɾ ə n ə m m 'e n	 s u r p ɾ ə n ə n ə m 'e n 
sorrenc	s u r 'ɛ ŋ	 s u r 'ɛ ŋ k 
sort	s 'ɔ r t	 s 'o r t 
sorteig	s u r t 'ɛ t ʃ	 s u r t 'ɛ ʃ 
sortenc	s u r t 'ɛ ŋ	 s u r t 'ɛ n s 
sospir	s u s p 'i r	 s u s p 'i 
sota	s 'o t ə	 s 'ɔ t ə 
sotragueig	s u t ɾ ə ɣ 'ɛ t ʃ	 s u t ɾ ə ɣ u 'ɛ ʃ 
sous	s 'ɔ w s	 s 'o w s 
subaltern	s u p ə l t 'ɛ r n	 s u β ə l t 'ɛ r n 
subalterna	s u p ə l t 'ɛ r n ə	 s u β ə l t 'ɛ r n ə 
subalternes	s u p ə l t 'ɛ r n ə s	 s u β ə l t 'ɛ r n ə s 
subaquàtic	s u p ə k w 'a t i k	 s u β ə k w 'a t i k 
subhasta	s u β 'a s t ə	 s u β u 'a s t ə 
subjecte	s u b ʒ 'e k t ə	 s u b ʒ 'ɛ k t ə 
sublim	s u β l 'i m	 s u p l 'i m 
subratllades	s u β ɾ ə ʎ ʎ 'a ð ə s	 s u β ɾ ə t ə l 'a ð ə s 
subratllar	s u b r ə ʎ ʎ 'a	 s u β ɾ ə ʎ ʎ 'a 
subrogar	s u b r u ɣ 'a	 s u β ɾ u ɣ 'a 
subsaharià	s u p s ə ə ɾ i 'a	 s u p s ə β ə ɾ i 'a 
sud	s 'u t	 s 'u d 
suficientment	s u f i s i ə m m 'e n	 s u f i s i ə n ə m 'e n 
sulfur	s u l f 'u r	 s u l f 'u 
superior	s u p ə ɾ i 'o r	 s u p ə ɾ i 'o 
supero	s u p 'e ɾ u	 s u p 'ɛ ɾ u 
suport	s u p 'ɔ r t	 s u p 'o r t 
suprem	s u p ɾ 'e m	 s u p ɾ 'ɛ m 
surenc	s u ɾ 'ɛ ŋ	 s u ɾ 'ɛ n s 
tabard	t ə β 'a r	 t ə β 'a r t 
tafur	t ə f 'u r	 t ə f 'u 
Tailàndia	t ə j l 'a n d i ə	 t ə i l 'a n d i ə 
tanc	t 'a ŋ	 t 'a ŋ k 
tanmateix	t ə m m ə t 'e ʃ	 t ə n m ə t 'e ʃ 
tard	t 'a r t	 t 'a r 
tàrtar	t 'a r t ə r	 t ə r t 'a 
Tàrtar	t 'a r t ə r	 t ə r t 'a 
te	t 'ə	 t ə 
teatre	t e 'a t ɾ ə	 ə e 'a t ɾ ə 
tecla	t 'e k l ə	 t 'ɛ k l ə 
tecles	t 'e k l ə s	 t 'ɛ k l ə s 
telèfons	t ə l 'ɛ f u n s	 t ə l ə f 'o n s 
tem	t 'e m	 t 'ɛ m 
tema	t 'e m ə	 t 'ɛ m ə 
temen	t 'e m ə n	 t 'ɛ m ə n 
témer	t 'e m ə	 t ə m 'e 
temes	t 'e m ə s	 t 'ɛ m ə s 
temo	t 'e m u	 t 'ɛ m u 
temor	t ə m 'o r	 t ə m 'o 
tempesta	t ə m p 'e s t ə	 t ə m p 'ɛ s t ə 
templa	t 'e m p l ə	 t 'ɛ m p l ə 
temple	t 'e m p l ə	 t 'ɛ m p l ə 
temples	t 'e m p l ə s	 t 'ɛ m p l ə s 
temps	t 'e m s	 t 'ɛ m p s 
tempteig	t ə m t 'ɛ t ʃ	 t ə m p t 'ɛ ʃ 
tenc	t 'ɛ ŋ	 t 'ɛ n s 
tenda	t 'e n d ə	 t 'ɛ n d ə 
tendencioses	t ə n d ə n s i 'o z ə s	 t ə n d ə n s i 'o s ə s 
tendes	t 'e n d ə s	 t 'ɛ n d ə s 
tenebra	t ə n 'e β ɾ ə	 t ə n 'ɛ β ɾ ə 
tenebres	t ə n 'e β ɾ ə s	 t ə n 'ɛ β ɾ ə s 
tenen	t 'e n ə n	 t 'ɛ n ə n 
tenor	t ə n 'o r	 t ə n 'o 
téntol	t 'e n t u l	 t ə n t 'ɔ l 
Ter	t 'e r	 t 'e 
terme	t 'e r m ə	 t 'ɛ r m ə 
termes	t 'e r m ə s	 t 'ɛ r m ə s 
terrassenc	t ə r ə s 'ɛ ŋ	 t ə r ə s 'ɛ n s 
terrestre	t ə r 'e s t ɾ ə	 t ə r 'ɛ s t ɾ ə 
terrestres	t ə r 'e s t ɾ ə s	 t ə r 'ɛ s t ɾ ə s 
terror	t ə r 'o r	 t ə r 'o 
test	t 'e s t	 t 'ɛ s t 
testa	t 'e s t ə	 t 'ɛ s t ə 
testicular	t ə s t i k u l 'a r	 t ə s t i k u l 'a 
testimoni	t ə s t i m 'ɔ n i	 t ə s t i m 'o n i 
testos	t 'e s t u s	 t 'ɛ s t u s 
tètanus	t 'ɛ t ə n u s	 t ə t ə n 'u s 
tetràgons	t ə t ɾ 'a ɣ u n s	 t ə t ɾ ə ɣ 'o n s 
teu	t 'e w	 t 'ɛ w 
teus	t 'e w s	 t 'ɛ w s 
teva	t 'e β ə	 t 'ɛ β ə 
teves	t 'e β ə s	 t 'ɛ β ə s 
text	t 'e k s t	 t 'ɛ k s t 
textos	t 'e k s t u s	 t 'ɛ k s t u s 
tigressa	t i ɣ ɾ 'ɛ s ə	 t i ɣ ɾ 'e s ə 
tinc	t 'i ŋ	 t 'i ŋ k 
tinença	t i n 'ɛ n s ə	 t i n 'e n s ə 
tir	t 'i r	 t 'i 
tiroteig	t i ɾ u t 'ɛ t ʃ	 t i ɾ u t 'ɛ ʃ 
titllada	t i ʎ ʎ 'a ð ə	 t i t ə l 'a ð ə 
titllades	t i ʎ ʎ 'a ð ə s	 t i t ə l 'a ð ə s 
titllat	t i ʎ ʎ 'a t	 t i t ə l 'a t 
titllats	t i ʎ ʎ 'a t s	 t i t ə l 'a t s 
titubeig	t i t u β 'ɛ t ʃ	 t i t u β 'ɛ ʃ 
titular	t i t u l 'a r	 t i t u l 'a 
to	t 'ɔ	 t 'o 
tofenc	t u f 'ɛ ŋ	 t u f 'ɛ n s 
tomba	t 'o m b ə	 t 'ɔ m b ə 
tomben	t 'o m b ə n	 t 'ɔ m b ə n 
tombes	t 'o m b ə s	 t 'ɔ m b ə s 
tómbol	t 'o m b u l	 t u m b 'ɔ l 
ton	t 'u n	 t 'o n 
tons	t 'ɔ n s	 t 'o n s 
tonya	t 'ɔ ɲ ə	 t 'o ɲ ə 
topen	t 'o p ə n	 t 'ɔ p ə n 
topi	t 'o p i	 t 'ɔ p i 
topin	t 'o p i n	 t 'ɔ p i n 
topo	t 'o p u	 t 'ɔ p u 
tòrcer	t 'ɔ r s ə	 t 'ɔ r s ə r 
tord	t 'o r t	 t 'o r 
torna	t 'o r n ə	 t 'ɔ r n ə 
torneig	t u r n 'ɛ t ʃ	 t u r n 'ɛ ʃ 
tornen	t 'o r n ə n	 t 'ɔ r n ə n 
tornes	t 'o r n ə s	 t 'ɔ r n ə s 
torni	t 'o r n i	 t 'ɔ r n i 
tornin	t 'o r n i n	 t 'ɔ r n i n 
tornis	t 'o r n i s	 t 'ɔ r n i s 
torno	t 'o r n u	 t 'ɔ r n u 
torra	t 'ɔ r ə	 t 'o r ə 
torre	t 'o r ə	 t 'ɔ r ə 
tors	t 'ɔ r s	 t 'o s 
tort	t 'ɔ r t	 t 'o r t 
tosca	t 'o s k ə	 t 'ɔ s k ə 
tot	t 'o t	 t 'ɔ t 
tota	t 'o t ə	 t 'ɔ t ə 
totes	t 'o t ə s	 t 'ɔ t ə s 
tothom	t u t 'ɔ m	 t u t 'a m 
tothora	t u t 'ɔ ɾ ə	 t u t i 'o ɾ ə 
totxo	t 'o t ʃ u	 t 'ɔ t ʃ u 
tova	t 'o β ə	 t 'ɔ β ə 
trabeació	t ɾ ə β e ə s i 'o	 t ɾ ə β ə ə s i 'o 
transcendència	t ɾ ə s ə n d 'ɛ n s i ə	 t ɾ ə n s ə n d 'ɛ n s i ə 
transcórrer	t ɾ ə n s k 'o r ə	 t ɾ ə n s k u r 'e 
transició	t ɾ ə n z i s i 'o	 t ɾ ə n s i s i 'o 
transigir	t ɾ ə n z i ʒ 'i	 t ɾ ə n s i ʒ 'i 
transitar	t ɾ ə n z i t 'a	 t ɾ ə n s i t 'a 
transitiu	t ɾ ə n z i t 'i w	 t ɾ ə n s i t 'i w 
transitiva	t ɾ ə n z i t 'i β ə	 t ɾ ə n s i t 'i β ə 
transitori	t ɾ ə n z i t 'ɔ ɾ i	 t ɾ ə n s i t 'ɔ ɾ i 
Transnístria	t ɾ ə n z n 'i s t ɾ i ə	 t ɾ ə n s n i s t ɾ 'i ə 
tràquea	t ɾ 'a k e ə	 t ɾ 'a k ə ə 
tremp	t ɾ 'e m	 t ɾ 'ɛ m p 
Tremp	t ɾ 'e m	 t ɾ 'ɛ m p 
trenc	t ɾ 'ɛ ŋ	 t ɾ 'ɛ n s 
trens	t ɾ 'ɛ n s	 t ɾ 'e n s 
trenta	t ɾ 'ɛ n t ə	 t ɾ 'e n t ə 
trentes	t ɾ 'ɛ n t ə s	 t ɾ 'e n t ə s 
trepa	t ɾ 'e p ə	 t ɾ 'ɛ p ə 
trepes	t ɾ 'e p ə s	 t ɾ 'ɛ p ə s 
trepig	t ɾ ə p 'i t ʃ	 t ɾ ə p 'i ɣ 
tresor	t ɾ ə z 'ɔ r	 t ɾ ə z 'o 
tret	t ɾ 'e t	 t ɾ 'ɛ t 
treta	t ɾ 'e t ə	 t ɾ 'ɛ t ə 
tretes	t ɾ 'e t ə s	 t ɾ 'ɛ t ə s 
trets	t ɾ 'e t s	 t ɾ 'ɛ t s 
tretze	t ɾ 'e d z ə	 t ɾ 'ɛ d z ə 
treva	t ɾ 'e β ə	 t ɾ 'ɛ β ə 
trinxeraire	t ɾ i n ʃ ə ɾ 'a j ɾ ə	 t ɾ i n ʃ ə ɾ ə 'i ɾ ə 
triumvirat	t ɾ i w m b i ɾ 'a t	 t ɾ i u m b i ɾ 'a t 
tro	t ɾ 'ɔ	 t ɾ 'o 
tromba	t ɾ 'o m b ə	 t ɾ 'ɔ m b ə 
trompa	t ɾ 'o m p ə	 t ɾ 'ɔ m p ə 
trompes	t ɾ 'o m p ə s	 t ɾ 'ɔ m p ə s 
tron	t ɾ 'ɔ n	 t ɾ 'o n 
trona	t ɾ 'ɔ n ə	 t ɾ 'o n ə 
tronc	t ɾ 'o ŋ	 t ɾ 'o ŋ k 
trones	t ɾ 'ɔ n ə s	 t ɾ 'o n ə s 
troni	t ɾ 'ɔ n i	 t ɾ 'o n i 
tronin	t ɾ 'ɔ n i n	 t ɾ 'o n i n 
tronis	t ɾ 'ɔ n i s	 t ɾ 'o n i s 
tropa	t ɾ 'o p ə	 t ɾ 'ɔ p ə 
tropes	t ɾ 'o p ə s	 t ɾ 'ɔ p ə s 
tros	t ɾ 'ɔ s	 t ɾ 'o s 
tsar	t s 'a r	 ə s 'a 
tsarista	t s ə ɾ 'i s t ə	 d z ə ɾ 'i s t ə 
tub	t 'u p	 t 'u 
tubular	t u β u l 'a r	 t u β u l 'a 
tumor	t u m 'o r	 t u m 'o 
txagatai	t ʃ ə ɣ ə t 'a j	 t ʃ ə ɣ ə t 'a i 
ubiqüitat	u β i k w i t 'a t	 u β i k i t 'a t 
udol	u ð 'o l	 u ð 'ɔ l 
ulterior	u l t ə ɾ i 'o r	 u l t ə ɾ i 'o 
Úmbria	'u m b ɾ i ə	 u m b ɾ 'i ə 
únic	'u n i k	 ' u n i k 
uniforme	u n i f 'o r m ə	 u n i f 'ɔ r m ə 
uniformes	u n i f 'o r m ə s	 u n i f 'ɔ r m ə s 
univers	u n i β 'ɛ r s	 u n i β 'e s 
urgellenc	u r ʒ ə ʎ 'ɛ ŋ	 u r ʒ ə ʎ 'ɛ n s 
Uruguai	u ɾ u ɣ w 'a j	 u ɾ u ɣ w 'a i 
uruguaià	u ɾ u ɣ w ə j 'a	 u ɾ u ɣ u ə j 'a 
us	'u s	 u s 
úter	'u t ə r	 u t 'e 
vaguista	b ə ɣ 'i s t ə	 b ə ɣ u 'i s t ə 
vaig	b 'a t ʃ	 b ə 'i ə 
vailet	b ə j l 'ɛ t	 b ə i l 'ɛ t 
vainilla	b ə j n 'i ʎ ə	 b ə i n 'i ʎ ə 
vainilles	b ə j n 'i ʎ ə s	 b ə i n 'i ʎ ə s 
vair	b 'a j r	 b ə 'i 
Valença	b ə l 'ɛ n s ə	 b ə l 'e n s ə 
valer	b ə l 'ɛ	 b ə l 'e 
vallenc	b ə ʎ 'ɛ ŋ	 b ə ʎ 'ɛ n s 
valor	b ə l 'o r	 b ə l 'o 
vampir	b ə m p 'i r	 b ə m p 'i 
vanuatenc	b ə n u ə t 'ɛ ŋ	 b ə n u ə t 'ɛ n s 
ve	b 'e	 b 'ɛ 
vehemència	b ə ə m 'ɛ n s i ə	 b e ə m 'ɛ n s i ə 
vehement	b ə ə m 'e n	 b ə z ə m 'e n 
vehicle	b ə 'i k l ə	 b ə z 'i k l ə 
veloç	b ə l 'ɔ s	 b ə l 'o s 
vèncer	b 'ɛ n s ə	 b 'ɛ n s ə r 
vences	b 'ɛ n s ə s	 b 'e n s ə s 
vendrellenc	b ə n d ɾ ə ʎ 'ɛ ŋ	 b ə n d ɾ ə ʎ 'ɛ n s 
vens	b 'ɛ n s	 b 'e n s 
ventre	b 'e n t ɾ ə	 b 'ɛ n t ɾ ə 
ver	b 'ɛ r	 b 'e 
verb	b 'ɛ r p	 b 'ɛ r 
verds	b 'ɛ r s	 b 'ɛ r t s 
vermell	b ə r m 'ɛ ʎ	 b ə r m 'e ʎ 
vermella	b ə r m 'ɛ ʎ ə	 b ə r m 'e ʎ ə 
vermelles	b ə r m 'ɛ ʎ ə s	 b ə r m 'e ʎ ə s 
vermells	b ə r m 'ɛ ʎ s	 b ə r m 'e ʎ s 
vers	b 'ɛ r s	 b 'e s 
ves	b 'e s	 b 'ɛ s 
vespa	b 'e s p ə	 b 'ɛ s p ə 
vespre	b 'e s p ɾ ə	 b 'ɛ s p ɾ ə 
veure's	b 'ɛ w ɾ ə s	 b ə w ɾ 'ɛ s 
Vicent	b i s 'ɛ n	 b i k 'e n 
vigor	b i ɣ 'o r	 b i ɣ 'o 
vinc	b 'i ŋ	 b 'i ŋ k 
virrei	b i r 'e j	 b i r 'ɛ i 
viuda	b 'i w ð ə	 b i 'u ð ə 
voler	b u l 'ɛ	 b u l 'e 
vora	b 'ɔ ɾ ə	 b 'o ɾ ə 
voto	b 'o t u	 b 'ɔ t u 
vuitada	b u j t 'a ð ə	 b u i t 'a ð ə 
vuitanta	b u j t 'a n t ə	 b u i t 'a n t ə 
vulgar	b u l ɣ 'a r	 b u l ɣ 'a 
wattímetre	b ə t 'i m ə t ɾ ə	 b ə t t 'i m ə t ɾ ə 
web	b 'e p	 b 'ɛ p 
whisky	w 'i s k i	 ə 'i s k 
xai	ʃ 'a j	 ʃ 'a i 
xeic	ʃ 'ɛ j k	 ʃ 'ɛ i k 
xíndria	ʃ 'i n d ɾ i ə	 ʃ i n d ɾ 'i ə 
xipolleig	ʃ i p u ʎ 'ɛ t ʃ	 ʃ i p u ʎ 'ɛ ʃ 
xistorra	ʃ i s t 'ɔ r ə	 ʃ i s t 'o r ə 
xiulada	ʃ i w l 'a ð ə	 ʃ i u l 'a ð ə 
xiulades	ʃ i w l 'a ð ə s	 ʃ i u l 'a ð ə s 
xiulador	ʃ i w l ə ð 'o	 ʃ i u l ə ð 'o 
xiular	ʃ i w l 'a	 ʃ i u l 'a 
xiulat	ʃ i w l 'a t	 ʃ i u l 'a t 
xiulats	ʃ i w l 'a t s	 ʃ i u l 'a t s 
xiulet	ʃ i w l 'ɛ t	 ʃ i u l 'ɛ t 
xop	ʃ 'o p	 ʃ 'ɔ p 
xou	ʃ 'ɔ w	 ʃ 'o w 
yazidisme	j ə z i ð 'i z m ə	 k ə z i ð 'i z m ə 
zinc	z 'i ŋ	 z 'i ŋ k 
zirconi	z i r k 'ɔ n i	 z i r k 'o n i 
zuau	z u 'a w	 ə w 'a w 
zumzeig	z u m z 'ɛ t ʃ	 z u m z 'ɛ ʃ 
de	d 'ə	 d ə 
que	k 'ə	 k ə 
la	l 'ə	 l ə 
i	'i	 i 
a	'ə	 ə 
el	'ə l	 ə l 
per	p 'ə r	 p 'e 
en	'ə n	 ə n 
les	l 'ə s	 l ə s 
els	'ə l s	 'ɛ l s 
del	d 'ə l	 d ə l 
amb	'ə m	 'a m b 
al	'ə l	 ə l 
es	'ə s	 ə s 
El	'ə l	 ə l 
dels	d 'ə l s	 d 'ɛ l s 
hi	'i	 i 
La	l 'ə	 l ə 
o	'ɔ	 'o 
si	s 'i	 s i 
em	'ə m	 ə m 
li	l 'i	 l i 
tot	t 'o t	 t 'ɔ t 
seva	s 'e β ə	 s 'ɛ β ə 
ens	'ə n s	 ə n s 
Els	'ə l s	 'ɛ l s 
A	'ə	 ə 
aquest	ə k 'ɛ t	 ə k 'ɛ s t 
als	'ə l s	 'a l s 
sobre	s 'o β ɾ ə	 s 'ɔ β ɾ ə 
vaig	b 'a t ʃ	 b ə 'i ə 
En	'ə n	 ə n 
Per	p 'ə r	 p 'e 
Si	s 'i	 s i 
sense	s 'e n s ə	 s 'ɛ n s ə 
ho	'u	 'ɔ 
temps	t 'e m s	 t 'ɛ m p s 
De	d 'ə	 d ə 
pel	p 'ə l	 p 'ɛ l 
tots	t 'o t s	 t 'ɔ t s 
entre	'e n t ɾ ə	 'ɛ n t ɾ ə 
fet	f 'e t	 f 'ɛ t 
meva	m 'e β ə	 m 'ɛ β ə 
jo	ʒ 'ɔ	 ʒ 'o 
sempre	s 'e m p ɾ ə	 s 'ɛ m p ɾ ə 
I	'i	 i 
he	'e	 'ɛ 
us	'u s	 u s 
cinc	s 'i ŋ	 s 'i ŋ k 
altres	'a l t ɾ ə s	 ' a l t ɾ ə s 
cosa	k 'ɔ z ə	 k 'o z ə 
seves	s 'e β ə s	 s 'ɛ β ə s 
han	'a n	 i 'a n 
se	s 'ə	 s ə 
Les	l 'ə s	 l ə s 
sistema	s i s t 'e m ə	 s i s t 'ɛ m ə 
Em	'ə m	 ə m 
tota	t 'o t ə	 t 'ɔ t ə 
et	'ə t	 ə t 
mentre	m 'e n t ɾ ə	 m 'ɛ n t ɾ ə 
des	d 'e s	 d 'ɛ s 
Jo	ʒ 'ɔ	 ʒ 'o 
Es	'ə s	 ə s 
poder	p u ð 'ɛ	 p u ð 'e 
Al	'ə l	 ə l 
hores	'ɔ ɾ ə s	 i 'o ə s 
Tinc	t 'i ŋ	 t 'i ŋ k 
aquell	ə k 'ɛ ʎ	 ə k 'e ʎ 
totes	t 'o t ə s	 t 'ɔ t ə s 
Aquest	ə k 'ɛ t	 ə k 'ɛ s t 
coses	k 'ɔ z ə s	 k 'o z ə s 
Hi	'i	 i 
dona	d 'ɔ n ə	 d 'o n ə 
haver	ə β 'ɛ	 ə β 'e 
altre	'a l t ɾ ə	 ' a l t ɾ ə 
nom	n 'ɔ m	 n 'o m 
tenen	t 'e n ə n	 t 'ɛ n ə n 
Li	l 'i	 l i 
Amb	'ə m	 'a m b 
tinc	t 'i ŋ	 t 'i ŋ k 
nens	n 'ɛ n s	 n 'e n s 
centre	s 'e n t ɾ ə	 s 'ɛ n t ɾ ə 
sota	s 'o t ə	 s 'ɔ t ə 
aquests	ə k 'ɛ t s	 ə k 'ɛ s t s 
s'hi	s 'i	 s 'ɔ 
bon	b 'ɔ n	 b 'o n 
ben	b 'e n	 b 'ɛ n 
pels	p 'ə l s	 p 'ɛ l s 
bona	b 'ɔ n ə	 b 'o n ə 
aquella	ə k 'ɛ ʎ ə	 ə k 'e ʎ ə 
saber	s ə β 'ɛ	 s ə β 'e 
mig	m 'i t ʃ	 m 'i ə 
mesos	m 'e z u s	 m 'ɛ z u s 
finestra	f i n 'e s t ɾ ə	 f i n 'ɛ s t ɾ ə 
cotxe	k 'o t ʃ ə	 k 'ɔ t ʃ ə 
compte	k 'o m t ə	 k 'ɔ m p t ə 
Ho	'u	 'ɔ 
moltes	m 'o l t ə s	 m 'ɔ l t ə s 
mateixa	m ə t 'e ʃ ə	 m ə t 'ɛ ʃ ə 
eren	'e ɾ ə n	 'ɛ ɾ ə n 
mes	m 'e s	 m 'ɛ s 
gairebé	g ə j ɾ ə β 'e	 g ə i ɾ ə β 'e 
Queden	k 'e ð ə n	 k 'ɛ ð ə n 
web	b 'e p	 b 'ɛ p 
mort	m 'ɔ r t	 m 'o r t 
altra	'a l t ɾ ə	 ' a l t ɾ ə 
cos	k 'ɔ s	 k 'o s 
forma	f 'o r m ə	 f 'ɔ r m ə 
fora	f 'ɔ ɾ ə	 f 'o ɾ ə 
home	'ɔ m ə	 u m ə 
ve	b 'e	 b 'ɛ 
llei	ʎ 'e j	 ʎ 'ɛ i 
trenta	t ɾ 'ɛ n t ə	 t ɾ 'e n t ə 
sento	s 'e n t u	 s 'ɛ n t u 
gaire	g 'a j ɾ ə	 g ə 'i ɾ ə 
He	'e	 'ɛ 
hora	'ɔ ɾ ə	 i 'o ɾ ə 
Vaig	b 'a t ʃ	 b ə 'i ə 
se'n	s 'ə n	 s 'ɛ n 
parell	p ə ɾ 'ɛ ʎ	 p ə ɾ 'e ʎ 
Tot	t 'o t	 t 'ɔ t 
darrere	d ə r 'e ɾ ə	 d ə r 'ɛ ɾ ə 
teva	t 'e β ə	 t 'ɛ β ə 
exemple	ə g z 'e m p l ə	 ə k s 'ɛ m p l ə 
tretze	t ɾ 'e d z ə	 t ɾ 'ɛ d z ə 
tothom	t u t 'ɔ m	 t u t 'a m 
tema	t 'e m ə	 t 'ɛ m ə 
molta	m 'o l t ə	 m 'ɔ l t ə 
dotze	d 'o d z ə	 d 'ɔ d z ə 
camp	k 'a m	 k 'a m p 
dones	d 'ɔ n ə s	 d 'o n ə s 
aquells	ə k 'ɛ ʎ s	 ə k 'e ʎ s 
queda	k 'e ð ə	 k 'ɛ ð ə 
noi	n 'ɔ j	 n 'o i 
fort	f 'ɔ r t	 f 'o r t 
Ens	'ə n s	 ə n s 
valors	b ə l 'o r s	 b ə l 'o s 
llengua	ʎ 'e ŋ g w ə	 ʎ 'ɛ ŋ g w ə 
Josep	ʒ u z 'ɛ p	 ʒ u s 'ɛ p 
veig	b 'ɛ t ʃ	 b 'ɛ ʃ 
comença	k u m 'ɛ n s ə	 k u m 'e n s ə 
bancs	b 'a ŋ s	 b 'a ŋ k s 
tard	t 'a r t	 t 'a r 
segle	s 'e g g l ə	 s 'ɛ g l ə 
Tots	t 'o t s	 t 'ɔ t s 
hagi	'a ʒ i	 i 'a ʒ i 
tros	t ɾ 'ɔ s	 t ɾ 'o s 
has	'a s	 i 'a s 
fred	f ɾ 'ɛ t	 f ɾ 'e d 
cabell	k ə β 'ɛ ʎ	 k ə β 'e ʎ 
Que	k 'ə	 k ə 
jove	ʒ 'o β ə	 ʒ 'ɔ β ə 
fets	f 'e t s	 f 'ɛ t s 
catorze	k ə t 'o r z ə	 k ə t 'ɔ r z ə 
Mentre	m 'e n t ɾ ə	 m 'ɛ n t ɾ ə 
records	r ə k 'ɔ r s	 r ə k 'o r t s 
joves	ʒ 'o β ə s	 ʒ 'ɔ β ə s 
banc	b 'a ŋ	 b 'a ŋ k 
Sempre	s 'e m p ɾ ə	 s 'ɛ m p ɾ ə 
sobretot	s u β ɾ ə t 'o t	 s u β ɾ ə t 'ɔ t 
segueix	s ə ɣ 'ɛ ʃ	 s ə ɣ 'e ʃ 
objectes	u b ʒ 'e k t ə s	 u b ʒ 'ɛ k t ə s 
faig	f 'a t ʃ	 f 'a ʃ 
to	t 'ɔ	 t 'o 
projecte	p ɾ u ʒ 'e k t ə	 p ɾ u ʒ 'ɛ k t ə 
meves	m 'e β ə s	 m 'ɛ β ə s 
flors	f l 'ɔ s	 f l 'o s 
dissabte	d i s 'a p t ə	 d i s 'a b b t ə 
Aquell	ə k 'ɛ ʎ	 ə k 'e ʎ 
resta	r 'e s t ə	 r 'ɛ s t ə 
prendre	p 'ɛ n d ɾ ə	 p ɾ 'ɛ n d ɾ ə 
terme	t 'e r m ə	 t 'ɛ r m ə 
n'hi	n 'i	 n 'ɔ 
llarg	ʎ 'a r k	 ʎ 'a r 
l'espai	l ə s p 'a j	 l ə s p 'a i 
deixa	d 'e ʃ ə	 d 'ɛ ʃ ə 
d'acord	d ə k 'ɔ r t	 d ə k 'o r t 
cor	k 'ɔ r	 k 'o 
boca	b 'o k ə	 b 'ɔ k ə 
aquelles	ə k 'ɛ ʎ ə s	 ə k 'e ʎ ə s 
temes	t 'e m ə s	 t 'ɛ m ə s 
tecla	t 'e k l ə	 t 'ɛ k l ə 
parella	p ə ɾ 'ɛ ʎ ə	 p ə ɾ 'e ʎ ə 
homes	'ɔ m ə s	 u m ə s 
centres	s 'e n t ɾ ə s	 s 'ɛ n t ɾ ə s 
bar	b 'a r	 b 'a 
Madrid	m ə ð ɾ 'i t	 m ə ð ɾ 'i ð 
Lleida	ʎ 'e j ð ə	 ʎ 'ɛ j ð ə 
Des	d 'e s	 d 'ɛ s 
Aquests	ə k 'ɛ t s	 ə k 'ɛ s t s 
se'ls	s 'ə l s	 s 'ɛ l s 
maig	m 'a t ʃ	 m 'a ʃ 
favor	f ə β 'o r	 f ə β 'o 
d'aquell	d ə k 'ɛ ʎ	 d ə k 'e ʎ 
camps	k 'a m s	 k 'a m p s 
Aquella	ə k 'ɛ ʎ ə	 ə k 'e ʎ ə 
trens	t ɾ 'ɛ n s	 t ɾ 'e n s 
s'havia	s ə β 'i ə	 s u ə β 'i ə 
cabells	k ə β 'ɛ ʎ s	 k ə β 'e ʎ s 
vora	b 'ɔ ɾ ə	 b 'o ɾ ə 
teatre	t e 'a t ɾ ə	 ə e 'a t ɾ ə 
posa	p 'ɔ z ə	 p 'o z ə 
futur	f u t 'u r	 f u t 'u 
bosc	b 'ɔ s k	 b 'o s k 
aspectes	ə s p 'e k t ə s	 ə s p 'ɛ k t ə s 
vehicles	b ə 'i k l ə s	 b ə z 'i k l ə s 
valor	b ə l 'o r	 b ə l 'o 
se'ns	s 'ə n s	 s 'ɛ n s 
s'ho	s 'u	 s 'ɔ 
noms	n 'ɔ m s	 n 'o m s 
festa	f 'e s t ə	 f 'ɛ s t ə 
fes	f 'e s	 f 'ɛ s 
desembre	d ə z 'e m b ɾ ə	 d ə z 'ɛ m b ɾ ə 
aprendre	ə p 'ɛ n d ɾ ə	 ə p ɾ 'ɛ n d ɾ ə 
vuitanta	b u j t 'a n t ə	 b u i t 'a n t ə 
torna	t 'o r n ə	 t 'ɔ r n ə 
suport	s u p 'ɔ r t	 s u p 'o r t 
queden	k 'e ð ə n	 k 'ɛ ð ə n 
peixos	p 'e ʃ u s	 p 'ɛ ʃ u s 
l'hora	l 'ɔ ɾ ə	 l i 'o ɾ ə 
haig	'a t ʃ	 ə 'i ə 
foto	f 'o t u	 f 'ɔ t u 
concret	k u ŋ k ɾ 'e t	 k u ŋ k ɾ 'ɛ t 
coll	k 'ɔ ʎ	 k 'o ʎ 
Pere	p 'e ɾ ə	 p 'ɛ ɾ ə 
O	'ɔ	 'o 
sons	s 'ɔ n s	 s 'o n s 
setembre	s ə t 'e m b ɾ ə	 s ə t 'ɛ m b ɾ ə 
dimarts	d i m 'a r s	 d i m 'a r t s 
conte	k 'o n t ə	 k 'ɔ n t ə 
bo	b 'ɔ	 b 'o 
apareix	ə p ə ɾ 'ɛ ʃ	 ə p ə ɾ 'e ʃ 
a	'ə	 ə 
flor	f l 'ɔ	 f l 'o 
d'aquella	d ə k 'ɛ ʎ ə	 d ə k 'e ʎ ə 
d'aigua	d 'a j ɣ w ə	 d 'a i ɣ w ə 
bossa	b 'o s ə	 b 'ɔ s ə 
bones	b 'ɔ n ə s	 b 'o n ə s 
Entre	'e n t ɾ ə	 'ɛ n t ɾ ə 
tecnologies	t ə g n u l u ʒ 'i ə s	 t ə k n u l u ʒ 'i ə s 
pedra	p 'e ð ɾ ə	 p 'ɛ ð ɾ ə 
paisatge	p ə j z 'a d ʒ ə	 p ə i z 'a d ʒ ə 
novembre	n u β 'e m b ɾ ə	 n u β 'ɛ m b ɾ ə 
nois	n 'ɔ j s	 n 'o i s 
formes	f 'o r m ə s	 f 'ɔ r m ə s 
espai	ə s p 'a j	 ə s p 'a i 
cotxes	k 'o t ʃ ə s	 k 'ɔ t ʃ ə s 
compra	k 'o m p ɾ ə	 k 'ɔ m p ɾ ə 
anterior	ə n t ə ɾ i 'o r	 ə n t ə ɾ i 'o 
Us	'u s	 u s 
Teatre	t e 'a t ɾ ə	 ə e 'a t ɾ ə 
vermell	b ə r m 'ɛ ʎ	 b ə r m 'e ʎ 
sud	s 'u t	 s 'u d 
respecte	r ə s p 'e k t ə	 r ə s p 'ɛ k t ə 
record	r ə k 'ɔ r t	 r ə k 'o r t 
quedar-se	k ə ð 'a r s ə	 k ə ð 'a s ə 
parts	p 'a r s	 p 'a r t s 
me	m 'ə	 m ə 
mateixos	m ə t 'e ʃ u s	 m ə t 'ɛ ʃ u s 
gossos	g 'o s u s	 g 'ɔ s u s 
feta	f 'e t ə	 f 'ɛ t ə 
d'aquells	d ə k 'ɛ ʎ s	 d ə k 'e ʎ s 
amor	ə m 'o r	 ə m 'o 
Pel	p 'ə l	 p 'ɛ l 
Et	'ə t	 ə t 
se'm	s 'ə m	 s 'ɛ m 
plens	p l 'ɛ n s	 p l 'e n s 
estableix	ə s t ə b b l 'ɛ ʃ	 ə s t ə b b l 'e ʃ 
dimecres	d i m 'e k ɾ ə s	 d i m 'ɛ k ɾ ə s 
deixen	d 'e ʃ ə n	 d 'ɛ ʃ ə n 
Sense	s 'e n s ə	 s 'ɛ n s ə 
transport	t ɾ ə n s p 'ɔ r t	 t ɾ ə n s p 'o r t 
processos	p ɾ u s 'e s u s	 p ɾ u s 'ɛ s u s 
pols	p 'o l s	 p 'ɔ l s 
pedres	p 'e ð ɾ ə s	 p 'ɛ ð ɾ ə s 
passeig	p ə s 'ɛ t ʃ	 p ə s 'ɛ ʃ 
membres	m 'e m b ɾ ə s	 m 'ɛ m b ɾ ə s 
l'hi	l 'i	 l 'ɔ 
l'havia	l ə β 'i ə	 l u ə β 'i ə 
guerra	g 'ɛ r ə	 g u 'ɛ r ə 
font	f 'ɔ n	 f 'o n 
esforç	ə s f 'ɔ r s	 ə s f 'o r s 
desig	d ə z 'i t ʃ	 d ə z 'i ə 
alhora	ə l 'ɔ ɾ ə	 ə l i 'o ɾ ə 
Se	s 'ə	 s ə 
Has	'a s	 i 'a s 
únic	'u n i k	 ' u n i k 
textos	t 'e k s t u s	 t 'ɛ k s t u s 
tempesta	t ə m p 'e s t ə	 t ə m p 'ɛ s t ə 
objecte	u b ʒ 'e k t ə	 u b ʒ 'ɛ k t ə 
fosca	f 'o s k ə	 f 'ɔ s k ə 
fer-ho	f 'e ɾ u	 f 'ɛ ɾ u 
existeix	ə g z i s t 'ɛ ʃ	 ə g z i s t 'e ʃ 
entendre	ə n t 'e n d ɾ ə	 ə n t 'ɛ n d ɾ ə 
dolça	d 'o l s ə	 d 'ɔ l s ə 
defecte	d ə f 'e k t ə	 d ə f 'ɛ k t ə 
correspon	k u r ə s p 'ɔ n	 k u r ə s p 'o n 
Consell	k u n s 'ɛ ʎ	 k u n s 'e ʎ 
ves	b 'e s	 b 'ɛ s 
tret	t ɾ 'e t	 t ɾ 'ɛ t 
torno	t 'o r n u	 t 'ɔ r n u 
sistemes	s i s t 'e m ə s	 s i s t 'ɛ m ə s 
respon	r ə s p 'ɔ n	 r ə s p 'o n 
queixes	k 'e ʃ ə s	 k 'ɛ ʃ ə s 
metges	m 'e d ʒ ə s	 m 'ɛ d ʒ ə s 
gest	ʒ 'e s t	 ʒ 'ɛ s t 
formen	f 'o r m ə n	 f 'ɔ r m ə n 
festes	f 'e s t ə s	 f 'ɛ s t ə s 
cognoms	k u g n 'ɔ m s	 k u ə n 'o m s 
caràcter	k ə ɾ 'a k t ə r	 k ə ɾ 'a k t ə 
caos	k 'a o s	 k ə 'ɔ s 
bons	b 'ɔ n s	 b 'o n s 
boig	b 'ɔ t ʃ	 b 'ɔ j ə 
aspecte	ə s p 'e k t ə	 ə s p 'ɛ k t ə 
Camp	k 'a m	 k 'a m p 
i	'i	 i 
vespre	b 'e s p ɾ ə	 b 'ɛ s p ɾ ə 
sabent	s ə β 'ɛ n	 s ə β 'e n 
reforma	r ə f 'o r m ə	 r ə f 'ɔ r m ə 
quedo	k 'e ð u	 k 'ɛ ð u 
projectes	p ɾ u ʒ 'e k t ə s	 p ɾ u ʒ 'ɛ k t ə s 
néixer	n 'e ʃ ə	 n ə ʃ 'e 
nord	n 'ɔ r t	 n 'o r 
menor	m ə n 'o r	 m ə n 'o 
meitat	m ə j t 'a t	 m ə i t 'a t 
m'havia	m ə β 'i ə	 m u ə β 'i ə 
llenguatge	ʎ ə ŋ g w 'a d ʒ ə	 ʎ ə ŋ g u 'a d ʒ ə 
lleis	ʎ 'e j s	 ʎ 'ɛ i s 
leis	l 'ɛ j s	 l 'ɛ i s 
hom	'ɔ m	 i 'o 
hagin	'a ʒ i n	 i 'a ʒ i n 
enrere	ə n r 'e ɾ ə	 ə n r 'ɛ ɾ ə 
doble	d 'o b b l ə	 d 'ɔ b b l ə 
disposen	d i s p 'o z ə n	 d i s p 'ɔ z ə n 
córrer	k 'o r ə	 k u r 'e 
cercle	s 'e r k l ə	 s 'ɛ r k l ə 
Moltes	m 'o l t ə s	 m 'ɔ l t ə s 
D'acord	d ə k 'ɔ r t	 d ə k 'o r t 
Als	'ə l s	 'a l s 
ésser	'e s ə r	 'e s ə 
A	'ə	 ə 
voler	b u l 'ɛ	 b u l 'e 
trets	t ɾ 'e t s	 t ɾ 'ɛ t s 
son	s 'ɔ n	 s 'o n 
restes	r 'e s t ə s	 r 'ɛ s t ə s 
popular	p u p u l 'a r	 p u p u l 'a 
ofereix	u f ə ɾ 'ɛ ʃ	 u f ə ɾ 'e ʃ 
menors	m ə n 'o r s	 m ə n 'o s 
fer-me	f 'e r m ə	 f 'ɛ r m ə 
espais	ə s p 'a j s	 ə s p 'a i s 
d'aquelles	d ə k 'ɛ ʎ ə s	 d ə k 'e ʎ ə s 
bombes	b 'o m b ə s	 b 'ɔ m b ə s 
vermelles	b ə r m 'ɛ ʎ ə s	 b ə r m 'e ʎ ə s 
transports	t ɾ ə n s p 'ɔ r s	 t ɾ ə n s p 'o r t s 
trajecte	t ɾ ə ʒ 'e k t ə	 t ɾ ə ʒ 'ɛ k t ə 
teves	t 'e β ə s	 t 'ɛ β ə s 
se'l	s 'ə l	 s 'ɛ l 
s'hagi	s 'a ʒ i	 s u 'a ʒ i 
s'aixeca	s ə ʃ 'e k ə	 s ə ʃ 'ɛ k ə 
quarts	k w 'a r s	 k w 'a r t s 
presenten	p ɾ ə z 'e n t ə n	 p ɾ ə z 'ɛ n t ə n 
plaer	p l ə 'ɛ	 p l ə 'e 
llar	ʎ 'a r	 ʎ 'a 
joguina	ʒ u ɣ 'i n ə	 ʒ u ɣ u 'i n ə 
interior	i n t ə ɾ i 'o r	 i n t ə ɾ i 'o 
interessa	i n t ə ɾ 'ɛ s ə	 i n t ə ɾ 'e s ə 
fotos	f 'o t u s	 f 'ɔ t u s 
fonts	f 'ɔ n s	 f 'o n s 
finestres	f i n 'e s t ɾ ə s	 f i n 'ɛ s t ɾ ə s 
fer-se	f 'e r s ə	 f 'ɛ r s ə 
esport	ə s p 'ɔ r t	 ə s p 'o r t 
deixo	d 'e ʃ u	 d 'ɛ ʃ u 
ampolla	ə m p 'o ʎ ə	 ə m p 'ɔ ʎ ə 
acord	ə k 'ɔ r t	 ə k 'o r t 
Veig	b 'ɛ t ʃ	 b 'ɛ ʃ 
Sento	s 'e n t u	 s 'ɛ n t u 
N'hi	n 'i	 n 'ɔ 
Faig	f 'a t ʃ	 f 'a ʃ 
Dóna'm	d 'o n ə m	 d u n 'a m 
Dissabte	d i s 'a p t ə	 d i s 'a b b t ə 
Conca	k 'o ŋ k ə	 k 'ɔ ŋ k ə 
tronc	t ɾ 'o ŋ	 t ɾ 'o ŋ k 
tecnologia	t ə g n u l u ʒ 'i ə	 t ə k n u l u ʒ 'i ə 
sentin	s 'e n t i n	 s 'ɛ n t i n 
segles	s 'e g g l ə s	 s 'ɛ g l ə s 
representen	r ə p ɾ ə z 'e n t ə n	 r ə p ɾ ə z 'ɛ n t ə n 
regles	r 'e g g l ə s	 r 'ɛ ɣ l ə s 
quedi	k 'e ð i	 k 'ɛ ð i 
provoca	p ɾ u β 'o k ə	 p ɾ u β 'ɔ k ə 
pressupost	p ɾ ə s u p 'ɔ s t	 p ɾ ə s u p 'o s t 
premsa	p ɾ 'e m s ə	 p ɾ 'ɛ m s ə 
port	p 'ɔ r t	 p 'o r t 
parelles	p ə ɾ 'ɛ ʎ ə s	 p ə ɾ 'e ʎ ə s 
metge	m 'e d ʒ ə	 m 'ɛ d ʒ ə 
lluitar	ʎ u j t 'a	 ʎ u i t 'a 
llargs	ʎ 'a r k s	 ʎ 'a r s 
immens	i m m 'ɛ n s	 i m m 'e n s 
gros	g ɾ 'ɔ s	 g ɾ 'o s 
error	ə r 'o r	 ə r 'o 
enorme	ə n 'o r m ə	 ə n 'ɔ r m ə 
créixer	k ɾ 'e ʃ ə	 k ɾ ə ʃ 'e 
conceptes	k u n s 'e p t ə s	 k u n s 'ɛ p t ə s 
comptes	k 'o m t ə s	 k 'ɔ m p t ə s 
atendre	ə t 'e n d ɾ ə	 ə t 'ɛ n d ɾ ə 
adequat	ə ð ə k w 'a t	 ə ð ə k 'a t 
abelles	ə β 'ɛ ʎ ə s	 ə β 'e ʎ ə s 
Totes	t 'o t ə s	 t 'ɔ t ə s 
Gairebé	g ə j ɾ ə β 'e	 g ə i ɾ ə β 'e 
Boi	b 'ɔ j	 b 'o i 
únics	'u n i k s	 ' u n i k s 
tornes	t 'o r n ə s	 t 'ɔ r n ə s 
tinguessin	t i ŋ g 'e s i n	 t i ŋ g 'ɛ s i n 
termes	t 'e r m ə s	 t 'ɛ r m ə s 
telèfons	t ə l 'ɛ f u n s	 t ə l ə f 'o n s 
t'he	t 'e	 t 'ɛ 
solar	s u l 'a r	 s u l 'a 
s'havien	s ə β 'i ə n	 s u ə β 'i ə n 
rugbi	r 'u g b i	 r 'u ɣ β i 
rosa	r 'ɔ z ə	 r 'o z ə 
recórrer	r ə k 'o r ə	 r ə k u r 'e 
particular	p ə r t i k u l 'a r	 p ə r t i k u l 'a 
mots	m 'o t s	 m 'ɔ t s 
moto	m 'o t u	 m 'ɔ t u 
mot	m 'o t	 m 'ɔ t 
moribund	m u ɾ i β 'u n	 m u ɾ i β 'u n d 
m'hi	m 'i	 m 'a 
llest	ʎ 'e s t	 ʎ 'ɛ s t 
llengües	ʎ 'e ŋ g w ə s	 ʎ 'ɛ ŋ g w ə s 
l'univers	l u n i β 'ɛ r s	 l u n i β 'e s 
gola	g 'o l ə	 g 'ɔ l ə 
enmig	ə m m 'i t ʃ	 ə n m 'i ə 
efectes	ə f 'e k t ə s	 ə f 'ɛ k t ə s 
dubtes	d 'u p t ə s	 d 'u b b t ə s 
distret	d i s t ɾ 'e t	 d i s t ɾ 'ɛ t 
converteix	k u m b ə r t 'ɛ ʃ	 k u m b ə r t 'e ʃ 
contes	k 'o n t ə s	 k 'ɔ n t ə s 
consell	k u n s 'ɛ ʎ	 k u n s 'e ʎ 
concepte	k u n s 'e p t ə	 k u n s 'ɛ p t ə 
cobreix	k u β ɾ 'ɛ ʃ	 k u β ɾ 'e ʃ 
afegeix	ə f ə ʒ 'ɛ ʃ	 ə f ə ʒ 'e ʃ 
Tremp	t ɾ 'e m	 t ɾ 'ɛ m p 
Tothom	t u t 'ɔ m	 t u t 'a m 
Segueix	s ə ɣ 'ɛ ʃ	 s ə ɣ 'e ʃ 
Salt	s 'a l	 s 'a l t 
Peso	p 'e z u	 p 'ɛ z u 
Pesa	p 'e z ə	 p 'ɛ z ə 
Medeix	m ə ð 'ɛ ʃ	 m ə ð 'e ʃ 
Igualada	i ɣ w ə l 'a ð ə	 i ɣ u ə l 'a ð ə 
Fes	f 'e s	 f 'ɛ s 
éssers	'e s ə r s	 e s 'e s 
Per	p 'ə r	 p 'e 
En	'ə n	 ə n 
vers	b 'ɛ r s	 b 'e s 
secret	s ə k ɾ 'e t	 s ə k ɾ 'ɛ t 
raig	r 'a t ʃ	 r ə 'i ə 
prefereix	p ɾ ə f ə ɾ 'ɛ ʃ	 p ɾ ə f ə ɾ 'e ʃ 
plataforma	p l ə t ə f 'o r m ə	 p l ə t ə f 'ɔ r m ə 
peninsular	p ə n i n s u l 'a r	 p ə n i n s u l 'a 
orelles	u ɾ 'ɛ ʎ ə s	 u ɾ 'e ʎ ə s 
morts	m 'ɔ r s	 m 'o r t s 
militar	m i l i t 'a r	 m i l i t 'a 
menja	m 'e n ʒ ə	 m 'ɛ n ʒ ə 
mateixes	m ə t 'e ʃ ə s	 m ə t 'ɛ ʃ ə s 
intento	i n t 'e n t u	 i n t 'ɛ n t u 
intenten	i n t 'e n t ə n	 i n t 'ɛ n t ə n 
humor	u m 'o r	 u m 'o 
golf	g 'ɔ l f	 g 'o l f 
fruits	f ɾ 'u j t s	 f ɾ u 'i t s 
fossin	f 'o s i n	 f 'ɔ s i n 
familiar	f ə m i l i 'a r	 f ə m i l i 'a 
errors	ə r 'o r s	 ə r 'o s 
entren	'e n t ɾ ə n	 'ɛ n t ɾ ə n 
enormes	ə n 'o r m ə s	 ə n 'ɔ r m ə s 
currículum	k u r 'i k u l u m	 k u r i k u l 'u m 
cost	k 'ɔ s t	 k 'o s t 
corre	k 'o r ə	 k 'ɔ r ə 
copes	k 'o p ə s	 k 'ɔ p ə s 
coneix	k u n 'ɛ ʃ	 k u n 'e ʃ 
clars	k l 'a s	 k l 'a r s 
alcohol	ə l k u 'ɔ l	 ə l k u 'a l 
afores	ə f 'ɔ ɾ ə s	 ə f 'o ɾ ə s 
Torna	t 'o r n ə	 t 'ɔ r n ə 
S'hi	s 'i	 s 'ɔ 
Eren	'e ɾ ə n	 'ɛ ɾ ə n 
Compte	k 'o m t ə	 k 'ɔ m p t ə 
Bon	b 'ɔ n	 b 'o n 
Antoni	ə n t 'ɔ n i	 ə n t 'o n i 
úniques	'u n i k ə s	 ' u n i k ə s 
única	'u n i k ə	 ' u n i k ə 
érem	'e ɾ ə m	 e ɾ 'ɛ m 
vivendes	b i β 'e n d ə s	 b i β 'ɛ n d ə s 
vivenda	b i β 'e n d ə	 b i β 'ɛ n d ə 
vinc	b 'i ŋ	 b 'i ŋ k 
vermells	b ə r m 'ɛ ʎ s	 b ə r m 'e ʎ s 
vermella	b ə r m 'ɛ ʎ ə	 b ə r m 'e ʎ ə 
ungles	'u ŋ g l ə s	 ' u ŋ g l ə s 
tècniques	t 'ɛ g n i k ə s	 t 'ɛ k n i k ə s 
tornen	t 'o r n ə n	 t 'ɔ r n ə n 
sona	s 'ɔ n ə	 s 'o n ə 
sisè	s i z 'ɛ	 s i s 'ɛ 
similar	s i m i l 'a r	 s i m i l 'a 
sentir-se	s ə n t 'i r s ə	 s ə n t 'i s ə 
segurs	s ə ɣ 'u s	 s ə ɣ 'u r s 
repte	r 'e p t ə	 r 'ɛ p t ə 
repeteix	r ə p ə t 'ɛ ʃ	 r ə p ə t 'e ʃ 
recompte	r ə k 'o m t ə	 r ə k 'ɔ m p t ə 
recents	r ə s 'e n s	 r ə k 'e n s 
recentment	r ə s ə m m 'e n	 r ə k ə n ə m 'e n 
quiet	k i 'e t	 k i 'ɛ t 
quelcom	k ə l k 'ɔ m	 k ə l k 'o m 
queixa	k 'e ʃ ə	 k 'ɛ ʃ ə 
produeix	p ɾ u ð u 'ɛ ʃ	 p ɾ u ð u 'e ʃ 
poesia	p u ə z 'i ə	 p u ə s 'i ə 
plàncton	p l 'a ŋ k t o n	 p l ə ŋ k t 'o n 
plor	p l 'ɔ	 p l 'o 
piscina	p i s 'i n ə	 p i s k 'i n ə 
perfecte	p ə r f 'e k t ə	 p ə r f 'ɛ k t ə 
pateix	p ə t 'ɛ ʃ	 p ə t 'e ʃ 
neboda	n ə β 'o ð ə	 n ə β 'ɔ ð ə 
lo	l 'u	 l u 
llop	ʎ 'o p	 ʎ 'ɔ p 
llagosta	ʎ ə ɣ 'o s t ə	 ʎ ə ɣ 'ɔ s t ə 
l'orella	l u ɾ 'ɛ ʎ ə	 l u ɾ 'e ʎ ə 
l'havien	l ə β 'i ə n	 l u ə β 'i ə n 
l'estómac	l ə s t 'o m ə k	 l ə s t u m 'a k 
l'enneàgon	l ə n n e 'a ɣ u n	 l ə n ə e 'a ɣ u n 
jersei	ʒ ə r s 'ɛ j	 ʒ ə r s 'ɛ i 
intens	i n t 'ɛ n s	 i n t 'e n s 
herois	ə ɾ 'ɔ j s	 i ə ɾ 'o i s 
gotes	g 'o t ə s	 g 'ɔ t ə s 
gota	g 'o t ə	 g 'ɔ t ə 
glop	g l 'o p	 g l 'ɔ p 
garanteix	g ə ɾ ə n t 'ɛ ʃ	 g ə ɾ ə n 'e ʃ 
fosques	f 'o s k ə s	 f 'ɔ s k ə s 
fetge	f 'e d ʒ ə	 f 'ɛ d ʒ ə 
exigir	ə g z i ʒ 'i	 ə k s i ʒ 'i 
evidentment	ə β i ð ə m m 'e n	 ə β i ð ə n ə m 'e n 
esports	ə s p 'ɔ r s	 ə s p 'o r t s 
esperi	ə s p 'e ɾ i	 ə s p 'ɛ ɾ i 
entenc	ə n t 'e ŋ	 ə n t 'ɛ n s 
endarrere	ə n d ə r 'e ɾ ə	 ə n d ə r 'ɛ ɾ ə 
encendre	ə n s 'e n d ɾ ə	 ə n s 'ɛ n d ɾ ə 
donen	d 'o n ə n	 d 'ɔ n ə n 
dirigeix	d i ɾ i ʒ 'ɛ ʃ	 d i ɾ i ʒ 'e ʃ 
dimonis	d i m 'ɔ n i s	 d i m 'o n i s 
diguem-ne	d i ɣ 'ɛ m n ə	 d i ɣ u 'ɛ m n ə 
descens	d ə s 'ɛ n s	 d ə s 'e n s 
desa	d 'e z ə	 d 'ɛ z ə 
deixi	d 'e ʃ i	 d 'ɛ ʃ i 
d'hora	d 'ɔ ɾ ə	 d i 'o ɾ ə 
convoquen	k u m b 'o k ə n	 k u m b 'ɔ k ə n 
concerts	k u n s 'ɛ r s	 k u n s 'ɛ r t s 
compta	k 'o m t ə	 k 'ɔ m t ə 
compro	k 'o m p ɾ u	 k 'ɔ m p ɾ u 
assenteix	ə s ə n t 'ɛ ʃ	 ə s ə n t 'e ʃ 
agenda	ə ʒ 'e n d ə	 ə ʒ 'ɛ n d ə 
adequada	ə ð ə k w 'a ð ə	 ə ð ə k 'a ð ə 
Seguint	s ə ɣ 'i n	 s ə ɣ u 'i n 
Santander	s ə n t ə n d 'e r	 s ə n t ə n d 'e 
S'havia	s ə β 'i ə	 s u ə β 'i ə 
Respecte	r ə s p 'e k t ə	 r ə s p 'ɛ k t ə 
Reglament	r ə g g l ə m 'e n	 r ə ɣ l ə m 'e n 
Londres	l 'o n d ɾ ə s	 l 'ɔ n d ɾ ə s 
Intento	i n t 'e n t u	 i n t 'ɛ n t u 
Horts	'ɔ r s	 i 'o t s 
Han	'a n	 i 'a n 
Evidentment	ə β i ð ə m m 'e n	 ə β i ð ə n ə m 'e n 
Deixo	d 'e ʃ u	 d 'ɛ ʃ u 
Coll	k 'ɔ ʎ	 k 'o ʎ 
Bona	b 'ɔ n ə	 b 'o n ə 
Benidorm	b ə n i ð 'o r m	 b ə n i ð 'o m 
o	'ɔ	 'o 
per	p 'ə r	 p 'e 
Has	'a s	 i 'a s 
transaccions	t ɾ ə n z ə k s i 'o n s	 t ɾ ə n s ə k s i 'o n s 
torni	t 'o r n i	 t 'ɔ r n i 
tons	t 'ɔ n s	 t 'o n s 
testimonis	t ə s t i m 'ɔ n i s	 t ə s t i m 'o n i s 
te	t 'ə	 t ə 
t'hi	t 'i	 t 'a 
suposa	s u p 'ɔ z ə	 s u p 'o z ə 
sencera	s ə n s 'ɛ ɾ ə	 s ə n s 'e ɾ ə 
seguint	s ə ɣ 'i n	 s ə ɣ u 'i n 
sabor	s ə β 'o r	 s ə β 'o 
s'hagin	s 'a ʒ i n	 s 'ɔ ʒ i n 
s'adonessin	s ə ð u n 'e s i n	 s ə ð u n 'ɛ s i n 
retrobo	r ə t ɾ 'o β u	 r ə t ɾ 'ɔ β u 
renda	r 'e n d ə	 r 'ɛ n d ə 
remei	r ə m 'ɛ j	 r ə m 'ɛ i 
profund	p ɾ u f 'u n	 p ɾ u f 'u n d 
prendrà	p ə n d ɾ 'a	 p ɾ ə n d ɾ 'a 
parer	p ə ɾ 'ɛ	 p ə ɾ 'e 
oberts	u β 'ɛ r s	 u β 'ɛ r t s 
n'he	n 'e	 n 'ɛ 
motor	m u t 'o r	 m u t 'o 
menjo	m 'e n ʒ u	 m 'ɛ n ʒ u 
membre	m 'e m b ɾ ə	 m 'ɛ m b ɾ ə 
mantenen	m ə n t 'e n ə n	 m ə n t 'ɛ n ə n 
malson	m ə l s 'ɔ n	 m ə l s 'o n 
lleixa	ʎ 'e ʃ ə	 ʎ 'ɛ ʃ ə 
llegeix	ʎ ə ʒ 'ɛ ʃ	 ʎ ə ʒ 'e ʃ 
grega	g ɾ 'e ɣ ə	 g ɾ 'ɛ ɣ ə 
goig	g 'ɔ t ʃ	 g u 'i ə 
foscos	f 'o s k u s	 f 'ɔ s k u s 
forts	f 'ɔ r s	 f 'o r t s 
foren	f 'o ɾ ə n	 f 'ɔ ɾ ə n 
fer-nos	f 'e r n u s	 f 'ɛ r n u s 
fer-li	f 'e r l i	 f 'ɛ r l i 
farigola	f ə ɾ i ɣ 'o l ə	 f ə ɾ i ɣ 'ɔ l ə 
exòtica	ə g z 'ɔ t i k ə	 ə k s 'ɔ t i k ə 
exterior	ə k s t ə ɾ i 'o r	 ə k s t ə ɾ i 'o 
examen	ə g z 'a m ə n	 ə k s 'a m ə n 
esperen	ə s p 'e ɾ ə n	 ə s p 'ɛ ɾ ə n 
escolar	ə s k u l 'a r	 ə s k u l 'a 
element	ə l ə m 'e n	 ɛ l ə m 'e n 
dutxar-se	d u t ʃ 'a r s ə	 d u t ʃ 'a s ə 
distreta	d i s t ɾ 'e t ə	 d i s t ɾ 'ɛ t ə 
dimoni	d i m 'ɔ n i	 d i m 'o n i 
d'eines	d 'ɛ j n ə s	 d 'ɛ i n ə s 
creixi	k ɾ 'e ʃ i	 k ɾ 'ɛ ʃ i 
corren	k 'o r ə n	 k 'ɔ r ə n 
comparseros	k u m p ə r s 'e ɾ u s	 k u m p ə r s 'ɛ ɾ u s 
cognom	k u g n 'ɔ m	 k u ə n 'o m 
celles	s 'ɛ ʎ ə s	 s 'e ʎ ə s 
celebra	s ə l 'e β ɾ ə	 s ə l 'ɛ β ɾ ə 
caràcters	k ə ɾ 'a k t ə r s	 k ə ɾ ə k t 'e s 
bàsquet	b 'a s k ə t	 b ə s k 'ɛ t 
bàndols	b 'a n d u l s	 b ə n d 'ɔ l s 
aparells	ə p ə ɾ 'ɛ ʎ s	 ə p ə ɾ 'e ʎ s 
Sota	s 'o t ə	 s 'ɔ t ə 
Pontevedra	p u n t ə β 'e ð ɾ ə	 p u n t ə β 'ɛ ð ɾ ə 
Pels	p 'ə l s	 p 'ɛ l s 
Menjo	m 'e n ʒ u	 m 'ɛ n ʒ u 
L'havien	l ə β 'i ə n	 l u ə β 'i ə n 
Home	'ɔ m ə	 u m ə 
Espero	ə s p 'e ɾ u	 ə s p 'ɛ ɾ u 
Dimarts	d i m 'a r s	 d i m 'a r t s 
Centre	s 'e n t ɾ ə	 s 'ɛ n t ɾ ə 
volent	b u l 'ɛ n	 b u l 'e n 
vigor	b i ɣ 'o r	 b i ɣ 'o 
vehemència	b ə ə m 'ɛ n s i ə	 b e ə m 'ɛ n s i ə 
univers	u n i β 'ɛ r s	 u n i β 'e s 
tub	t 'u p	 t 'u 
tresor	t ɾ ə z 'ɔ r	 t ɾ ə z 'o 
transforma	t ɾ ə n s f 'o r m ə	 t ɾ ə n s f 'ɔ r m ə 
tonto	t 'o n t u	 t 'ɔ n t u 
testimoni	t ə s t i m 'ɔ n i	 t ə s t i m 'o n i 
temor	t ə m 'o r	 t ə m 'o 
tecnològics	t ə g n u l 'ɔ ʒ i k s	 t ə k n u l 'ɔ ʒ i k s 
tecles	t 'e k l ə s	 t 'ɛ k l ə s 
te'n	t 'ə n	 t 'ɛ n 
t'ho	t 'u	 t 'a 
suggereix	s u g ʒ ə ɾ 'ɛ ʃ	 s u g ʒ ə ɾ 'e ʃ 
subjectes	s u b ʒ 'e k t ə s	 s u b ʒ 'ɛ k t ə s 
sorteig	s u r t 'ɛ t ʃ	 s u r t 'ɛ ʃ 
sopars	s u p 'a s	 s u p 'a r s 
sofre	s 'o f ɾ ə	 s 'ɔ f ɾ ə 
sistema	s i s t 'e m ə	 s i s t 'ɛ m ə 
seqüeles	s ə k w 'ɛ l ə s	 s ə k 'ɛ l ə s 
sencer	s ə n s 'ɛ	 s ə n s 'e 
seguiment	s ə ɣ i m 'e n	 s ə ɣ u i m 'e n 
s'espolsa	s ə s p 'o l s ə	 s ə s p 'ɔ l s ə 
s'aconsegueix	s ə k u n s ə ɣ 'ɛ ʃ	 s ə k u n s ə ɣ 'e ʃ 
s'accepten	s ə k s 'e p t ə n	 s ə k s 'ɛ p t ə n 
ronda	r 'o n d ə	 r 'ɔ n d ə 
rere	r 'e ɾ ə	 r 'ɛ ɾ ə 
reprodueix	r ə p ɾ u ð u 'ɛ ʃ	 r ə p ɾ u ð u 'e ʃ 
reformes	r ə f 'o r m ə s	 r ə f 'ɔ r m ə s 
recorre	r ə k 'o r ə	 r ə k 'ɔ r ə 
reconeix	r ə k u n 'ɛ ʃ	 r ə k u n 'e ʃ 
pàrquing	p 'a r k i ŋ	 p ə r k 'i ŋ 
protegeix	p ɾ u t ə ʒ 'ɛ ʃ	 p ɾ u t ə ʒ 'e ʃ 
prosa	p ɾ 'ɔ z ə	 p ɾ 'o z ə 
presta	p ɾ 'e s t ə	 p ɾ 'ɛ s t ə 
presses	p ɾ 'e s ə s	 p ɾ 'ɛ s ə s 
presento	p ɾ ə z 'e n t u	 p ɾ ə z 'ɛ n t u 
ports	p 'ɔ r s	 p 'o r t s 
poguessin	p u ɣ 'e s i n	 p u ɣ 'ɛ s i n 
podi	p 'o ð i	 p 'ɔ ð i 
plora	p l 'ɔ ɾ ə	 p l 'o ɾ ə 
penja	p 'e n ʒ ə	 p 'ɛ n ʒ ə 
pengi	p 'e n ʒ i	 p 'ɛ n ʒ i 
pengen	p 'e n ʒ ə n	 p 'ɛ n ʒ ə n 
passaport	p ə s ə p 'ɔ r t	 p ə s ə p 'o r t 
parisencs	p ə ɾ i z 'ɛ ŋ s	 p ə ɾ i z 'ɛ ŋ k s 
pacientment	p ə s i ə m m 'e n	 p ə s i ə n ə m 'e n 
omple	'o m p l ə	 'ɔ m p l ə 
ombres	'o m b ɾ ə s	 'ɔ m b ɾ ə s 
obtinguts	u p t i ŋ g 'u t s	 u β t i ŋ g 'u t s 
obtingut	u p t i ŋ g 'u t	 u β t i ŋ g 'u t 
obrir-se	u β ɾ 'i r s ə	 u β ɾ 'i s ə 
motors	m u t 'o r s	 m u t 'o s 
mercadeig	m ə r k ə ð 'ɛ t ʃ	 m ə r k ə ð 'ɛ ʃ 
mengen	m 'e n ʒ ə n	 m 'ɛ n ʒ ə n 
matrimoni	m ə t ɾ i m 'ɔ n i	 m ə t ɾ i m 'o n i 
mareig	m ə ɾ 'ɛ t ʃ	 m ə ɾ 'ɛ ʃ 
m'interessa	m i n t ə ɾ 'ɛ s ə	 m i n t ə ɾ 'e s ə 
lluitava	ʎ u j t 'a β ə	 ʎ u i t 'a β ə 
llueix	ʎ u 'ɛ ʃ	 ʎ u 'e ʃ 
llosa	ʎ 'ɔ z ə	 ʎ 'o z ə 
lletja	ʎ 'e d ʒ ə	 ʎ 'ɛ d ʒ ə 
lleig	ʎ 'e t ʃ	 ʎ 'ɛ ʃ 
l'aparença	l ə p ə ɾ 'ɛ n s ə	 l ə p ə ɾ 'e n s ə 
l'aparell	l ə p ə ɾ 'ɛ ʎ	 l ə p ə ɾ 'e ʎ 
kafkianes	k ə f k i 'a n ə s	 k ə f i i 'a n ə s 
irreal	i r e 'a l	 i r ə e 'a l 
interiors	i n t ə ɾ i 'o r s	 i n t ə ɾ i 'o s 
inquiet	i ŋ k i 'e t	 i ŋ k i 'ɛ t 
hàbits	'a β i t s	 ə β i t s 
guiava	g i 'a β ə	 g u i 'a β ə 
grecs	g ɾ 'e k s	 g ɾ 'ɛ k s 
grec	g ɾ 'e k	 g ɾ 'ɛ k 
golfes	g 'o l f ə s	 g 'ɔ l f ə s 
gespa	ʒ 'e s p ə	 ʒ 'ɛ s p ə 
gasoil	g ə z 'ɔ j l	 g ə z u 'i l 
fotre	f 'o t ɾ ə	 f 'ɔ t ɾ ə 
folre	f 'o l r ə	 f 'ɔ l r ə 
fetes	f 'e t ə s	 f 'ɛ t ə s 
fer-ne	f 'e r n ə	 f 'ɛ r n ə 
fer-la	f 'e r l ə	 f 'ɛ r l ə 
extrem	ə k s t ɾ 'e m	 ə k s t ɾ 'ɛ m 
exempts	ə g z 'e m t s	 ə k s 'ɛ m p t s 
excepte	ə k s 'e p t ə	 ə k s 'ɛ p t ə 
estàndard	ə s t 'a n d ə r t	 ə s t 'a n d ə r 
establiments	ə s t ə b b l i m 'e n s	 ə s t ə β l i m 'e n s 
espongiformes	ə s p u n ʒ i f 'o r m ə s	 ə s p u n ʒ i f 'ɔ r m ə s 
esnob	ə z n 'ɔ p	 ə z n 'o 
esmorzen	ə z m 'o r z ə n	 ə z m 'ɔ r z ə n 
escolta	ə s k 'o l t ə	 ə s k 'ɔ l t ə 
escletxa	ə s k l 'e t ʃ ə	 ə s k l 'ɛ t ʃ ə 
enquestes	ə ŋ k 'e s t ə s	 ə ŋ k 'ɛ s t ə s 
enquesta	ə ŋ k 'e s t ə	 ə ŋ k 'ɛ s t ə 
empremtes	ə m p ɾ 'e m t ə s	 ə m p ɾ 'ɛ m t ə s 
elèctrics	ə l 'ɛ k t ɾ i k s	 ə l ə k t ɾ 'i k s 
efecte	ə f 'e k t ə	 ə f 'ɛ k t ə 
distrets	d i s t ɾ 'e t s	 d i s t ɾ 'ɛ t s 
dirigir-se	d i ɾ i ʒ 'i r s ə	 d i ɾ i ʒ 'i s ə 
digui'm	d 'i ɣ i m	 d i ɣ 'i m 
difondre	d i f 'o n d ɾ ə	 d i f 'ɔ n d ɾ ə 
descomptat	d ə s k u m t 'a t	 d ə s k u m p t 'a t 
desapareix	d ə z ə p ə ɾ 'ɛ ʃ	 d ə z ə p ə ɾ 'e ʃ 
deixar-se	d ə ʃ 'a r s ə	 d ə ʃ 'a s ə 
d'àrea	d 'a ɾ e ə	 d 'a ɾ ə ə 
d'orella	d u ɾ 'ɛ ʎ ə	 d u ɾ 'e ʎ ə 
d'hores	d 'ɔ ɾ ə s	 d i 'o ə s 
d'homes	d 'ɔ m ə s	 d u m ə s 
d'espai	d ə s p 'a j	 d ə s p 'a i 
d'aigües	d 'a j ɣ w ə s	 d 'a i ɣ w ə s 
creixen	k ɾ 'e ʃ ə n	 k ɾ 'ɛ ʃ ə n 
creences	k ɾ ə 'ɛ n s ə s	 k ɾ ə 'e n s ə s 
creada	k ɾ e 'a ð ə	 k ə e 'a ð ə 
concretes	k u ŋ k ɾ 'e t ə s	 k u ŋ k ɾ 'ɛ t ə s 
conca	k 'o ŋ k ə	 k 'ɔ ŋ k ə 
comte	k 'o m t ə	 k 'ɔ m t ə 
compren	k 'o m p ɾ ə n	 k 'ɔ m p ɾ ə n 
comenten	k u m 'e n t ə n	 k u m 'ɛ n t ə n 
colze	k 'o l z ə	 k 'ɔ l z ə 
closos	k l 'ɔ z u s	 k l 'o z u s 
certs	s 'ɛ r s	 s 'ɛ r t s 
cera	s 'ɛ ɾ ə	 s 'e ɾ ə 
ceptre	s 'e p t ɾ ə	 s 'ɛ p t ɾ ə 
cegues	s 'e ɣ ə s	 s 'ɛ ɣ ə s 
capgròs	k ə b g ɾ 'ɔ s	 k ə p ɣ ɾ 'ɔ s 
brolla	b ɾ 'o ʎ ə	 b ɾ 'ɔ ʎ ə 
bots	b 'o t s	 b 'ɔ t s 
bosses	b 'o s ə s	 b 'ɔ s ə s 
borsa	b 'o r s ə	 b 'ɔ r s ə 
atzar	ə d z 'a r	 ə d z 'a 
atur	ə t 'u r	 ə t 'u 
assumptes	ə s 'u m t ə s	 ə s 'u m p t ə s 
assumpte	ə s 'u m t ə	 ə s 'u m p t ə 
arts	'a r s	 'a r t s 
arreglat	ə r ə g g l 'a t	 ə r ə ɣ l 'a t 
anteriors	ə n t ə ɾ i 'o r s	 ə n t ə ɾ i 'o s 
ampolles	ə m p 'o ʎ ə s	 ə m p 'ɔ ʎ ə s 
alt	'a l	 'a l t 
aliens	ə l i 'ɛ n s	 ə l i 'e n s 
aleatoris	ə l e ə t 'ɔ ɾ i s	 ə l ə ə t 'ɔ ɾ i s 
aimara	ə j m 'a ɾ ə	 ə i m 'a ɾ ə 
agafant-me	ə ɣ ə f 'a m m ə	 ə ɣ ə f 'a n d m ə 
adonar-se'n	ə ð u n 'a r s ə n	 ə ð u n ə r s 'ɛ n 
aconsegueix	ə k u n s ə ɣ 'ɛ ʃ	 ə k u n s ə ɣ 'e ʃ 
accepto	ə k s 'e p t u	 ə k s 'ɛ p t u 
abstenir-se	ə p s t ə n 'i r s ə	 ə p s t ə n 'i s ə 
Web	b 'e p	 b 'ɛ p 
Verds	b 'ɛ r s	 b 'ɛ r t s 
Torre	t 'o r ə	 t 'ɔ r ə 
Tornes	t 'o r n ə s	 t 'ɔ r n ə s 
Tenen	t 'e n ə n	 t 'ɛ n ə n 
Temps	t 'e m s	 t 'ɛ m p s 
Sabent	s ə β 'ɛ n	 s ə β 'e n 
Ribagorça	r i β ə ɣ 'o r s ə	 r i β ə ɣ 'ɔ r s ə 
Regne	r 'e g n ə	 r 'ɛ g n ə 
Popular	p u p u l 'a r	 p u p u l 'a 
Pallars	p ə ʎ 'a s	 p ə ʎ 'a r s 
Mig	m 'i t ʃ	 m 'i ə 
Me	m 'ə	 m ə 
Llei	ʎ 'e j	 ʎ 'ɛ i 
Hom	'ɔ m	 i 'o 
Hola	'ɔ l ə	 i 'ɔ l ə 
Güell	g w 'e ʎ	 ə w 'e ʎ 
Guerra	g 'ɛ r ə	 g u 'ɛ r ə 
Formes	f 'o r m ə s	 f 'ɔ r m ə s 
Escolti'm	ə s k 'o l t i m	 ə s k u l t 'i m 
Escolta	ə s k 'o l t ə	 ə s k 'ɔ l t ə 
Entro	'e n t ɾ u	 'ɛ n t ɾ u 
Eivissa	ə j β 'i s ə	 ə i β 'i s ə 
Dones	d 'ɔ n ə s	 d 'o n ə s 
Dimecres	d i m 'e k ɾ ə s	 d i m 'ɛ k ɾ ə s 
Descarrega't	d ə s k ə r 'ɛ ɣ ə t	 d ə s k ə r ə ɣ 'a t 
Del	d 'ə l	 d ə l 
Corts	k 'o r s	 k 'o r t s 
Coneix	k u n 'ɛ ʃ	 k u n 'e ʃ 
Cinc	s 'i ŋ	 s 'i ŋ k 
Celoni	s ə l 'ɔ n i	 s ə l 'o n i 
Camps	k 'a m s	 k 'a m p s 
Belgrad	b ə l ɣ ɾ 'a t	 b ə l ɣ ɾ 'a ð 
Balears	b ə l e 'a r s	 b ə l ə 'a s 
Aprendre	ə p 'ɛ n d ɾ ə	 ə p ɾ 'ɛ n d ɾ ə 
Alt	'a l	 'a l t 
per	p 'ə r	 p 'e 
Hi	'i	 i 
De	d 'ə	 d ə 
xops	ʃ 'o p s	 ʃ 'ɔ p s 
vinguessis	b i ŋ g 'e s i s	 b i ŋ g 'ɛ s i s 
tornin	t 'o r n i n	 t 'ɔ r n i n 
titular	t i t u l 'a r	 t i t u l 'a 
tenda	t 'e n d ə	 t 'ɛ n d ə 
tancs	t 'a ŋ s	 t 'a ŋ k s 
suficientment	s u f i s i ə m m 'e n	 s u f i s i ə n ə m 'e n 
sorgeix	s u r ʒ 'ɛ ʃ	 s u r ʒ 'e ʃ 
sers	s 'e r s	 s 'e s 
seguien	s ə ɣ 'i ə n	 s ə ɣ u 'i ə n 
s'esgoten	s ə z ɣ 'o t ə n	 s ə z ɣ 'ɔ t ə n 
rock	r 'ɔ k	 r 'o k k 
revolt	r ə β 'ɔ l	 r ə β 'o ʎ 
retorna	r ə t 'o r n ə	 r ə t 'ɔ r n ə 
resten	r 'e s t ə n	 r 'ɛ s t ə n 
resolt	r ə z 'ɔ l t	 r ə z 'o l t 
resisteix	r ə z i s t 'ɛ ʃ	 r ə z i s t 'e ʃ 
requereix	r ə k ə ɾ 'ɛ ʃ	 r ə k ə ɾ 'e ʃ 
reprendre	r ə p 'ɛ n d ɾ ə	 r ə p ɾ 'ɛ n d ɾ ə 
relacioni	r ə l ə s i 'ɔ n i	 r ə l ə s i 'o n i 
reiterada	r ə i t ə ɾ 'a ð ə	 r ə j t ə ɾ 'a ð ə 
regeix	r ə ʒ 'ɛ ʃ	 r ə ʒ 'e ʃ 
refereix	r ə f ə ɾ 'ɛ ʃ	 r ə f ə ɾ 'e ʃ 
recent	r ə s 'e n	 r ə k 'e n 
rebuig	r ə β 'u t ʃ	 r ə β 'u ʃ 
queixar-se	k ə ʃ 'a r s ə	 k ə ʃ 'a s ə 
presumpte	p ɾ ə z 'u m t ə	 p ɾ ə z 'u m p t ə 
porc	p 'ɔ r k	 p 'o r k 
pop	p 'o p	 p 'ɔ p 
ponts	p 'ɔ n s	 p 'o n s 
plaers	p l ə 'ɛ s	 p l ə 'e s 
persegueix	p ə r s ə ɣ 'ɛ ʃ	 p ə r s ə ɣ 'e ʃ 
pegues	p 'e ɣ ə s	 p 'ɛ ɣ ə s 
paraigua	p ə ɾ 'a j ɣ w ə	 p ə ɾ 'a i ɣ w ə 
ombra	'o m b ɾ ə	 'ɔ m b ɾ ə 
oi	'ɔ j	 'o i 
nèctar	n 'ɛ k t ə r	 n ə k t 'a 
morro	m 'o r u	 m 'ɔ r u 
mor	m 'ɔ r	 m 'o 
molesta	m u l 'e s t ə	 m u l 'ɛ s t ə 
mirar-se	m i ɾ 'a r s ə	 m i ɾ 'a s ə 
militars	m i l i t 'a r s	 m i l i t 'a s 
m'havien	m ə β 'i ə n	 m u ə β 'i ə n 
llet	ʎ 'e t	 ʎ 'ɛ t 
llença	ʎ 'ɛ n s ə	 ʎ 'e n s ə 
lleixes	ʎ 'e ʃ ə s	 ʎ 'ɛ ʃ ə s 
linux	l i n 'u k s	 l i n ʃ 
l'obtenció	l u p t ə n s i 'o	 l u β t ə n s i 'o 
l'existència	l ə g z i s t 'ɛ n s i ə	 l ə k s i s t 'ɛ n s i ə 
irrompre	i r 'o m p ɾ ə	 i r 'ɔ m p ɾ ə 
insistentment	i n s i s t ə m m 'e n	 i n s i s t ə n ə m 'e n 
indústria	i n d 'u s t ɾ i ə	 i n d u s t ɾ 'i ə 
honest	u n 'e s t	 u n 'ɛ s t 
hipnotitza	i b n u t 'i d z ə	 i p n u t 'i d z ə 
himne	'i m n ə	 u 'i m n ə 
fonda	f 'o n d ə	 f 'ɔ n d ə 
fer-te	f 'e r t ə	 f 'ɛ r t ə 
fer-se'n	f 'e r s ə n	 f ə r s 'ɛ n 
feble	f 'e b b l ə	 f 'ɛ b b l ə 
espectacular	ə s p ə k t ə k u l 'a r	 ə s p ə k t ə k u l 'a 
esglésies	ə z ɣ l 'e z i ə s	 ə z ɣ l ə z 'i ə s 
envesteix	ə m b ə s t 'ɛ ʃ	 ə m b ə s t 'e ʃ 
envaeix	ə m b ə 'ɛ ʃ	 ə m b ə 'e ʃ 
entri	'e n t ɾ i	 'ɛ n t ɾ i 
entenguin	ə n t 'e ŋ g i n	 ə n t 'ɛ ŋ g i n 
enrera	ə n r 'e ɾ ə	 ə n 'e ɾ ə 
ema	'e m ə	 'ɛ m ə 
do	d 'ɔ	 d 'o 
distendre	d i s t 'e n d ɾ ə	 d i s t 'ɛ n d ɾ ə 
discuteix	d i s k u t 'ɛ ʃ	 d i s k u t 'e ʃ 
desmai	d ə z m 'a j	 d ə z m 'a i 
descomptes	d ə s k 'o m t ə s	 d ə s k 'ɔ m p t ə s 
descompte	d ə s k 'o m t ə	 d ə s k 'ɔ m p t ə 
desamors	d ə z ə m 'o r s	 d ə z ə m 'o s 
decret	d ə k ɾ 'e t	 d ə k ɾ 'ɛ t 
decideix	d ə s i ð 'ɛ ʃ	 d ə s i ð 'e ʃ 
cuidar	k u j ð 'a	 k u i ð 'a 
corro	k 'o r u	 k 'ɔ r u 
copa	k 'o p ə	 k 'ɔ p ə 
constantment	k u n s t ə m m 'e n	 k u n s t ə n ə m 'e n 
concentren	k u n s 'e n t ɾ ə n	 k u n s 'ɛ n t ɾ ə n 
comptar	k u m t 'a	 k u m p t 'a 
compres	k 'o m p ɾ ə s	 k 'ɔ m p ɾ ə s 
arruinats	ə r u j n 'a t s	 ə r u i n 'a t s 
arrapar-s'hi	ə r ə p 'a r s i	 ə r ə p 'a s i 
amors	ə m 'o r s	 ə m 'o s 
afronta	ə f ɾ 'o n t ə	 ə f ɾ 'ɔ n t ə 
adverteix	ə d b ə r t 'ɛ ʃ	 ə d b ə r t 'e ʃ 
adonar-me'n	ə ð u n 'a r m ə n	 ə ð u n ə r m 'ɛ n 
accepten	ə k s 'e p t ə n	 ə k s 'ɛ p t ə n 
accepta	ə k s 'e p t ə	 ə k s 'ɛ p t ə 
absort	ə p s 'ɔ r t	 ə p s 'o r t 
Ui	'u j	 s i 
Tota	t 'o t ə	 t 'ɔ t ə 
Sistema	s i s t 'e m ə	 s i s t 'ɛ m ə 
Se'm	s 'ə m	 s 'ɛ m 
Ronda	r 'o n d ə	 r 'ɔ n d ə 
Queda	k 'e ð ə	 k 'ɛ ð ə 
Port	p 'ɔ r t	 p 'o r t 
Nord	n 'ɔ r t	 n 'o r 
M'hi	m 'i	 m 'a 
Ginebra	ʒ i n 'e β ɾ ə	 ʒ i n 'ɛ β ɾ ə 
Fonts	f 'ɔ n s	 f 'o n s 
Existeix	ə g z i s t 'ɛ ʃ	 ə g z i s t 'e ʃ 
Error	ə r 'o r	 ə r 'o 
Engega	ə n ʒ 'e ɣ ə	 ə n ʒ 'ɛ ɣ ə 
Deixa	d 'e ʃ ə	 d 'ɛ ʃ ə 
Clos	k l 'ɔ s	 k l 'o s 
Altre	'a l t ɾ ə	 ' a l t ɾ ə 
ítems	'i t ə m s	 i t 'ɛ m s 
àngels	'a n ʒ ə l s	 a n ʒ 'ɛ l s 
que	k 'ə	 k ə 
Us	'u s	 u s 
Que	k 'ə	 k ə 
La	l 'ə	 l ə 
En	'ə n	 ə n 
xopa	ʃ 'o p ə	 ʃ 'ɔ p ə 
xop	ʃ 'o p	 ʃ 'ɔ p 
xeics	ʃ 'ɛ j k s	 ʃ ə 'i k s 
xai	ʃ 'a j	 ʃ 'a i 
web	b 'e p	 b 'ɛ p 
vuitens	b u j t 'ɛ n s	 b u i t 'e n s 
vuitena	b u j t 'ɛ n ə	 b u i t 'ɛ n ə 
vodka	b 'o t k ə	 b 'ɔ ð k ə 
virrei	b i r 'e j	 b i r 'ɛ i 
vingueren	b i ŋ g 'e ɾ ə n	 b i ŋ g u 'ɛ ɾ ə n 
vetlli	b 'e ʎ ʎ i	 b 'ɛ ʎ ʎ i 
vetlles	b 'e ʎ ʎ ə s	 b 'ɛ ʎ ʎ ə s 
vesteix	b ə s t 'ɛ ʃ	 b ə s t 'e ʃ 
vespres	b 'e s p ɾ ə s	 b 'ɛ s p ɾ ə s 
verds	b 'ɛ r s	 b 'ɛ r t s 
verb	b 'ɛ r p	 b 'ɛ r 
vendre'ns	b 'ɛ n d ɾ ə n s	 b ə n d ɾ 'ɛ n s 
vendre'ls	b 'ɛ n d ɾ ə l s	 b ə n d ɾ 'ɛ l s 
venc	b 'ɛ ŋ	 b 'ɛ n s 
vehicle	b ə 'i k l ə	 b ə z 'i k l ə 
valoren	b ə l 'o ɾ ə n	 b ə l 'ɔ ɾ ə n 
valentinenc	b ə l ə n t i n 'ɛ ŋ	 b ə l ə n t i n 'ɛ n s 
vagabund	b ə ɣ ə β 'u n	 b ə ɣ ə β 'u n d 
uniforme	u n i f 'o r m ə	 u n i f 'ɔ r m ə 
tsars	t s 'a r s	 ə s 'a s 
tronxos	t ɾ 'o n ʃ u s	 t ɾ 'ɔ n ʃ u s 
trontolla	t ɾ u n t 'o ʎ ə	 t ɾ u n t 'ɔ ʎ ə 
tron	t ɾ 'ɔ n	 t ɾ 'o n 
tro	t ɾ 'ɔ	 t ɾ 'o 
tresors	t ɾ ə z 'ɔ r s	 t ɾ ə z 'o s 
trepig	t ɾ ə p 'i t ʃ	 t ɾ ə p 'i ɣ 
trasplantessin	t ɾ ə s p l ə n t 'e s i n	 t ɾ ə s p l ə n t 'ɛ s i n 
transoceànic	t ɾ ə n z u s e 'a n i k	 t ɾ ə n s u ə e 'a n i k 
transmetent-me	t ɾ ə n z m ə t 'e m m ə	 t ɾ ə n z m ə t 'ɛ n d m ə 
transitava	t ɾ ə n z i t 'a β ə	 t ɾ ə n s i t 'a β ə 
transició	t ɾ ə n z i s i 'o	 t ɾ ə n s i s i 'o 
transcorre	t ɾ ə n s k 'o r ə	 t ɾ ə n s k 'ɔ r ə 
transcendència	t ɾ ə s ə n d 'ɛ n s i ə	 t ɾ ə n s ə n d 'ɛ n s i ə 
transcendentals	t ɾ ə s ə n d ə n t 'a l s	 t ɾ ə n s ə n d ə n t 'a l s 
transacció	t ɾ ə n z ə k s i 'o	 t ɾ ə n s ə k s i 'o 
tova	t 'o β ə	 t 'ɔ β ə 
totxo	t 'o t ʃ u	 t 'ɔ t ʃ u 
totes	t 'o t ə s	 t 'ɔ t ə s 
tot	t 'o t	 t 'ɔ t 
torre	t 'o r ə	 t 'ɔ r ə 
torneig	t u r n 'ɛ t ʃ	 t u r n 'ɛ ʃ 
torero	t u ɾ 'e ɾ u	 t u ɾ 'ɛ ɾ u 
topen	t 'o p ə n	 t 'ɔ p ə n 
tomba	t 'o m b ə	 t 'ɔ m b ə 
tirar-se	t i ɾ 'a r s ə	 t i ɾ 'a s ə 
tirallongues	t i ɾ ə ʎ 'o ŋ g ə s	 t i ɾ ə ʎ 'ɔ ŋ g ə s 
tirallonga	t i ɾ ə ʎ 'o ŋ g ə	 t i ɾ ə ʎ 'ɔ ŋ g ə 
tinguent	t i ŋ g 'e n	 t i ŋ g w 'e n 
testos	t 'e s t u s	 t 'ɛ s t u s 
testa	t 'e s t ə	 t 'ɛ s t ə 
terraqüi	t ə r 'a k w i	 t ə r 'a k i 
tenor	t ə n 'o r	 t ə n 'o 
tempteig	t ə m t 'ɛ t ʃ	 t ə m p t 'ɛ ʃ 
tecnocientífic	t ə g n u s i ə n t 'i f i k	 t ə k n u s i ə n t 'i f i k 
tecleig	t ə k l 'ɛ t ʃ	 t ə k l 'ɛ ʃ 
te'm	t 'ə m	 t 'ɛ m 
te'l	t 'ə l	 t 'ɛ l 
t'interessa	t i n t ə ɾ 'ɛ s ə	 t i n t ə ɾ 'e s ə 
t'hagis	t 'a ʒ i s	 t 'ɔ ʒ i s 
t'enyoro	t ə ɲ 'o ɾ u	 t ə ɲ 'ɔ ɾ u 
suprimeix	s u p ɾ i m 'ɛ ʃ	 s u p ɾ i m 'e ʃ 
successos	s u k s 'e s u s	 s u k s 'ɛ s u s 
substitueix	s u p s t i t u 'ɛ ʃ	 s u p s t i t u 'e ʃ 
subsisteix	s u p s i s t 'ɛ ʃ	 s u p s i s t 'e ʃ 
subministressin	s u b m i n i s t ɾ 'e s i n	 s u b m i n i s t ɾ 'ɛ s i n 
subhasta	s u β 'a s t ə	 s u β u 'a s t ə 
subgrup	s u b g ɾ 'u p	 s u β ɣ ɾ 'u p 
subgovernador	s u b g u β ə r n ə ð 'o	 s u b ɣ u β ə r n ə ð 'o 
sospesen	s u s p 'e z ə n	 s u s p 'ɛ z ə n 
sospesa	s u s p 'e z ə	 s u s p 'ɛ z ə 
sorrencs	s u r 'ɛ ŋ s	 s u r 'ɛ ŋ k s 
sorprendrà	s u r p ə n d ɾ 'a	 s u r p ɾ ə n d ɾ 'a 
sorprendre	s u r p 'ɛ n d ɾ ə	 s u r p ɾ 'ɛ n d ɾ ə 
sorna	s 'o r n ə	 s 'ɔ r n ə 
sopes	s 'o p ə s	 s 'ɔ p ə s 
sopen	s 'o p ə n	 s 'ɔ p ə n 
sopa	s 'o p ə	 s 'ɔ p ə 
sonors	s u n 'o r s	 s u n 'o s 
sonor	s u n 'o r	 s u n 'o 
sobtada	s u p t 'a ð ə	 s u ə t 'a ð ə 
silvestres	s i l β 'e s t ɾ ə s	 s i l β 'ɛ s t ɾ ə s 
silencioses	s i l ə n s i 'o z ə s	 s i l ə n s i 'o s ə s 
serps	s 'e r p s	 s 'ɛ r p s 
serp	s 'e r p	 s 'ɛ r p 
serens	s ə ɾ 'ɛ n s	 s ə ɾ 'e n s 
ser-ho	s 'e ɾ u	 s 'ɛ ɾ u 
ser-hi	s 'e ɾ i	 s 'ɛ ɾ i 
sentis	s 'e n t i s	 s 'ɛ n t i s 
sentint-me	s ə n t 'i m m ə	 s ə n t 'i n d m ə 
senten	s 'e n t ə n	 s 'ɛ n t ə n 
sempre	s 'e m p ɾ ə	 s 'ɛ m p ɾ ə 
semblessin	s ə m b l 'e s i n	 s ə m b l 'ɛ s i n 
seitons	s ə j t 'o n s	 s ə i t 'o n s 
satisfets	s ə t i s f 'e t s	 s ə t i s f 'ɛ t s 
satisfet	s ə t i s f 'e t	 s ə t i s f 'ɛ t 
sapiens	s ə p i 'ɛ n s	 s ə p i 'e n s 
salpebra	s ə l p 'e β ɾ ə	 s ə l p 'ɛ β ɾ ə 
s'oposen	s u p 'o z ə n	 s u p 'ɔ z ə n 
s'obliden	s u β l 'i ð ə n	 s u p l 'i ð ə n 
s'inverteix	s i m b ə r t 'ɛ ʃ	 s i m b ə r t 'e ʃ 
s'interessa	s i n t ə ɾ 'ɛ s ə	 s i n t ə ɾ 'e s ə 
s'expandeix	s ə k s p ə n d 'ɛ ʃ	 s ə k s p ə n d 'e ʃ 
s'executen	s ə g z ə k 'u t ə n	 s ə k s ə k 'u t ə n 
s'esvaeix	s ə z β ə 'ɛ ʃ	 s ə z β ə 'e ʃ 
s'equivoquen	s ə k i β 'o k ə n	 s ə k i β 'ɔ k ə n 
s'empitjori	s ə m p i d ʒ 'o ɾ i	 s ə m p i d ʒ 'ɔ ɾ i 
s'amaguessin	s ə m ə ɣ 'e s i n	 s ə m ə ɣ 'ɛ s i n 
s'alimenten	s ə l i m 'e n t ə n	 s ə l i m 'ɛ n t ə n 
s'aixequen	s ə ʃ 'e k ə n	 s ə ʃ 'ɛ k ə n 
s'adonen	s ə ð 'o n ə n	 s ə ð 'ɔ n ə n 
s'accedeix	s ə k s ə ð 'ɛ ʃ	 s ə k s ə ð 'e ʃ 
ruixar	r u ʃ 'a	 r u i ʃ 'a 
rotonda	r u t 'o n d ə	 r u t 'ɔ n d ə 
rosses	r 'o s ə s	 r 'ɔ s ə s 
roses	r 'ɔ z ə s	 r 'o z ə s 
ronden	r 'o n d ə n	 r 'ɔ n d ə n 
ronca	r 'o ŋ k ə	 r 'ɔ ŋ k ə 
rodejant-ne	r u ð ə ʒ 'a n n ə	 r u ð ə ʒ 'a n d n ə 
rigor	r i ɣ 'o r	 r i ɣ 'o 
revers	r ə β 'ɛ r s	 r ə β 'e s 
retrets	r ə t ɾ 'e t s	 r ə t ɾ 'ɛ t s 
retard	r ə t 'a r t	 r ə t 'a r 
resseguint	r ə s ə ɣ 'i n	 r ə s ə ɣ u 'i n 
ressegueix	r ə s ə ɣ 'ɛ ʃ	 r ə s ə ɣ 'e ʃ 
responc	r ə s p 'ɔ ŋ	 r ə s p 'o ŋ k 
responc	r ə s p 'ɔ ŋ	 r ə s p 'o ŋ k 
respecto	r ə s p 'e k t u	 r ə s p 'ɛ k t u 
respectessin	r ə s p ə k t 'e s i n	 r ə s p ə k t 'ɛ s i n 
resoldre'ls	r ə z 'ɔ l d ɾ ə l s	 r ə z u l d ɾ 'ɛ l s 
resen	r 'e z ə n	 r 'ɛ z ə n 
reptes	r 'e p t ə s	 r 'ɛ p t ə s 
reproduint-la	r ə p ɾ u ð u 'i n l ə	 r ə p ɾ u ð ɾ i n l ə 
repensar-nos-ho	r ə p ə n s 'a r n u z u	 r ə p ə n s ə r n 'ɔ z u 
reparteix	r ə p ə r t 'ɛ ʃ	 r ə p ə r t 'e ʃ 
renoven	r ə n 'o β ə n	 r ə n 'ɔ β ə n 
renecs	r ə n 'e k s	 r ə n 'ɛ k s 
rendeix	r ə n d 'ɛ ʃ	 r ə n d 'e ʃ 
rencontre	r ə ŋ k 'o n t ɾ ə	 r ə ŋ k 'ɔ n t ɾ ə 
reintegrament	r ə i n t ə ɣ ɾ ə m 'e n	 r ə 'i n t 'ɛ ɣ ɾ ə m 'e n 
regne	r 'e g n ə	 r 'ɛ g n ə 
regla	r 'e g g l ə	 r 'ɛ ɣ l ə 
reflecteix	r ə f l ə k t 'ɛ ʃ	 r ə f l ə k t 'e ʃ 
redueix	r ə ð u 'ɛ ʃ	 r ə ð u 'e ʃ 
redimensioni	r ə ð i m ə n s i 'ɔ n i	 r ə ð i m ə n s i 'o n i 
redemptora	r ə ð ə m t 'o ɾ ə	 r ə ð ə m p t 'o ɾ ə 
recorren	r ə k 'o r ə n	 r ə k 'ɔ r ə n 
records	r ə k 'ɔ r s	 r ə k 'o r t s 
reconeixent-ne	r ə k u n ə ʃ 'e n n ə	 r ə k u n ə ʃ 'ɛ n d n ə 
reconduir-lo	r ə k u n d u 'i r l u	 r ə k u n d z i r l u 
recolzo	r ə k 'o l z u	 r ə k 'ɔ l z u 
recolza	r ə k 'o l z ə	 r ə k 'ɔ l z ə 
receptes	r ə s 'e p t ə s	 r ə s 'ɛ p t ə s 
recents	r ə s 'e n s	 r ə k 'e n s 
rec	r 'e k	 r 'ɛ k 
rebessin	r ə β 'e s i n	 r ə β 'ɛ s i n 
rails	r 'a j l s	 r ə 'i l s 
raigràs	r ə j ɣ ɾ 'a s	 r ə i ɣ ɾ 'a s 
quiosc	k i 'ɔ s k	 k i 'o s k 
quilowatt	k i l u β 'a t	 k i l u β 'a t t 
quieta	k i 'e t ə	 k i 'ɛ t ə 
quedin-se	k 'e ð i n s ə	 k ə ð 'i n s ə 
quedes	k 'e ð ə s	 k 'ɛ ð ə s 
quatrecents	k w ə t ɾ ə s 'e n s	 k w ə t ɾ ə k 'e n s 
pícnic	p 'i g n i k	 p 'i k n i k 
protegir-se	p ɾ u t ə ʒ 'i r s ə	 p ɾ u t ə ʒ 'i s ə 
promocionin	p ɾ u m u s i 'ɔ n i n	 p ɾ u m u s i 'o n i n 
prometre'm	p ɾ u m 'ɛ t ɾ ə m	 p ɾ u m ə t ɾ 'ɛ m 
pretenguin	p ɾ ə t 'e ŋ g i n	 p ɾ ə t 'ɛ ŋ g i n 
pretendre	p ɾ ə t 'e n d ɾ ə	 p ɾ ə t 'ɛ n d ɾ ə 
prest	p ɾ 'e s t	 p ɾ 'ɛ s t 
prescindeix	p ɾ ə s i n d 'ɛ ʃ	 p ɾ ə s i n d 'e ʃ 
preromàntics	p ɾ ə r u m 'a n t i k s	 p ɾ ə ɾ u m 'a n t i k s 
prerafaelites	p ɾ ə r ə f ə e l 'i t ə s	 p ɾ ə ɾ ə f ə ə l 'i t ə s 
prengueren	p ɾ ə ŋ g 'e ɾ ə n	 p ɾ ə ŋ g u 'ɛ ɾ ə n 
prenent-se	p ɾ ə n 'e n s ə	 p ɾ ə n 'ɛ n s ə 
premsa	p ɾ 'e m s ə	 p ɾ 'ɛ m s ə 
precioses	p ɾ ə s i 'o z ə s	 p ɾ ə s i 'o s ə s 
posseeix	p u s ə 'ɛ ʃ	 p u s ə 'e ʃ 
posicioni	p u z i s i 'ɔ n i	 p u z i s i 'o n i 
poses	p 'ɔ z ə s	 p 'o z ə s 
posar-s'hi	p u z 'a r s i	 p u z 'a s i 
posar-nos-hi	p u z 'a r n u z i	 p u z ə r n 'ɔ z i 
posant-ne	p u z 'a n n ə	 p u z 'a n d n ə 
porta-me-les	p 'ɔ r t ə m ə l ə s	 p u r t ə m 'ɛ l ə s 
porro	p 'o r u	 p 'ɔ r u 
poprock	p u p ɾ 'ɔ k	 p u p ɾ 'o k k 
pont	p 'ɔ n	 p 'o n 
podent	p u ð 'ɛ n	 p u ð 'e n 
plumero	p l u m 'e ɾ u	 p l u m 'ɛ ɾ u 
plors	p l 'ɔ s	 p l 'o s 
plantejar-se	p l ə n t ə ʒ 'a r s ə	 p l ə n t ə ʒ 'a s ə 
piscines	p i s 'i n ə s	 p i s k 'i n ə s 
petitburgès	p ə t i d b u r ʒ 'ɛ s	 p ə t i t b u r ʒ 'ɛ s 
pertenences	p ə r t ə n 'ɛ n s ə s	 p ə r t ə n 'e n s ə s 
perpetren	p ə r p 'e t ɾ ə n	 p ə r p 'ɛ t ɾ ə n 
permetre'm	p ə r m 'ɛ t ɾ ə m	 p ə r m ə t ɾ 'ɛ m 
perfectes	p ə r f 'e k t ə s	 p ə r f 'ɛ k t ə s 
perfecta	p ə r f 'e k t ə	 p ə r f 'ɛ k t ə 
pentàgons	p ə n t 'a ɣ u n s	 p ə n t ə ɣ 'o n s 
penjolls	p ə n ʒ 'ɔ ʎ s	 p ə n ʒ 'o ʎ s 
penjo	p 'e n ʒ u	 p 'ɛ n ʒ u 
penetren	p ə n 'e t ɾ ə n	 p ə n 'ɛ t ɾ ə n 
pega	p 'e ɣ ə	 p 'ɛ ɣ ə 
peculiar	p ə k u l i 'a r	 p ə k u l i 'a 
patrimoni	p ə t ɾ i m 'ɔ n i	 p ə t ɾ i m 'o n i 
parteix	p ə r t 'ɛ ʃ	 p ə r t 'e ʃ 
parpelleig	p ə r p ə ʎ 'ɛ t ʃ	 p ə r p ə ʎ 'ɛ ʃ 
paraigüet	p ə ɾ ə j ɣ w 'ɛ t	 p ə ɾ ə j ə w 'ɛ t 
paixtus	p 'a ʃ t u s	 p ə ʃ t 'u s 
ovelles	u β 'ɛ ʎ ə s	 u β 'e ʎ ə s 
orienten	u ɾ i 'e n t ə n	 u ɾ i 'ɛ n t ə n 
orella	u ɾ 'ɛ ʎ ə	 u ɾ 'e ʎ ə 
operen	u p 'e ɾ ə n	 u p 'ɛ ɾ ə n 
oncle	'o ŋ k l ə	 'ɔ ŋ k l ə 
oloro	u l 'o ɾ u	 u l 'ɔ ɾ u 
ofendre's	u f 'ɛ n d ɾ ə s	 u f ə n d ɾ 'ɛ s 
oest	u 'e s t	 u 'ɛ s t 
obtingudes	u p t i ŋ g 'u ð ə s	 u β t i ŋ g 'u ð ə s 
nuclear	n u k l e 'a r	 n u k l e 'a 
nihilistes	n i i l 'i s t ə s	 n i ə l 'i s t ə s 
nihilista	n i i l 'i s t ə	 n i ə l 'i s t ə 
netegessin	n ə t ə ʒ 'e s i n	 n ə t ə ʒ 'ɛ s i n 
nedes	n 'e ð ə s	 n 'ɛ ð ə s 
neden	n 'e ð ə n	 n 'ɛ ð ə n 
neanderthalensis	n e ə n d ə r t ə l 'ɛ n s i s	 n ə ə n d ə t ə l 'ɛ n s i s 
naips	n 'a j p s	 n ə 'i p s 
mosso	m 'o s u	 m 'ɔ s u 
mosca	m 'o s k ə	 m 'ɔ s k ə 
mosaic	m u z 'a j k	 m u z 'a i k 
morses	m 'o r s ə s	 m 'ɔ r s ə s 
morros	m 'o r u s	 m 'ɔ r u s 
mora	m 'ɔ ɾ ə	 m 'o ɾ ə 
mon	m 'u n	 m 'o n 
moll	m 'ɔ ʎ	 m 'o ʎ 
molest	m u l 'e s t	 m u l 'ɛ s t 
millorin	m i ʎ 'o ɾ i n	 m i ʎ 'ɔ ɾ i n 
metros	m 'e t ɾ u s	 m 'ɛ t ɾ u s 
metgessa	m ə d ʒ 'ɛ s ə	 m ə d ʒ 'e s ə 
menjar-se	m ə n ʒ 'a r s ə	 m ə n ʒ 'a s ə 
mengi	m 'e n ʒ i	 m 'ɛ n ʒ i 
marxessin	m ə r ʃ 'e s i n	 m ə r ʃ 'ɛ s i n 
marcint-me	m ə r s 'i m m ə	 m ə r s 'i n d m ə 
manifesta	m ə n i f 'e s t ə	 m ə n i f 'ɛ s t ə 
maneig	m ə n 'ɛ t ʃ	 m ə n 'ɛ ʃ 
malsons	m ə l s 'ɔ n s	 m ə l s 'o n s 
ma	m 'ə	 m ə 
m'hagis	m 'a ʒ i s	 m i 'a ʒ i s 
m'avorreix	m ə β u r 'ɛ ʃ	 m ə β u r 'e ʃ 
lluirà	ʎ u i ɾ 'a	 ʎ u j ɾ 'a 
lloses	ʎ 'ɔ z ə s	 ʎ 'o z ə s 
llesta	ʎ 'e s t ə	 ʎ 'ɛ s t ə 
lleopards	ʎ ə u p 'a r s	 ʎ ə u p 'a ɾ i s 
llenya	ʎ 'e ɲ ə	 ʎ 'ɛ ɲ ə 
llengües	ʎ 'e ŋ g w ə s	 ʎ 'ɛ ŋ g w ə s 
llegendes	ʎ ə ʒ 'e n d ə s	 ʎ ə ʒ 'ɛ n d ə s 
lepra	l 'e p ɾ ə	 l 'ɛ p ɾ ə 
lamento	l ə m 'e n t u	 l ə m 'ɛ n t u 
labor	l ə β 'o r	 l ə β 'o 
l'àguila	l 'a ɣ i l ə	 l 'a ɣ u i l ə 
l'interessa	l i n t ə ɾ 'ɛ s ə	 l i n t ə ɾ 'e s ə 
l'exigència	l ə g z i ʒ 'ɛ n s i ə	 l ə k s i ʒ 'ɛ n s i ə 
l'excés	l ə k s 'e s	 l ə k s s 'e s 
l'exaltació	l ə g z ə l t ə s i 'o	 l ə k s ə l t ə s i 'o 
l'espurneig	l ə s p u r n 'ɛ t ʃ	 l ə s p u r n 'ɛ ʃ 
l'esguerro	l ə z ɣ 'ɛ r u	 l ə z ɣ u 'ɛ r u 
l'engoleix	l ə ŋ g u l 'ɛ ʃ	 l ə ŋ g u l 'e ʃ 
l'avorreix	l ə β u r 'ɛ ʃ	 l ə β u r 'e ʃ 
l'ascens	l ə s 'ɛ n s	 l ə s k 'e n s 
l'algebraic	l ə l ʒ ə β ɾ 'a j k	 l ə l ʒ ə β ɾ 'a i k 
l'aguait	l ə ɣ w 'a j t	 l ə ɣ w ə 'i t 
l'adequada	l ə ð ə k w 'a ð ə	 l ə ð ə k 'a ð ə 
l'Univers	l u n i β 'ɛ r s	 l u n i β 'e s 
l'Espai	l ə s p 'a j	 l ə s p 'a i 
l'Antoni	l ə n t 'ɔ n i	 l ə n t 'o n i 
kuwaitians	k u β ə j t i 'a n s	 k u β ə i t i 'a n s 
kafkiana	k ə f k i 'a n ə	 k ə f i i 'a n ə 
jueva	ʒ u 'e β ə	 ʒ u 'ɛ β ə 
jamaicans	ʒ ə m ə j k 'a n s	 ʒ ə m ə i k 'a n s 
israelià	i z r ə e l i 'a	 i z r ə ə l i 'a 
intèrpret	i n t 'ɛ r p ɾ ə t	 i n t ə r p ɾ 'ɛ t 
intrínsecs	i n t ɾ 'i n s ə k s	 i n t ɾ i n s 'ɛ k s 
introduir-lo	i n t ɾ u ð u 'i r l u	 i n t ɾ u ð ɾ i r l u 
introdueix	i n t ɾ u ð u 'ɛ ʃ	 i n t ɾ u ð u 'e ʃ 
interrompre	i n t ə r 'o m p ɾ ə	 i n t ə r 'ɔ m p ɾ ə 
interrogant-los	i n t ə r u ɣ 'a n l u s	 i n t ə r u ɣ ə n l 'ɔ s 
insisteix	i n s i s t 'ɛ ʃ	 i n s i s t 'e ʃ 
insatisfets	i n s ə t i s f 'e t s	 i n s ə t i s f 'ɛ t s 
insatisfeta	i n s ə t i s f 'e t ə	 i n s ə t i s f 'ɛ t ə 
inquiets	i ŋ k i 'e t s	 i ŋ k i 'ɛ t s 
ingresses	i ŋ g ɾ 'e s ə s	 i ŋ g ɾ 'ɛ s ə s 
inconscientment	i ŋ k u n s i ə m m 'e n	 i ŋ k u n s i ə n ə m 'e n 
incerts	i n s 'ɛ r s	 i n s 'ɛ r t s 
import	i m p 'ɔ r t	 i m p 'o r t 
imperfecte	i m p ə r f 'e k t ə	 i m p ə r f 'ɛ k t ə 
igualar	i ɣ w ə l 'a	 i ɣ u ə l 'a 
ignoren	i g n 'o ɾ ə n	 i g n 'ɔ ɾ ə n 
idoni	i ð 'ɔ n i	 i ð 'o n i 
hòstia	'ɔ s t i ə	 u s t i ə 
híbrid	'i β ɾ i t	 ə β ɾ i ð 
hàbit	'a β i t	 ə β i t 
horts	'ɔ r s	 i 'o t s 
hora	'ɔ ɾ ə	 i 'o ɾ ə 
honor	u n 'o r	 u u n 'o 
hola	'ɔ l ə	 i 'ɔ l ə 
himnes	'i m n ə s	 u 'i m n ə s 
haguessis	ə ɣ 'e s i s	 ə ɣ 'ɛ s i s 
haguessin	ə ɣ 'e s i n	 ə ɣ 'ɛ s i n 
hagis	'a ʒ i s	 i 'a ʒ i s 
guspires	g u s p 'i ɾ ə s	 g s p 'i ɾ ə s 
guspira	g u s p 'i ɾ ə	 g s p 'i ɾ ə 
guinguetes	g i ŋ g 'ɛ t ə s	 g i ŋ g u 'ɛ t ə s 
guinda	g 'i n d ə	 g u 'i n d ə 
guanyant-me	g w ə ɲ 'a m m ə	 g w ə ɲ 'a n d m ə 
groguenc	g ɾ u ɣ 'ɛ ŋ	 g ɾ u ɣ u 'ɛ n s 
greixos	g ɾ 'e ʃ u s	 g ɾ 'ɛ ʃ u s 
golfo	g 'o l f u	 g 'ɔ l f u 
gestos	ʒ 'e s t u s	 ʒ 'ɛ s t u s 
gesta	ʒ 'e s t ə	 ʒ 'ɛ s t ə 
generen	ʒ ə n 'e ɾ ə n	 ʒ ə n 'ɛ ɾ ə n 
gemecs	ʒ ə m 'e k s	 ʒ ə m 'ɛ k s 
gemec	ʒ ə m 'e k	 ʒ ə m 'ɛ k 
gairell	g ə j ɾ 'e ʎ	 g ə i ɾ 'e ʎ 
férem	f 'e ɾ ə m	 f ə ɾ 'ɛ m 
fuig	f 'u t ʃ	 f 'u ʃ 
freqüentment	f ɾ ə k w ə m m 'e n	 f ɾ ə k w ə n ə m 'e n 
frens	f ɾ 'ɛ n s	 f ɾ 'e n s 
frankfurt	f ɾ ə ŋ k f 'u r t	 f ɾ ə n ə f 'u r t 
fots	f 'o t s	 f 'ɔ t s 
fotre-li	f 'o t ɾ ə l i	 f u t ɾ 'ɛ l i 
fot	f 'o t	 f 'ɔ t 
formi	f 'o r m i	 f 'ɔ r m i 
foques	f 'o k ə s	 f 'ɔ k ə s 
floringuelles	f l u ɾ i ŋ g 'e ʎ ə s	 f l u ɾ i ŋ g u 'e ʎ ə s 
fletxes	f l 'e t ʃ ə s	 f l 'ɛ t ʃ ə s 
fletxa	f l 'e t ʃ ə	 f l 'ɛ t ʃ ə 
flamencs	f l ə m 'ɛ ŋ s	 f l ə m 'ɛ ŋ k s 
flamenc	f l ə m 'ɛ ŋ	 f l ə m 'ɛ n s 
fixi's	f 'i k s i s	 f i k s 'i s 
fiquessin	f i k 'e s i n	 f i k 'ɛ s i n 
finestra	f i n 'e s t ɾ ə	 f i n 'ɛ s t ɾ ə 
ficar-s'hi	f i k 'a r s i	 f i k 'a s i 
fer-lo	f 'e r l u	 f 'ɛ r l u 
fer-hi	f 'e ɾ i	 f 'ɛ ɾ i 
fent-se	f 'e n s ə	 f 'ɛ n s ə 
fent-lo	f 'e n l u	 f 'ɛ n l u 
fen	f 'e n	 f 'ɛ n 
feldspat	f ə l t s p 'a t	 f ə l s p 'a t 
feixos	f 'e ʃ u s	 f 'ɛ ʃ u s 
favor	f ə β 'o r	 f ə β 'o 
familiar	f ə m i l i 'a r	 f ə m i l i 'a 
exàmens	ə g z 'a m ə n s	 ə k s 'a m ə n s 
extret	ə k s t ɾ 'e t	 ə k s t ɾ 'ɛ t 
extrems	ə k s t ɾ 'e m s	 ə k s t ɾ 'ɛ m s 
exteriors	ə k s t ə ɾ i 'o r s	 ə k s t ə ɾ i 'o s 
extens	ə k s t 'ɛ n s	 ə k s t 'e n s 
expliquessin	ə k s p l i k 'e s i n	 ə k s p l i k 'ɛ s i n 
explicant-me	ə k s p l i k 'a m m ə	 ə k s p l i k 'a n d m ə 
explicant-los	ə k s p l i k 'a n l u s	 ə k s p l i k ə n l 'ɔ s 
experts	ə k s p 'ɛ r s	 ə k s p 'ɛ r t s 
exjugador	ə g ʒ u ɣ ə ð 'o	 ə k s ʒ u ɣ ə ð 'o 
exigent	ə g z i ʒ 'e n	 ə k s i ʒ 'e n 
exerceix	ə g z ə r s 'ɛ ʃ	 ə g z ə r k 'e ʃ 
exemples	ə g z 'e m p l ə s	 ə k s 'ɛ m p l ə s 
exemplar	ə g z ə m p l 'a r	 ə g z ə m p l 'a 
executa	ə g z ə k 'u t ə	 ə k s ə k 'u t ə 
examinar-les	ə g z ə m i n 'a r l ə s	 ə k s ə m i n 'a r l ə s 
evolucioni	ə β u l u s i 'ɔ n i	 ə β u l u s i 'o n i 
estómac	ə s t 'o m ə k	 ə s t u m 'a k 
estudiïn	ə s t u ð 'i i n	 ə s t u ð i 'i n 
estrenyent-me	ə s t ɾ ə ɲ 'e m m ə	 ə s t ɾ ə ɲ 'ɛ n d m ə 
estiueja	ə s t i w 'ɛ ʒ ə	 ə s t i u 'ɛ ʒ ə 
establerts	ə s t ə b b l 'ɛ r s	 ə s t ə b b l 'ɛ r t s 
esport	ə s p 'ɔ r t	 ə s p 'o r t 
esplèndid	ə s p l 'ɛ n d i t	 ə s p l 'ɛ n d i ð 
espessa	ə s p 'ɛ s ə	 ə s p 'e s ə 
espero	ə s p 'e ɾ u	 ə s p 'ɛ ɾ u 
esperessis	ə s p ə ɾ 'e s i s	 ə s p ə ɾ 'ɛ s i s 
esperessin	ə s p ə ɾ 'e s i n	 ə s p ə ɾ 'ɛ s i n 
esperant-los	ə s p ə ɾ 'a n l u s	 ə s p ə ɾ ə n l 'ɔ s 
esmunyir-se	ə z m u ɲ 'i r s ə	 ə z m u ɲ 'i s ə 
esmicola	ə z m i k 'o l ə	 ə z m i k 'ɔ l ə 
esment	ə z m 'e n	 e z m 'e n 
esgrogueït	ə z ɣ ɾ u ɣ ə 'i t	 ə z ɣ ɾ u ɣ u ə 'i t 
esgrogueint-se	ə z ɣ ɾ u ɣ ə 'i n s ə	 ə z ɣ ɾ u ɣ u ə 'i n s ə 
esglai	ə z ɣ l 'a j	 ə z ə l 'a i 
esfinx	ə s f 'i n ʃ	 ə s f 'i n 
escombra	ə s k 'o m b ɾ ə	 ə s k 'ɔ m b ɾ ə 
escolto	ə s k 'o l t u	 ə s k 'ɔ l t u 
escolti'm	ə s k 'o l t i m	 ə s k u l t 'i m 
escolti	ə s k 'o l t i	 ə s k 'ɔ l t i 
escoltes	ə s k 'o l t ə s	 ə s k 'ɔ l t ə s 
escaigui	ə s k 'a j ɣ i	 ə s k 'a i ɣ i 
enviïn	ə m b 'i i n	 ə m b i 'i n 
envers	ə m b 'ɛ r s	 ə m b 'e s 
enuig	ə n 'u t ʃ	 ə n 'u ʃ 
entretenir-se	ə n t ɾ ə t ə n 'i r s ə	 ə n t ɾ ə t ə n 'i s ə 
enter	ə n t 'e r	 ə n t 'e 
entendre'n	ə n t 'e n d ɾ ə n	 ə n t ə n d ɾ 'ɛ n 
enlairar-se	ə n l ə j ɾ 'a r s ə	 ə n l ə i ɾ 'a s ə 
engego	ə n ʒ 'e ɣ u	 ə n ʒ 'ɛ ɣ u 
engega	ə n ʒ 'e ɣ ə	 ə n ʒ 'ɛ ɣ ə 
endreço	ə n d ɾ 'e s u	 ə n d ɾ 'ɛ s u 
empentes	ə m p 'ɛ n t ə s	 ə m p 'e n t ə s 
empenta	ə m p 'ɛ n t ə	 ə m p 'e n t ə 
emborratxant-me	ə m b u r ə t ʃ 'a m m ə	 ə m b u r ə t ʃ 'a n d m ə 
elèctrica	ə l 'ɛ k t ɾ i k ə	 ə l ə k t ɾ 'i k ə 
elabori	ə l ə β 'o ɾ i	 ə l ə β 'ɔ ɾ i 
eixos	'e ʃ u s	 'ɛ ʃ u s 
eivissencs	ə j β i s 'ɛ ŋ s	 ə j β i s 'ɛ ŋ k s 
dèficits	d 'ɛ f i s i t s	 d ə f i s 'i t s 
duo	d 'u o	 d 'u u 
dorm	d 'ɔ r m	 d 'o r m 
doni'm	d 'o n i m	 d u n 'i m 
donessin	d u n 'e s i n	 d u n 'ɛ s i n 
donant-nos	d u n 'a n n u s	 d u n 'a n d n u s 
donant-los	d u n 'a n l u s	 d u n ə n l 'ɔ s 
docent	d u s 'e n	 d u k 'e n 
dobla	d 'o b b l ə	 d 'ɔ b b l ə 
divuitè	d i β u j t 'ɛ	 d i β u i t 'ɛ 
divuitena	d i β u j t 'ɛ n ə	 d i β u i t 'ɛ n ə 
dividir-se	d i β i ð 'i r s ə	 d i β i ð 'i s ə 
dissoldre's	d i s 'ɔ l d ɾ ə s	 d i s u l d ɾ 'ɛ s 
disruptor	d i z r u p t 'o	 d i s u p t 'o 
disposo	d i s p 'o z u	 d i s p 'ɔ z u 
disfressa	d i s f ɾ 'ɛ s ə	 d i s f ɾ 'e s ə 
discretes	d i s k ɾ 'e t ə s	 d i s k ɾ 'ɛ t ə s 
discrepo	d i s k ɾ 'e p u	 d i s k ɾ 'ɛ p u 
discrepi	d i s k ɾ 'e p i	 d i s k ɾ 'ɛ p i 
dirigeixi's	d i ɾ i ʒ 'ɛ ʃ i s	 d i ɾ i ʒ ə ʃ 'i s 
digueren	d i ɣ 'e ɾ ə n	 d i ɣ u 'ɛ ɾ ə n 
difereix	d i f ə ɾ 'ɛ ʃ	 d i f ə ɾ 'e ʃ 
dient-se	d i 'e n s ə	 d i 'ɛ n s ə 
dibuixant-me	d i β u ʃ 'a m m ə	 d i β u ʃ 'a n d m ə 
detesto	d ə t 'e s t u	 d ə t 'ɛ s t u 
detecta	d ə t 'e k t ə	 d ə t 'ɛ k t ə 
destrueix	d ə s t ɾ u 'ɛ ʃ	 d ə s t ɾ u 'e ʃ 
destorb	d ə s t 'o r p	 d ə s t 'o r 
desigs	d ə z 'i t ʃ s	 d ə z 'i g s 
desfer-li	d ə s f 'e r l i	 d ə s f 'ɛ r l i 
desesper	d ə z ə s p 'e r	 d ə z ə s p 'e 
desemboca	d ə z ə m b 'o k ə	 d ə z ə m b 'ɔ k ə 
desamor	d ə z ə m 'o r	 d ə z ə m 'o 
desacord	d ə z ə k 'ɔ r t	 d ə z ə k 'o r t 
demanar-nos-ho	d ə m ə n 'a r n u z u	 d ə m ə n ə r n 'ɔ z u 
deltaic	d ə l t 'a j k	 d ə l t 'a i k 
delinqüents	d ə l i ŋ k w 'e n s	 d ə l i n ə w 'e n s 
deixis	d 'e ʃ i s	 d 'ɛ ʃ i s 
deixi'm	d 'e ʃ i m	 d ə ʃ 'i m 
deixessin	d ə ʃ 'e s i n	 d ə ʃ 'ɛ s i n 
deixes	d 'e ʃ ə s	 d 'ɛ ʃ ə s 
deixant-me	d ə ʃ 'a m m ə	 d ə ʃ 'a n d m ə 
deixa't	d 'e ʃ ə t	 d ə ʃ 'a t 
deixa'm	d 'e ʃ ə m	 d ə ʃ 'a m 
defineix	d ə f i n 'ɛ ʃ	 d ə f i n 'e ʃ 
deessa	d ə 'ɛ s ə	 d ə 'e s ə 
decrets	d ə k ɾ 'e t s	 d ə k ɾ 'ɛ t s 
decidir-se	d ə s i ð 'i r s ə	 d ə s i ð 'i s ə 
d'intèrpret	d i n t 'ɛ r p ɾ ə t	 d i n t ə r p ɾ 'ɛ t 
d'exotisme	d ə g z u t 'i z m ə	 d ə k s u t 'i z m ə 
d'esplai	d ə s p l 'a j	 d ə s p l 'a i 
d'espais	d ə s p 'a j s	 d ə s p 'a i s 
d'espagueti	d ə s p ə ɣ 'ɛ t i	 d ə s p ə ɣ u 'ɛ t i 
d'eines	d 'ɛ j n ə s	 d 'ɛ i n ə s 
d'apropar-s'hi	d ə p ɾ u p 'a r s i	 d ə p ɾ u p 'a s i 
d'aparells	d ə p ə ɾ 'ɛ ʎ s	 d ə p ə ɾ 'e ʎ s 
d'aparell	d ə p ə ɾ 'ɛ ʎ	 d ə p ə ɾ 'e ʎ 
d'afeitar	d ə f ə j t 'a	 d ə f ə i t 'a 
d'adrianenc	d ə ð ɾ i ə n 'ɛ ŋ	 d ə ð ɾ i ə n 'ɛ n s 
còmplices	k 'ɔ m p l i s ə s	 k u m p l 'i s ə s 
cuinés	k u j n 'e s	 k u i n 'e s 
cuinera	k u j n 'e ɾ ə	 k u i n 'e ɾ ə 
cuinar	k u j n 'a	 k u i n 'a 
cuidava	k u j ð 'a β ə	 k u i ð 'a β ə 
cuidant	k u j ð 'a n	 k u i ð 'a n 
cruixeix	k ɾ u ʃ 'ɛ ʃ	 k ɾ u ʃ 'e ʃ 
cromos	k ɾ 'o m u s	 k ɾ 'ɔ m u s 
creïn	k ɾ 'e i n	 k ɾ ə 'i n 
cremes	k ɾ 'e m ə s	 k ɾ 'ɛ m ə s 
cremen	k ɾ 'e m ə n	 k ɾ 'ɛ m ə n 
crema	k ɾ 'e m ə	 k ɾ 'ɛ m ə 
creessin	k ɾ ə 'e s i n	 k ɾ ə 'ɛ s i n 
creades	k ɾ e 'a ð ə s	 k ə e 'a ð ə s 
cosinus	k u s 'i n u s	 k u z 'i n u s 
cosa	k 'ɔ z ə	 k 'o z ə 
cos	k 'ɔ s	 k 'o s 
cors	k 'ɔ r s	 k 'o s 
convèncer	k u m b 'ɛ n s ə	 k u m b 'ɛ n s ə r 
convidant-los	k u m b i ð 'a n l u s	 k u m b i ð ə n l 'ɔ s 
convertir-se	k u m b ə r t 'i r s ə	 k u m b ə r t 'i s ə 
continuessin	k u n t i n u 'e s i n	 k u n t i n u 'ɛ s i n 
contesto	k u n t 'e s t u	 k u n t 'ɛ s t u 
contenen	k u n t 'e n ə n	 k u n t 'ɛ n ə n 
construeix	k u n s t ɾ u 'ɛ ʃ	 k u n s t ɾ u 'e ʃ 
consta	k 'o n s t ə	 k 'ɔ n s t ə 
consisteix	k u n s i s t 'ɛ ʃ	 k u n s i s t 'e ʃ 
considero	k u n s i ð 'e ɾ u	 k u n s i ð 'ɛ ɾ u 
conques	k 'o ŋ k ə s	 k 'ɔ ŋ k ə s 
connecta	k u n n 'e k t ə	 k u n n 'ɛ k t ə 
condemna	k u n d 'e m n ə	 k u n d 'ɛ m n ə 
comptem	k u m t 'ɛ m	 k u m p t 'ɛ m 
completa-la	k u m p l 'ɛ t ə l ə	 k u m p l ə t 'a l ə 
complaença	k u m p l ə 'ɛ n s ə	 k u m p l ə 'e n s ə 
comparsero	k u m p ə r s 'e ɾ u	 k u m p ə r s 'ɛ ɾ u 
compareixença	k u m p ə ɾ ə ʃ 'ɛ n s ə	 k u m p ə ɾ ə ʃ 'e n s ə 
comences	k u m 'ɛ n s ə s	 k u m 'e n s ə s 
coloraines	k u l u ɾ 'a j n ə s	 k u l u ɾ 'a i n ə s 
coixa	k 'o ʃ ə	 k 'ɔ ʃ ə 
coincideix	k u i n s i ð 'ɛ ʃ	 k u i n s i ð 'e ʃ 
coherents	k u ə ɾ 'e n s	 k u β ə ɾ 'e n s 
cofoi	k u f 'ɔ j	 k u f 'o i 
coco	k 'o k u	 k 'ɔ k u 
clor	k l 'ɔ r	 k l 'o 
cercles	s 'e r k l ə s	 s 'ɛ r k l ə s 
centígrads	s ə n t 'i ɣ ɾ ə t s	 s ə n t i ɣ ɾ 'a ð s 
centelleig	s ə n t ə ʎ 'ɛ t ʃ	 s ə n t ə ʎ 'ɛ ʃ 
celebren	s ə l 'e β ɾ ə n	 s ə l 'ɛ β ɾ ə n 
cec	s 'e k	 s 'ɛ k 
caràcters	k ə ɾ 'a k t ə r s	 k ə ɾ ə k t 'e s 
cards	k 'a r s	 k 'a r t s 
carai	k ə ɾ 'a j	 k ə ɾ 'a i 
car	k 'a r	 k 'a 
capvespre	k ə b b 'e s p ɾ ə	 k ə p b 'ɛ s p ɾ ə 
capgirat	k ə b ʒ i ɾ 'a t	 k ə p ʒ i ɾ 'a t 
capbussar	k ə b b u s 'a	 k ə p b u s 'a 
cantimplora	k ə n t i m p l 'ɔ ɾ ə	 k ə n t i m p l 'o ɾ ə 
cangur	k ə ŋ g 'u r	 k ə ŋ g 'u 
búnquers	b 'u ŋ k ə r s	 b u ŋ k 'ɛ r s 
buldòzer	b u l d 'ɔ z ə	 b u l d 'ɔ z ə r 
buidor	b u j ð 'o	 b u i ð 'o 
buidar-la	b u j ð 'a r l ə	 b u i ð 'a r l ə 
brots	b ɾ 'o t s	 b ɾ 'ɔ t s 
brollen	b ɾ 'o ʎ ə n	 b ɾ 'ɔ ʎ ə n 
botes	b 'o t ə s	 b 'ɔ t ə s 
bot	b 'o t	 b 'ɔ t 
bons	b 'ɔ n s	 b 'o n s 
bombolles	b u m b 'o ʎ ə s	 b u m b 'ɔ ʎ ə s 
bolquen	b 'o l k ə n	 b 'ɔ l k ə n 
boirina	b u j ɾ 'i n ə	 b u i ɾ 'i n ə 
bo	b 'ɔ	 b 'o 
bes	b 'e s	 b 'ɛ s 
beneeix	b ə n ə 'ɛ ʃ	 b ə n ə 'e ʃ 
bateig	b ə t 'ɛ t ʃ	 b ə t 'ɛ ʃ 
bable	b 'a β l ə	 b 'a b b l ə 
atribuir-ho	ə t ɾ i β u 'i ɾ u	 ə t ɾ i β 'u j ɾ u 
assisteix	ə s i s t 'ɛ ʃ	 ə s i s t 'e ʃ 
assaigs	ə s 'a t ʃ s	 ə s ə 'i ə s 
assaborint-ne	ə s ə β u ɾ 'i n n ə	 ə s ə β u ɾ 'i n d n ə 
asimètrica	ə s i m 'ɛ t ɾ i k ə	 ə z i m 'ɛ t ɾ i k ə 
arribessin	ə r i β 'e s i n	 ə r i β 'ɛ s i n 
arreglava	ə r ə g g l 'a β ə	 ə r ə ɣ l 'a β ə 
arreglar-hi	ə r ə g g l 'a ɾ i	 ə r ə ɣ l 'a ɾ i 
arreglar	ə r ə g g l 'a	 ə r ə ɣ l 'a 
arregla	ə r 'e g g l ə	 ə r 'ɛ ɣ l ə 
aproven	ə p ɾ 'o β ə n	 ə p ɾ 'ɔ β ə n 
apretar-me-les	ə p ɾ ə t 'a r m ə l ə s	 ə p ɾ ə t ə r m 'ɛ l ə s 
aportessin	ə p u r t 'e s i n	 ə p u r t 'ɛ s i n 
aparegueren	ə p ə ɾ ə ɣ 'e ɾ ə n	 ə p ə ɾ ə ɣ u 'ɛ ɾ ə n 
anècdota	ə n 'ɛ g d u t ə	 ə n ə g d 'ɔ t ə 
anguiles	ə ŋ g 'i l ə s	 ə ŋ g u 'i l ə s 
angoixa	ə ŋ g 'o ʃ ə	 ə ŋ g 'ɔ ʃ ə 
anglosaxons	ə ŋ g l u s ə k s 'o n s	 ə ŋ g l u z ə k s 'o n s 
anessin	ə n 'e s i n	 ə n 'ɛ s i n 
anar-se-la	ə n 'a r s ə l ə	 ə n ə r s 'ɛ l ə 
anar-se'n	ə n 'a r s ə n	 ə n ə r s 'ɛ n 
ambigüitats	ə m b i ɣ w i t 'a t s	 ə m b i ɣ i t 'a t s 
ambdós	ə m d 'o s	 ə m b d 'o s 
ambdues	ə m d 'u ə s	 ə m b d 'u ə s 
alteren	ə l t 'e ɾ ə n	 ə l t 'ɛ ɾ ə n 
allotjar-se	ə ʎ u d ʒ 'a r s ə	 ə ʎ u d ʒ 'a s ə 
alletin	ə ʎ 'e t i n	 ə ʎ 'ɛ t i n 
algebraic	ə l ʒ ə β ɾ 'a j k	 ə l ʒ ə β ɾ 'a i k 
alegre	ə l 'e ɣ ɾ ə	 ə l 'ɛ ɣ ɾ ə 
aixeco	ə ʃ 'e k u	 ə ʃ 'ɛ k u 
aixeca	ə ʃ 'e k ə	 ə ʃ 'ɛ k ə 
aiguamolls	ə j ɣ w ə m 'ɔ ʎ s	 ə j ɣ u ə m 'o ʎ s 
aigualida	ə j ɣ w ə l 'i ð ə	 ə j ɣ u ə l 'i ð ə 
aiguaforts	ə j ɣ w ə f 'ɔ r s	 ə j ɣ w ə f 'o r t s 
aguaitar	ə ɣ w ə j t 'a	 ə ɣ w ə i t 'a 
agrupa'ls	ə ɣ ɾ 'u p ə l s	 ə ɣ ɾ u p 'a l s 
agrair-li	ə ɣ ɾ ə 'i r l i	 ə ɣ ɾ 'a i r l i 
agraeix	ə ɣ ɾ ə 'ɛ ʃ	 ə ɣ ɾ ə 'e ʃ 
agafessin	ə ɣ ə f 'e s i n	 ə ɣ ə f 'ɛ s i n 
afruitat	ə f ɾ u j t 'a t	 ə f ɾ u i t 'a t 
afecten	ə f 'e k t ə n	 ə f 'ɛ k t ə n 
afecte	ə f 'e k t ə	 ə f 'ɛ k t ə 
afavoreix	ə f ə β u ɾ 'ɛ ʃ	 ə f ə β u ɾ 'e ʃ 
aeròdroms	ə e ɾ 'ɔ ð ɾ u m s	 ə ə ɾ 'ɔ ð ɾ u m s 
adorns	ə ð 'o r n s	 ə ð 'o n s 
adornen	ə ð 'o r n ə n	 ə ð 'ɔ r n ə n 
adequar	ə ð ə k w 'a	 ə ð ə k 'a 
adequades	ə ð ə k w 'a ð ə s	 ə ð ə k 'a ð ə s 
adequa	ə ð 'e k w ə	 ə ð 'ɛ k w ə 
acords	ə k 'ɔ r s	 ə k 'o r t s 
aconsellen	ə k u n s 'e ʎ ə n	 ə k u n s 'ɛ ʎ ə n 
aconseguir-la	ə k u n s ə ɣ 'i r l ə	 ə k u n s ə ɣ u 'i r l ə 
aconseguint	ə k u n s ə ɣ 'i n	 ə k u n s ə ɣ u 'i n 
acompleix	ə k u m p l 'ɛ ʃ	 ə k u m p l 'e ʃ 
acomiadar-se	ə k u m i ə ð 'a r s ə	 ə k u m i ə ð 'a s ə 
a	'ə	 ə 
Zürich	z u ɾ 'i k	 ə w ɾ 'i k u 
Zagreb	z ə ɣ ɾ 'e p	 z ə ɣ ɾ 'ɛ p 
Xop	ʃ 'o p	 ʃ 'ɔ p 
Webs	b 'e p s	 b 'ɛ p s 
Vicent	b i s 'ɛ n	 b i k 'e n 
Vermella	b ə r m 'ɛ ʎ ə	 b ə r m 'e ʎ ə 
Ve	b 'e	 b 'ɛ 
Vailets	b ə j l 'ɛ t s	 b ə i l 'ɛ t s 
Ulldemol	u ʎ d ə m 'ɔ l	 u ʎ ð ə m 'ɔ l 
Trodheim	t ɾ u ð 'ɛ j m	 t ɾ u ð u 'i m 
Tret	t ɾ 'e t	 t ɾ 'ɛ t 
Transports	t ɾ ə n s p 'ɔ r s	 t ɾ ə n s p 'o r t s 
Transport	t ɾ ə n s p 'ɔ r t	 t ɾ ə n s p 'o r t 
Tort	t 'ɔ r t	 t 'o r t 
Torno	t 'o r n u	 t 'ɔ r n u 
Torni	t 'o r n i	 t 'ɔ r n i 
Ton	t 'u n	 t 'o n 
Ter	t 'e r	 t 'e 
Tema	t 'e m ə	 t 'ɛ m ə 
Tecnològic	t ə g n u l 'ɔ ʒ i k	 t ə k n u l 'ɔ ʒ i k 
Tecnologia	t ə g n u l u ʒ 'i ə	 t ə k n u l u ʒ 'i ə 
Te'n	t 'ə n	 t 'ɛ n 
Te	t 'ə	 t ə 
Taipei	t ə j p 'ɛ j	 t ə i p 'ɛ i 
Tailàndia	t ə j l 'a n d i ə	 t ə i l 'a n d i ə 
T'ho	t 'u	 t 'a 
Sobre	s 'o β ɾ ə	 s 'ɔ β ɾ ə 
Sistemes	s i s t 'e m ə s	 s i s t 'ɛ m ə s 
Sistema	s i s t 'e m ə	 s i s t 'ɛ m ə 
Se'l	s 'ə l	 s 'ɛ l 
Saqueig	s ə k 'ɛ t ʃ	 s ə k 'ɛ ʃ 
Samland	s ə m l 'a n	 s ə m l 'a n ə 
S'ho	s 'u	 s 'ɔ 
Rosa	r 'ɔ z ə	 r 'o z ə 
Riad	r i 'a t	 r i 'a ð 
Revetlla	r ə β 'e ʎ ʎ ə	 r ə β 'ɛ ʎ ʎ ə 
Renaixença	r ə n ə ʃ 'ɛ n s ə	 r ə n ə ʃ 'e n s ə 
Remei	r ə m 'ɛ j	 r ə m 'ɛ i 
Reixac	r ə ʃ 'a k	 r ə i ʃ 'a k 
Reintegrament	r ə i n t ə ɣ ɾ ə m 'e n	 r ə 'i n t 'ɛ ɣ ɾ ə m 'e n 
Reemissió	r e ə m i s i 'o	 r ə ə m i s i 'o 
Quedo	k 'e ð u	 k 'ɛ ð u 
QUIR	k 'i r	 k 'i 
Provença	p ɾ u β 'ɛ n s ə	 p ɾ u β 'e n s ə 
Ponç	p 'ɔ n s	 p 'o n s 
Pont	p 'ɔ n	 p 'o n 
Pladellorens	p l ə ð ə ʎ u ɾ 'ɛ n s	 p l ə ð ə ʎ u ɾ 'e n s 
Pingu	p 'i ŋ g u	 p 'i ŋ g 
Perecamps	p ə ɾ ə k 'a m s	 p ə ɾ ə k 'a m p s 
Penedesencs	p ə n ə ð ə z 'ɛ ŋ s	 p ə n ə ð ə z 'ɛ ŋ k s 
Parts	p 'a r s	 p 'a r t s 
Parisencs	p ə ɾ i z 'ɛ ŋ s	 p ə ɾ i z 'ɛ ŋ k s 
Parella	p ə ɾ 'ɛ ʎ ə	 p ə ɾ 'e ʎ ə 
PIME	p 'i m e	 p 'i m ə 
Os	'ɔ s	 'o s 
Omple	'o m p l ə	 'ɔ m p l ə 
Ofereix	u f ə ɾ 'ɛ ʃ	 u f ə ɾ 'e ʃ 
Nois	n 'ɔ j s	 n 'o i s 
Nogueira	n u ɣ 'ɛ j ɾ ə	 n u ɣ u ə 'i ɾ ə 
Nairobi	n ə j ɾ 'ɔ β i	 n ə i ɾ 'ɔ β i 
N'Anglada	n ə ŋ g l 'a ð ə	 n ə n ə l 'a ð ə 
Munich	m u n 'i k	 m u n 'i s i 
Mossos	m 'o s u s	 m 'ɔ s u s 
Mora	m 'ɔ ɾ ə	 m 'o ɾ ə 
Molta	m 'o l t ə	 m 'ɔ l t ə 
Menja	m 'e n ʒ ə	 m 'ɛ n ʒ ə 
Martens	m ə r t 'ɛ n s	 m ə r t 'e n s 
Margarita	m ə ɾ ɣ ə ɾ 'i t ə	 m ə r ɣ ə ɾ 'i t ə 
Malone	m ə l 'o n ə	 m ə l 'ɔ n ə 
Magog	m ə ɣ 'ɔ k	 m ə ɣ 'o 
M'envaeix	m ə m b ə 'ɛ ʃ	 m ə m b ə 'e ʃ 
Légolas	l 'e ɣ u l ə s	 l ə ɣ u l 'a s 
Lund	l 'u n	 l 'u n d 
Lo	l 'u	 l u 
Lluch	ʎ 'u k	 ʎ 'u k u 
Llevo	ʎ 'e β u	 ʎ 'ɛ β u 
Llegeix	ʎ ə ʒ 'ɛ ʃ	 ʎ ə ʒ 'e ʃ 
Lisboa	l i z β 'o ə	 l i z β 'ɔ ə 
Liikanen	l i j k 'a n ə n	 l i i k 'a n ə n 
L'hi	l 'i	 l 'ɔ 
L'espai	l ə s p 'a j	 l ə s p 'a i 
L'assalt	l ə s 'a l	 l ə s 'a l t 
L'amiguisme	l ə m i ɣ 'i z m ə	 l ə m i ɣ u 'i z m ə 
L'Antoni	l ə n t 'ɔ n i	 l ə n t 'o n i 
Kinkel	k i ŋ k 'ɛ l	 ʒ i n s 'ɛ l 
Johannesburg	ʒ u ə n n ə z β 'u r k	 ʒ u ə n n ə z β 'u r 
Joguines	ʒ u ɣ 'i n ə s	 ʒ u ɣ u 'i n ə s 
Jofre	ʒ 'o f ɾ ə	 ʒ 'ɔ f ɾ ə 
Jeroni	ʒ ə ɾ 'ɔ n i	 ʒ ə ɾ 'o n i 
Imprimeix	i m p ɾ i m 'ɛ ʃ	 i m p ɾ i m 'e ʃ 
Ignoro	i g n 'o ɾ u	 i g n 'ɔ ɾ u 
Hòstia	'ɔ s t i ə	 u s t i ə 
Hug	'u k	  'u 
Horta	'ɔ r t ə	 u r t ə 
Hansen	'a n s ə n	 i 'a n s ə n 
Haig	'a t ʃ	 ə 'i ə 
Günther	g w n t 'e r	 g 'u n t 'ɔ 'e 
Frankfurt	f ɾ ə ŋ k f 'u r t	 f ɾ ə n ə f 'u r t 
Floraina	f l u ɾ 'a j n ə	 f l u ɾ ə 'i n ə 
Fixi's	f 'i k s i s	 f i k s 'i s 
Finestres	f i n 'e s t ɾ ə s	 f i n 'ɛ s t ɾ ə s 
Festes	f 'e s t ə s	 f 'ɛ s t ə s 
Festa	f 'e s t ə	 f 'ɛ s t ə 
Fent-ho	f 'e n t u	 f ə n t 'ɔ 
Explica'ls	ə k s p l 'i k ə l s	 ə k s p l i k 'a l s 
Exempcions	ə g z ə m s i 'o n s	 ə g z ə m p s i 'o n s 
Executa	ə g z ə k 'u t ə	 ə k s ə k 'u t ə 
Esports	ə s p 'ɔ r s	 ə s p 'o r t s 
Esperi	ə s p 'e ɾ i	 ə s p 'ɛ ɾ i 
Espera'm	ə s p 'e ɾ ə m	 ə s p ə ɾ 'a m 
Escolti	ə s k 'o l t i	 ə s k 'ɔ l t i 
Escolta'm	ə s k 'o l t ə m	 ə s k u l t 'a m 
Ernest	ə r n 'e s t	 ə r n 'ɛ s t 
Entren	'e n t ɾ ə n	 'ɛ n t ɾ ə n 
Elisenda	ə l i z 'e n d ə	 ə l i z 'ɛ n d ə 
Eindhoven	ə j n d 'o β ə n	 ə i n d 'a β ə n 
Efecte	ə f 'e k t ə	 ə f 'ɛ k t ə 
Ebre	'e β ɾ ə	 'ɛ β ɾ ə 
Ebre	'e β ɾ ə	 'ɛ β ɾ ə 
EAJA	e 'a ʒ ə	 ə 'a ʒ ə 
Dubtes	d 'u p t ə s	 d 'u b b t ə s 
Diguem-ne	d i ɣ 'ɛ m n ə	 d i ɣ u 'ɛ m n ə 
Detroit	d ə t ɾ 'ɔ j t	 d ə t ɾ u 'i t 
Deixi	d 'e ʃ i	 d 'ɛ ʃ i 
Defineix	d ə f i n 'ɛ ʃ	 d ə f i n 'e ʃ 
Darrere	d ə r 'e ɾ ə	 d ə r 'ɛ ɾ ə 
D'Israel	d i z r ə 'ɛ l	 d i s ə 'ɛ l 
Copia-la	k u p 'i ə l ə	 k u p i 'a l ə 
Copenhague	k u p ə n 'a ɣ ə	 k u p ə n u 'a ɣ ə 
Copa	k 'o p ə	 k 'ɔ p ə 
Consta	k 'o n s t ə	 k 'ɔ n s t ə 
Connecta	k u n n 'e k t ə	 k u n n 'ɛ k t ə 
Comptes	k 'o m t ə s	 k 'ɔ m p t ə s 
Compta	k 'o m t ə	 k 'ɔ m t ə 
Comparseros	k u m p ə r s 'e ɾ u s	 k u m p ə r s 'ɛ ɾ u s 
Comença	k u m 'ɛ n s ə	 k u m 'e n s ə 
Comences	k u m 'ɛ n s ə s	 k u m 'e n s ə s 
Cleveland	k l ə β ə l 'a n	 k l ə β ə l 'a n ə 
Chirac	t ʃ i ɾ 'a k	 s i i ɾ 'a k 
Cheng	t ʃ 'ɛ ŋ	 k u ŋ 
Carreras	k ə r 'e ɾ ə s	 k ə r 'ɛ ɾ ə s 
Capgrossos	k ə b g ɾ 'ɔ s u s	 k ə p ɣ ɾ 'ɔ s u s 
Bons	b 'ɔ n s	 b 'o n s 
Bohigas	b u 'i ɣ ə s	 b u 'a ɣ ə s 
Boeing	b u 'ɛ j ŋ	 b u ə 'i ŋ 
Bodes	b 'o ð ə s	 b 'ɔ ð ə s 
Banotti	b ə n 'ɔ t i	 b ə n 'ɔ t t i 
Banc	b 'a ŋ	 b 'a ŋ k 
Avisa'm	ə β 'i z ə m	 ə β i z 'a m 
Arts	'a r s	 'a r t s 
Aquelles	ə k 'ɛ ʎ ə s	 ə k 'e ʎ ə s 
Apareix	ə p ə ɾ 'ɛ ʃ	 ə p ə ɾ 'e ʃ 
Anterior	ə n t ə ɾ i 'o r	 ə n t ə ɾ i 'o 
Amor	ə m 'o r	 ə m 'o 
Alhora	ə l 'ɔ ɾ ə	 ə l i 'o ɾ ə 
Alfred	ə l f ɾ 'ɛ t	 ə l f ɾ 'e d 
Aixeca	ə ʃ 'e k ə	 ə ʃ 'ɛ k ə 
Ai	'a j	 'a i 
Agenda	ə ʒ 'e n d ə	 ə ʒ 'ɛ n d ə 
Acosta't	ə k 'ɔ s t ə t	 ə k u s t 'a t 
amb	ə m	 'a m b 
promig	p ɾ u m 'i t ʃ	 p ɾ u m 'i ə 
dient-me	d i 'e m m ə	 d i 'ɛ n d m ə 
Virrei	b i r 'e j	 b i r 'ɛ i 
Vesteix	b ə s t 'ɛ ʃ	 b ə s t 'e ʃ 
Verds	b 'ɛ r s	 b 'ɛ r t s 
Venc	b 'ɛ ŋ	 b 'ɛ n s 
Suprem	s u p ɾ 'e m	 s u p ɾ 'ɛ m 
Son	s 'ɔ n	 s 'o n 
Se'n	s 'ə n	 s 'ɛ n 
S'aixeca	s ə ʃ 'e k ə	 s ə ʃ 'ɛ k ə 
Ruth	r 'u t	 r 'u t i 
Ressegueix	r ə s ə ɣ 'ɛ ʃ	 r ə s ə ɣ 'e ʃ 
Raúl	r ə 'u l	 r 'a ʎ 
Prenc	p ɾ 'ɛ ŋ	 p ɾ 'ɛ n s 
Prem	p ɾ 'e m	 p ɾ 'ɛ m 
Prefereix	p ɾ ə f ə ɾ 'ɛ ʃ	 p ɾ ə f ə ɾ 'e ʃ 
Pons	p 'ɔ n s	 p 'o n s 
Poder	p u ð 'ɛ	 p u ð 'e 
Plataforma	p l ə t ə f 'o r m ə	 p l ə t ə f 'ɔ r m ə 
Parisien	p ə ɾ i z 'i ə n	 p ə ɾ i s 'i ə n 
Ottawa	u t 'a β ə	 u t t 'a β ə 
Oh	'ɔ	 'o 
N'Édgar	n 'e d g ə	 n ə d ɣ 'a 
N'he	n 'e	 n 'ɛ 
Montmell	m u m m 'e ʎ	 m u n d m 'e ʎ 
Mes	m 'e s	 m 'ɛ s 
Lègolas	l 'ɛ ɣ u l ə s	 l ə ɣ u l 'a s 
Luxemburg	l u k s ə m b 'u r k	 l u k s ə m b 'u r 
Le	l 'e	 l 'ɛ 
L'hora	l 'ɔ ɾ ə	 l i 'o ɾ ə 
Introdueix	i n t ɾ u ð u 'ɛ ʃ	 i n t ɾ u ð u 'e ʃ 
Interessa	i n t ə ɾ 'ɛ s ə	 i n t ə ɾ 'e s ə 
Hèlsinki	'ɛ l s i ŋ k i	 i 'ɛ l s i n s i 
Huc	'u k	 'ɔ k 
Hisenda	i z 'e n d ə	 i s 'ɛ n d ə 
Hamburg	ə m b 'u r k	 ə m b 'u r 
Grenoble	g ɾ ə n 'o b b l ə	 g ɾ ə n 'ɔ b b l ə 
Grand	g ɾ 'a n	 g ɾ 'a n d 
Folch	f 'o l k	 f 'o l k ə 
Familiar	f ə m i l i 'a r	 f ə m i l i 'a 
Explota	ə k s p l 'o t ə	 ə k s p l 'ɔ t ə 
Escola't	ə s k 'ɔ l ə t	 ə s k u l 'a t 
Error	ə r 'o r	 ə r 'o 
Endreço	ə n d ɾ 'e s u	 ə n d ɾ 'ɛ s u 
Ela	'e l ə	 'ɛ l ə 
Dreamweaver	d ɾ e ə m b e ə β 'e	 d ɾ e ə m ə e ə β 'e 
Dona'm	d 'ɔ n ə m	 d u n 'a m 
Desi	d 'e z i	 d 'ɛ z i 
Converteix	k u m b ə r t 'ɛ ʃ	 k u m b ə r t 'e ʃ 
Contesta	k u n t 'e s t ə	 k u n t 'ɛ s t ə 
Compto	k 'o m t u	 k 'ɔ m p t u 
Chamonix	t ʃ ə m u n 'i k s	 k ə m u n 'i k s 
Camp	k 'a m	 k 'a m p 
COCO	k 'o k u	 k 'ɔ k u 
Ben	b 'e n	 b 'ɛ n 
Beirut	b ə j ɾ 'u t	 b ə i ɾ 'u t 
Atocha	ə t 'ɔ t ʃ ə	 ə t 'ɔ k ə 
Artur	ə r t 'u r	 ə r t 'u 
Aprendrem	ə p ə n d ɾ 'ɛ m	 ə p ɾ ə n d ɾ 'ɛ m 
Anvers	ə m b 'ɛ r s	 ə m b 'e s 
Altres	'a l t ɾ ə s	 ' a l t ɾ ə s 
Agnelli	ə g n 'e ʎ i	 ə g n 'ɛ ʎ i 
Acosta-t'hi	ə k 'ɔ s t ə t i	 ə k u s t 'a t i 
