patologista	p ə t u l u ʒ 'i s t ə	 p ə t u l u ʒ 'i s t ə 
tirant	t i ɾ 'a n	 t i ɾ 'a n 
subsòl	s u p s 'ɔ l	 s u p s 'ɔ l 
ortopèdic	u r t u p 'ɛ ð i k	 u r t u p 'ɛ ð i k 
Llicència	ʎ i s 'ɛ n s i ə	 ʎ i s 'ɛ n s i ə 
castellà	k ə s t ə ʎ 'a	 k ə s t ə ʎ 'a 
donat	d u n 'a t	 d u n 'a t 
nacionalitzats	n ə s i u n ə l i d z 'a t s	 n ə s i u n ə l i d z 'a t s 
cubata	k u β 'a t ə	 k u β 'a t ə 
entrepans	ə n t ɾ ə p 'a n s	 ə n t ɾ ə p 'a n s 
derrotista	d ə r u t 'i s t ə	 d ə r u t 'i s t ə 
mitja	m 'i d ʒ ə	 m 'i d ʒ ə 
estalviat	ə s t ə l β i 'a t	 ə s t ə l β i 'a t 
Munic	m u n 'i k	 m u n 'i k 
arribant	ə r i β 'a n	 ə r i β 'a n 
andorrà	ə n d u r 'a	 ə n d u r 'a 
turmells	t u r m 'e ʎ s	 t u r m 'e ʎ s 
agònic	ə ɣ 'ɔ n i k	 ə ɣ 'ɔ n i k 
vegades	b ə ɣ 'a ð ə s	 b ə ɣ 'a ð ə s 
punxegut	p u n ʃ ə ɣ 'u t	 p u n ʃ ə ɣ 'u t 
evasiu	ə β ə z 'i w	 ə β ə z 'i w 
muscle	m 'u s k l ə	 m 'u s k l ə 
escuterista	ə s k u t ə ɾ 'i s t ə	 ə s k u t ə ɾ 'i s t ə 
níquel	n 'i k ə l	 n 'i k ə l 
llanda	ʎ 'a n d ə	 ʎ 'a n d ə 
idees	i ð 'e ə s	 i ð 'e ə s 
piemontès	p i ə m u n t 'ɛ s	 p i ə m u n t 'ɛ s 
cesura	s ə z 'u ɾ ə	 s ə z 'u ɾ ə 
drissa	d ɾ 'i s ə	 d ɾ 'i s ə 
llagotejar	ʎ ə ɣ u t ə ʒ 'a	 ʎ ə ɣ u t ə ʒ 'a 
abrilenca	ə β ɾ i l 'ɛ ŋ k ə	 ə β ɾ i l 'ɛ ŋ k ə 
Cristòfol	k ɾ i s t 'ɔ f u l	 k ɾ i s t 'ɔ f u l 
Joval	ʒ u β 'a l	 ʒ u β 'a l 
massa	m 'a s ə	 m 'a s ə 
onada	u n 'a ð ə	 u n 'a ð ə 
s'emmiralla	s ə m m i ɾ 'a ʎ ə	 s ə m m i ɾ 'a ʎ ə 
corogràfica	k u ɾ u ɣ ɾ 'a f i k ə	 k u ɾ u ɣ ɾ 'a f i k ə 
localitza	l u k ə l 'i d z ə	 l u k ə l 'i d z ə 
Gran	g ɾ 'a n	 g ɾ 'a n 
dinamitzar	d i n ə m i d z 'a	 d i n ə m i d z 'a 
atròfies	ə t ɾ 'ɔ f i ə s	 ə t ɾ 'ɔ f i ə s 
alternats	ə l t ə r n 'a t s	 ə l t ə r n 'a t s 
l'esbroncada	l ə z β ɾ u ŋ k 'a ð ə	 l ə z β ɾ u ŋ k 'a ð ə 
soles	s 'ɔ l ə s	 s 'ɔ l ə s 
bressar	b ɾ ə s 'a	 b ɾ ə s 'a 
oracle	u ɾ 'a k l ə	 u ɾ 'a k l ə 
sudanès	s u ð ə n 'ɛ s	 s u ð ə n 'ɛ s 
avaluat	ə β ə l u 'a t	 ə β ə l u 'a t 
ascendits	ə s ə n d 'i t s	 ə s ə n d 'i t s 
pitjar	p i d ʒ 'a	 p i d ʒ 'a 
marraixa	m ə r 'a ʃ ə	 m ə r 'a ʃ ə 
situes	s i t 'u ə s	 s i t 'u ə s 
aranya	ə ɾ 'a ɲ ə	 ə ɾ 'a ɲ ə 
horaris	u ɾ 'a ɾ i s	 u ɾ 'a ɾ i s 
cinematogràfica	s i n ə m ə t u ɣ ɾ 'a f i k ə	 s i n ə m ə t u ɣ ɾ 'a f i k ə 
protagonitzats	p ɾ u t ə ɣ u n i d z 'a t s	 p ɾ u t ə ɣ u n i d z 'a t s 
pitó	p i t 'o	 p i t 'o 
inèrcia	i n 'ɛ r s i ə	 i n 'ɛ r s i ə 
marisc	m ə ɾ 'i s k	 m ə ɾ 'i s k 
progressada	p ɾ u ɣ ɾ ə s 'a ð ə	 p ɾ u ɣ ɾ ə s 'a ð ə 
maceració	m ə s ə ɾ ə s i 'o	 m ə s ə ɾ ə s i 'o 
generosa	ʒ ə n ə ɾ 'o z ə	 ʒ ə n ə ɾ 'o z ə 
delitar	d ə l i t 'a	 d ə l i t 'a 
criminals	k ɾ i m i n 'a l s	 k ɾ i m i n 'a l s 
encertada	ə n s ə r t 'a ð ə	 ə n s ə r t 'a ð ə 
diamant	d i ə m 'a n	 d i ə m 'a n 
zelandès	z ə l ə n d 'ɛ s	 z ə l ə n d 'ɛ s 
Selva	s 'ɛ l β ə	 s 'ɛ l β ə 
alimentem	ə l i m ə n t 'ɛ m	 ə l i m ə n t 'ɛ m 
romegueró	r u m ə ɣ ə ɾ 'o	 r u m ə ɣ ə ɾ 'o 
elaborares	ə l ə β u ɾ 'a ɾ ə s	 ə l ə β u ɾ 'a ɾ ə s 
tossut	t u s 'u t	 t u s 'u t 
expandit	ə k s p ə n d 'i t	 ə k s p ə n d 'i t 
tribulades	t ɾ i β u l 'a ð ə s	 t ɾ i β u l 'a ð ə s 
beure	b 'ɛ w ɾ ə	 b 'ɛ w ɾ ə 
monitoritza	m u n i t u ɾ 'i d z ə	 m u n i t u ɾ 'i d z ə 
instigar	i n s t i ɣ 'a	 i n s t i ɣ 'a 
embolcallant	ə m b u l k ə ʎ 'a n	 ə m b u l k ə ʎ 'a n 
substancial	s u p s t ə n s i 'a l	 s u p s t ə n s i 'a l 
paròdiques	p ə ɾ 'ɔ ð i k ə s	 p ə ɾ 'ɔ ð i k ə s 
brasa	b ɾ 'a z ə	 b ɾ 'a z ə 
fotogravar	f u t u ɣ ɾ ə β 'a	 f u t u ɣ ɾ ə β 'a 
sotragar	s u t ɾ ə ɣ 'a	 s u t ɾ ə ɣ 'a 
obi	'ɔ β i	 'ɔ β i 
lluïda	ʎ u 'i ð ə	 ʎ u 'i ð ə 
cabres	k 'a β ɾ ə s	 k 'a β ɾ ə s 
regent	r ə ʒ 'e n	 r ə ʒ 'e n 
Oslo	'ɔ z l u	 'ɔ z l u 
dolenta	d u l 'e n t ə	 d u l 'e n t ə 
pàgina	p 'a ʒ i n ə	 p 'a ʒ i n ə 
realització	r e ə l i d z ə s i 'o	 r e ə l i d z ə s i 'o 
continuo	k u n t i n 'u u	 k u n t i n 'u u 
jamaicà	ʒ ə m ə j k 'a	 ʒ ə m ə j k 'a 
difamatori	d i f ə m ə t 'ɔ ɾ i	 d i f ə m ə t 'ɔ ɾ i 
l'escorça	l ə s k 'ɔ r s ə	 l ə s k 'ɔ r s ə 
tallades	t ə ʎ 'a ð ə s	 t ə ʎ 'a ð ə s 
mortificat	m u r t i f i k 'a t	 m u r t i f i k 'a t 
iniciarem	i n i s i ə ɾ 'ɛ m	 i n i s i ə ɾ 'ɛ m 
avantatja	ə β ə n t 'a d ʒ ə	 ə β ə n t 'a d ʒ ə 
caigut	k ə j ɣ 'u t	 k ə j ɣ 'u t 
encriptats	ə ŋ k ɾ i p t 'a t s	 ə ŋ k ɾ i p t 'a t s 
mediocre	m ə ð i 'ɔ k ɾ ə	 m ə ð i 'ɔ k ɾ ə 
ninos	n 'i n u s	 n 'i n u s 
l'estudiés	l ə s t u ð i 'e s	 l ə s t u ð i 'e s 
puntal	p u n t 'a l	 p u n t 'a l 
presentar	p ɾ ə z ə n t 'a	 p ɾ ə z ə n t 'a 
etapes	ə t 'a p ə s	 ə t 'a p ə s 
peüc	p ə 'u k	 p ə 'u k 
avisats	ə β i z 'a t s	 ə β i z 'a t s 
amenaçat	ə m ə n ə s 'a t	 ə m ə n ə s 'a t 
calcules	k ə l k 'u l ə s	 k ə l k 'u l ə s 
saturació	s ə t u ɾ ə s i 'o	 s ə t u ɾ ə s i 'o 
cafeteria	k ə f ə t ə ɾ 'i ə	 k ə f ə t ə ɾ 'i ə 
marroquina	m ə r u k 'i n ə	 m ə r u k 'i n ə 
anotació	ə n u t ə s i 'o	 ə n u t ə s i 'o 
front	f ɾ 'o n	 f ɾ 'o n 
venjada	b ə n ʒ 'a ð ə	 b ə n ʒ 'a ð ə 
alçar	ə l s 'a	 ə l s 'a 
filosòfics	f i l u z 'ɔ f i k s	 f i l u z 'ɔ f i k s 
juga	ʒ 'u ɣ ə	 ʒ 'u ɣ ə 
immortalitat	i m m u r t ə l i t 'a t	 i m m u r t ə l i t 'a t 
subornà	s u β u r n 'a	 s u β u r n 'a 
modulada	m u ð u l 'a ð ə	 m u ð u l 'a ð ə 
combatre	k u m b 'a t ɾ ə	 k u m b 'a t ɾ ə 
etiquetes	ə t i k 'ɛ t ə s	 ə t i k 'ɛ t ə s 
Dàcia	d 'a s i ə	 d 'a s i ə 
carmí	k ə r m 'i	 k ə r m 'i 
colguen	k 'ɔ l ɣ ə n	 k 'ɔ l ɣ ə n 
tànnic	t 'a n n i k	 t 'a n n i k 
animalitzades	ə n i m ə l i d z 'a ð ə s	 ə n i m ə l i d z 'a ð ə s 
avantatjant	ə β ə n t ə d ʒ 'a n	 ə β ə n t ə d ʒ 'a n 
cine	s 'i n ə	 s 'i n ə 
casar-te	k ə z 'a r t ə	 k ə z 'a r t ə 
Moncofa	m u ŋ k 'ɔ f ə	 m u ŋ k 'ɔ f ə 
baula	b 'a w l ə	 b 'a w l ə 
albacetenyes	ə l β ə s ə t 'ɛ ɲ ə s	 ə l β ə s ə t 'ɛ ɲ ə s 
paviment	p ə β i m 'e n	 p ə β i m 'e n 
molt	m 'o l	 m 'o l 
alimentari	ə l i m ə n t 'a ɾ i	 ə l i m ə n t 'a ɾ i 
opinats	u p i n 'a t s	 u p i n 'a t s 
estirada	ə s t i ɾ 'a ð ə	 ə s t i ɾ 'a ð ə 
estrenar	ə s t ɾ ə n 'a	 ə s t ɾ ə n 'a 
fixant	f i k s 'a n	 f i k s 'a n 
indicativa	i n d i k ə t 'i β ə	 i n d i k ə t 'i β ə 
lleixiu	ʎ ə ʃ 'i w	 ʎ ə ʃ 'i w 
demolició	d ə m u l i s i 'o	 d ə m u l i s i 'o 
executar	ə g z ə k u t 'a	 ə g z ə k u t 'a 
acabés	ə k ə β 'e s	 ə k ə β 'e s 
afilaria	ə f i l ə ɾ 'i ə	 ə f i l ə ɾ 'i ə 
Desclot	d ə s k l 'ɔ t	 d ə s k l 'ɔ t 
Dolors	d u l 'o s	 d u l 'o s 
usats	u z 'a t s	 u z 'a t s 
sediciós	s ə ð i s i 'o s	 s ə ð i s i 'o s 
pruïdes	p ɾ u 'i ð ə s	 p ɾ u 'i ð ə s 
Aiguaviva	ə j ɣ w ə β 'i β ə	 ə j ɣ w ə β 'i β ə 
remunerat	r ə m u n ə ɾ 'a t	 r ə m u n ə ɾ 'a t 
matemàtiques	m ə t ə m 'a t i k ə s	 m ə t ə m 'a t i k ə s 
maltractat	m ə l t ɾ ə k t 'a t	 m ə l t ɾ ə k t 'a t 
amenaçades	ə m ə n ə s 'a ð ə s	 ə m ə n ə s 'a ð ə s 
revelació	r ə β ə l ə s i 'o	 r ə β ə l ə s i 'o 
rèmol	r 'ɛ m u l	 r 'ɛ m u l 
ambientades	ə m b i ə n t 'a ð ə s	 ə m b i ə n t 'a ð ə s 
inicialitzar	i n i s i ə l i d z 'a	 i n i s i ə l i d z 'a 
minotaure	m i n u t 'a w ɾ ə	 m i n u t 'a w ɾ ə 
definires	d ə f i n 'i ɾ ə s	 d ə f i n 'i ɾ ə s 
cercar	s ə r k 'a	 s ə r k 'a 
ballar	b ə ʎ 'a	 b ə ʎ 'a 
calabruixa	k ə l ə β ɾ 'u ʃ ə	 k ə l ə β ɾ 'u ʃ ə 
sostre	s 'ɔ s t ɾ ə	 s 'ɔ s t ɾ ə 
MIME	m 'i m ə	 m 'i m ə 
dominat	d u m i n 'a t	 d u m i n 'a t 
avorrides	ə β u r 'i ð ə s	 ə β u r 'i ð ə s 
assaltat	ə s ə l t 'a t	 ə s ə l t 'a t 
cessió	s ə s i 'o	 s ə s i 'o 
estic	ə s t 'i k	 ə s t 'i k 
captada	k ə p t 'a ð ə	 k ə p t 'a ð ə 
no	n 'o	 n 'o 
Contenint	k u n t ə n 'i n	 k u n t ə n 'i n 
impuls	i m p 'u l s	 i m p 'u l s 
arqueoastronomia	ə r k ə u ə s t ɾ u n u m 'i ə	 ə r k ə u ə s t ɾ u n u m 'i ə 
tràmit	t ɾ 'a m i t	 t ɾ 'a m i t 
guacamais	g w ə k ə m 'a j s	 g w ə k ə m 'a j s 
superposada	s u p ə r p u z 'a ð ə	 s u p ə r p u z 'a ð ə 
llatinitzat	ʎ ə t i n i d z 'a t	 ʎ ə t i n i d z 'a t 
contaminar	k u n t ə m i n 'a	 k u n t ə m i n 'a 
sociològics	s u s i u l 'ɔ ʒ i k s	 s u s i u l 'ɔ ʒ i k s 
prestigi	p ɾ ə s t 'i ʒ i	 p ɾ ə s t 'i ʒ i 
suma	s 'u m ə	 s 'u m ə 
incomplert	i ŋ k u m p l 'ɛ r t	 i ŋ k u m p l 'ɛ r t 
marxar	m ə r ʃ 'a	 m ə r ʃ 'a 
empaquetar	ə m p ə k ə t 'a	 ə m p ə k ə t 'a 
llegum	ʎ ə ɣ 'u m	 ʎ ə ɣ 'u m 
dramatitzat	d ɾ ə m ə t i d z 'a t	 d ɾ ə m ə t i d z 'a t 
vulguem	b u l ɣ 'ɛ m	 b u l ɣ 'ɛ m 
multat	m u l t 'a t	 m u l t 'a t 
descarrilament	d ə s k ə r i l ə m 'e n	 d ə s k ə r i l ə m 'e n 
inversors	i m b ə r s 'o s	 i m b ə r s 'o s 
Estaven	ə s t 'a β ə n	 ə s t 'a β ə n 
berenat	b ə ɾ ə n 'a t	 b ə ɾ ə n 'a t 
vostre	b 'ɔ s t ɾ ə	 b 'ɔ s t ɾ ə 
ajornades	ə ʒ u r n 'a ð ə s	 ə ʒ u r n 'a ð ə s 
promès	p ɾ u m 'ɛ s	 p ɾ u m 'ɛ s 
circumstàncies	s i r k u m s t 'a n s i ə s	 s i r k u m s t 'a n s i ə s 
acumula	ə k u m 'u l ə	 ə k u m 'u l ə 
consumia	k u n s u m 'i ə	 k u n s u m 'i ə 
increïble	i ŋ k ɾ ə 'i b b l ə	 i ŋ k ɾ ə 'i b b l ə 
ametlla	ə m 'ɛ ʎ ʎ ə	 ə m 'ɛ ʎ ʎ ə 
selves	s 'ɛ l β ə s	 s 'ɛ l β ə s 
Segòvia	s ə ɣ 'ɔ β i ə	 s ə ɣ 'ɔ β i ə 
femer	f ə m 'e	 f ə m 'e 
aconseguida	ə k u n s ə ɣ 'i ð ə	 ə k u n s ə ɣ 'i ð ə 
vaga	b 'a ɣ ə	 b 'a ɣ ə 
emperò	ə m p ə ɾ 'ɔ	 ə m p ə ɾ 'ɔ 
viticultura	b i t i k u l t 'u ɾ ə	 b i t i k u l t 'u ɾ ə 
Carreu	k ə r 'ɛ w	 k ə r 'ɛ w 
cessió	s ə s i 'o	 s ə s i 'o 
trencades	t ɾ ə ŋ k 'a ð ə s	 t ɾ ə ŋ k 'a ð ə s 
llençats	ʎ ə n s 'a t s	 ʎ ə n s 'a t s 
Xina	ʃ 'i n ə	 ʃ 'i n ə 
traumatitzar	t ɾ ə w m ə t i d z 'a	 t ɾ ə w m ə t i d z 'a 
policial	p u l i s i 'a l	 p u l i s i 'a l 
parlant	p ə r l 'a n	 p ə r l 'a n 
Croàcia	k ɾ u 'a s i ə	 k ɾ u 'a s i ə 
salades	s ə l 'a ð ə s	 s ə l 'a ð ə s 
malais	m ə l 'a j s	 m ə l 'a j s 
Predicar	p ɾ ə ð i k 'a	 p ɾ ə ð i k 'a 
tíbia	t 'i β i ə	 t 'i β i ə 
pantògrafs	p ə n t 'ɔ ɣ ɾ ə f s	 p ə n t 'ɔ ɣ ɾ ə f s 
alcassaba	ə l k ə s 'a β ə	 ə l k ə s 'a β ə 
botzinar	b u d z i n 'a	 b u d z i n 'a 
adita	ə ð 'i t ə	 ə ð 'i t ə 
indicat	i n d i k 'a t	 i n d i k 'a t 
tisores	t i z 'o ɾ ə s	 t i z 'o ɾ ə s 
reestructurar	r e ə s t ɾ u k t u ɾ 'a	 r e ə s t ɾ u k t u ɾ 'a 
desconeguda	d ə s k u n ə ɣ 'u ð ə	 d ə s k u n ə ɣ 'u ð ə 
desconcertats	d ə s k u n s ə r t 'a t s	 d ə s k u n s ə r t 'a t s 
empresonament	ə m p ɾ ə z u n ə m 'e n	 ə m p ɾ ə z u n ə m 'e n 
xirimoia	ʃ i ɾ i m 'ɔ j ə	 ʃ i ɾ i m 'ɔ j ə 
cadinè	k ə ð i n 'ɛ	 k ə ð i n 'ɛ 
marques	m 'a r k ə s	 m 'a r k ə s 
addicional	ə d d i s i u n 'a l	 ə d d i s i u n 'a l 
censurar	s ə n s u ɾ 'a	 s ə n s u ɾ 'a 
indonèsia	i n d u n 'ɛ z i ə	 i n d u n 'ɛ z i ə 
Formiguer	f u r m i ɣ 'e	 f u r m i ɣ 'e 
miàlgia	m i 'a l ʒ i ə	 m i 'a l ʒ i ə 
grup	g ɾ 'u p	 g ɾ 'u p 
embastar	ə m b ə s t 'a	 ə m b ə s t 'a 
rebutjades	r ə β u d ʒ 'a ð ə s	 r ə β u d ʒ 'a ð ə s 
clafolla	k l ə f 'ɔ ʎ ə	 k l ə f 'ɔ ʎ ə 
jocs	ʒ 'ɔ k s	 ʒ 'ɔ k s 
taüts	t ə 'u t s	 t ə 'u t s 
taxi	t 'a k s i	 t 'a k s i 
turisme	t u ɾ 'i z m ə	 t u ɾ 'i z m ə 
embridar	ə m b ɾ i ð 'a	 ə m b ɾ i ð 'a 
textuals	t ə k s t u 'a l s	 t ə k s t u 'a l s 
d'Educació	d ə ð u k ə s i 'o	 d ə ð u k ə s i 'o 
arrossegat	ə r u s ə ɣ 'a t	 ə r u s ə ɣ 'a t 
copso	k 'ɔ p s u	 k 'ɔ p s u 
declarava	d ə k l ə ɾ 'a β ə	 d ə k l ə ɾ 'a β ə 
clans	k l 'a n s	 k l 'a n s 
cuanegre	k u ə n 'ɛ ɣ ɾ ə	 k u ə n 'ɛ ɣ ɾ ə 
Certificat	s ə r t i f i k 'a t	 s ə r t i f i k 'a t 
debutant	d ə β u t 'a n	 d ə β u t 'a n 
resseguit	r ə s ə ɣ 'i t	 r ə s ə ɣ 'i t 
aproximats	ə p ɾ u k s i m 'a t s	 ə p ɾ u k s i m 'a t s 
teranyines	t ə ɾ ə ɲ 'i n ə s	 t ə ɾ ə ɲ 'i n ə s 
feixuc	f ə ʃ 'u k	 f ə ʃ 'u k 
Crist	k ɾ 'i s t	 k ɾ 'i s t 
llunyà	ʎ u ɲ 'a	 ʎ u ɲ 'a 
rodejat	r u ð ə ʒ 'a t	 r u ð ə ʒ 'a t 
conys	k 'o ɲ s	 k 'o ɲ s 
encamisada	ə ŋ k ə m i z 'a ð ə	 ə ŋ k ə m i z 'a ð ə 
matat	m ə t 'a t	 m ə t 'a t 
criticades	k ɾ i t i k 'a ð ə s	 k ɾ i t i k 'a ð ə s 
serològic	s ə ɾ u l 'ɔ ʒ i k	 s ə ɾ u l 'ɔ ʒ i k 
esquiat	ə s k i 'a t	 ə s k i 'a t 
estat	ə s t 'a t	 ə s t 'a t 
portals	p u r t 'a l s	 p u r t 'a l s 
nafrat	n ə f ɾ 'a t	 n ə f ɾ 'a t 
entelèquia	ə n t ə l 'ɛ k i ə	 ə n t ə l 'ɛ k i ə 
dionisíac	d i u n i z 'i ə k	 d i u n i z 'i ə k 
adonant-se	ə ð u n 'a n s ə	 ə ð u n 'a n s ə 
esparracar	ə s p ə r ə k 'a	 ə s p ə r ə k 'a 
tu	t 'u	 t 'u 
concebut	k u n s ə β 'u t	 k u n s ə β 'u t 
obstinat	u p s t i n 'a t	 u p s t i n 'a t 
entrecreuats	ə n t ɾ ə k ɾ ə w 'a t s	 ə n t ɾ ə k ɾ ə w 'a t s 
ressogre	r ə s 'ɔ ɣ ɾ ə	 r ə s 'ɔ ɣ ɾ ə 
amfibis	ə m f 'i β i s	 ə m f 'i β i s 
fornia	f u r n 'i ə	 f u r n 'i ə 
molèstia	m u l 'ɛ s t i ə	 m u l 'ɛ s t i ə 
tarquim	t ə r k 'i m	 t ə r k 'i m 
polseguera	p u l s ə ɣ 'e ɾ ə	 p u l s ə ɣ 'e ɾ ə 
desesperada	d ə z ə s p ə ɾ 'a ð ə	 d ə z ə s p ə ɾ 'a ð ə 
tassa	t 'a s ə	 t 'a s ə 
aconsellar-los	ə k u n s ə ʎ 'a r l u s	 ə k u n s ə ʎ 'a r l u s 
fotòmetre	f u t 'ɔ m ə t ɾ ə	 f u t 'ɔ m ə t ɾ ə 
Departament	d ə p ə r t ə m 'e n	 d ə p ə r t ə m 'e n 
pompós	p u m p 'o s	 p u m p 'o s 
centenàries	s ə n t ə n 'a ɾ i ə s	 s ə n t ə n 'a ɾ i ə s 
ventilava	b ə n t i l 'a β ə	 b ə n t i l 'a β ə 
etimòleg	ə t i m 'ɔ l ə k	 ə t i m 'ɔ l ə k 
planetaris	p l ə n ə t 'a ɾ i s	 p l ə n ə t 'a ɾ i s 
Actual	ə k t u 'a l	 ə k t u 'a l 
Viatjava	b i ə d ʒ 'a β ə	 b i ə d ʒ 'a β ə 
recollit	r ə k u ʎ 'i t	 r ə k u ʎ 'i t 
precoces	p ɾ ə k 'ɔ s ə s	 p ɾ ə k 'ɔ s ə s 
dull	d 'u ʎ	 d 'u ʎ 
deposada	d ə p u z 'a ð ə	 d ə p u z 'a ð ə 
antics	ə n t 'i k s	 ə n t 'i k s 
referides	r ə f ə ɾ 'i ð ə s	 r ə f ə ɾ 'i ð ə s 
fisonomia	f i z u n u m 'i ə	 f i z u n u m 'i ə 
xamós	ʃ ə m 'o s	 ʃ ə m 'o s 
L'elf	l 'ɛ l f	 l 'ɛ l f 
banyut	b ə ɲ 'u t	 b ə ɲ 'u t 
alcohòliques	ə l k u 'ɔ l i k ə s	 ə l k u 'ɔ l i k ə s 
revitalitzades	r ə β i t ə l i d z 'a ð ə s	 r ə β i t ə l i d z 'a ð ə s 
auge	'a w ʒ ə	 'a w ʒ ə 
Nàpols	n 'a p u l s	 n 'a p u l s 
abrasar	ə β ɾ ə z 'a	 ə β ɾ ə z 'a 
afinats	ə f i n 'a t s	 ə f i n 'a t s 
Cuba	k 'u β ə	 k 'u β ə 
menciones	m ə n s i 'o n ə s	 m ə n s i 'o n ə s 
nos	n 'o s	 n 'o s 
bestenaga	b ə s t ə n 'a ɣ ə	 b ə s t ə n 'a ɣ ə 
causaria	k ə w z ə ɾ 'i ə	 k ə w z ə ɾ 'i ə 
vetada	b ə t 'a ð ə	 b ə t 'a ð ə 
vetllat	b ə ʎ ʎ 'a t	 b ə ʎ ʎ 'a t 
malferits	m ə l f ə ɾ 'i t s	 m ə l f ə ɾ 'i t s 
justificació	ʒ u s t i f i k ə s i 'o	 ʒ u s t i f i k ə s i 'o 
acorregut	ə k u r ə ɣ 'u t	 ə k u r ə ɣ 'u t 
tremolades	t ɾ ə m u l 'a ð ə s	 t ɾ ə m u l 'a ð ə s 
realitzar	r e ə l i d z 'a	 r e ə l i d z 'a 
literatura	l i t ə ɾ ə t 'u ɾ ə	 l i t ə ɾ ə t 'u ɾ ə 
trinxada	t ɾ i n ʃ 'a ð ə	 t ɾ i n ʃ 'a ð ə 
Realitzar	r e ə l i d z 'a	 r e ə l i d z 'a 
lloada	ʎ u 'a ð ə	 ʎ u 'a ð ə 
finlandesa	f i n l ə n d 'ɛ z ə	 f i n l ə n d 'ɛ z ə 
antecessor	ə n t ə s ə s 'o	 ə n t ə s ə s 'o 
classificava	k l ə s i f i k 'a β ə	 k l ə s i f i k 'a β ə 
concretem	k u ŋ k ɾ ə t 'ɛ m	 k u ŋ k ɾ ə t 'ɛ m 
cotorreta	k u t u r 'ɛ t ə	 k u t u r 'ɛ t ə 
brodats	b ɾ u ð 'a t s	 b ɾ u ð 'a t s 
amics	ə m 'i k s	 ə m 'i k s 
Situació	s i t u ə s i 'o	 s i t u ə s i 'o 
pensament	p ə n s ə m 'e n	 p ə n s ə m 'e n 
inaugurar	i n ə w ɣ u ɾ 'a	 i n ə w ɣ u ɾ 'a 
fartes	f 'a r t ə s	 f 'a r t ə s 
cel	s 'ɛ l	 s 'ɛ l 
complagut	k u m p l ə ɣ 'u t	 k u m p l ə ɣ 'u t 
contin	k 'ɔ n t i n	 k 'ɔ n t i n 
cresp	k ɾ 'ɛ s p	 k ɾ 'ɛ s p 
cavallers	k ə β ə ʎ 'e s	 k ə β ə ʎ 'e s 
estranya	ə s t ɾ 'a ɲ ə	 ə s t ɾ 'a ɲ ə 
regulats	r ə ɣ u l 'a t s	 r ə ɣ u l 'a t s 
adonis	ə ð 'o n i s	 ə ð 'o n i s 
estranyesa	ə s t ɾ ə ɲ 'ɛ z ə	 ə s t ɾ ə ɲ 'ɛ z ə 
catúfol	k ə t 'u f u l	 k ə t 'u f u l 
contactarem	k u n t ə k t ə ɾ 'ɛ m	 k u n t ə k t ə ɾ 'ɛ m 
cuirassar	k u j ɾ ə s 'a	 k u j ɾ ə s 'a 
fregues	f ɾ 'ɛ ɣ ə s	 f ɾ 'ɛ ɣ ə s 
individualitzat	i n d i β i ð u ə l i d z 'a t	 i n d i β i ð u ə l i d z 'a t 
d'entrada	d ə n t ɾ 'a ð ə	 d ə n t ɾ 'a ð ə 
navegador	n ə β ə ɣ ə ð 'o	 n ə β ə ɣ ə ð 'o 
munió	m u n i 'o	 m u n i 'o 
valgut	b ə l ɣ 'u t	 b ə l ɣ 'u t 
equipares	ə k i p 'a ɾ ə s	 ə k i p 'a ɾ ə s 
arrumar	ə r u m 'a	 ə r u m 'a 
autoescola	ə w t u ə s k 'ɔ l ə	 ə w t u ə s k 'ɔ l ə 
voracitat	b u ɾ ə s i t 'a t	 b u ɾ ə s i t 'a t 
conatius	k u n ə t 'i w s	 k u n ə t 'i w s 
baló	b ə l 'o	 b ə l 'o 
cultes	k 'u l t ə s	 k 'u l t ə s 
torrada	t u r 'a ð ə	 t u r 'a ð ə 
fores	f 'o ɾ ə s	 f 'o ɾ ə s 
viatjo	b i 'a d ʒ u	 b i 'a d ʒ u 
pronunciada	p ɾ u n u n s i 'a ð ə	 p ɾ u n u n s i 'a ð ə 
creador	k ɾ e ə ð 'o	 k ɾ e ə ð 'o 
demències	d ə m 'ɛ n s i ə s	 d ə m 'ɛ n s i ə s 
camussa	k ə m 'u s ə	 k ə m 'u s ə 
desplaçat	d ə s p l ə s 'a t	 d ə s p l ə s 'a t 
tapiada	t ə p i 'a ð ə	 t ə p i 'a ð ə 
prestatgeries	p ɾ ə s t ə d ʒ ə ɾ 'i ə s	 p ɾ ə s t ə d ʒ ə ɾ 'i ə s 
copiares	k u p i 'a ɾ ə s	 k u p i 'a ɾ ə s 
americanitzades	ə m ə ɾ i k ə n i d z 'a ð ə s	 ə m ə ɾ i k ə n i d z 'a ð ə s 
Amposta	ə m p 'ɔ s t ə	 ə m p 'ɔ s t ə 
esgatinyat	ə z ɣ ə t i ɲ 'a t	 ə z ɣ ə t i ɲ 'a t 
abdicatives	ə b d i k ə t 'i β ə s	 ə b d i k ə t 'i β ə s 
permisos	p ə r m 'i z u s	 p ə r m 'i z u s 
resos	r 'ɛ z u s	 r 'ɛ z u s 
desplegables	d ə s p l ə ɣ 'a b b l ə s	 d ə s p l ə ɣ 'a b b l ə s 
encerclaran	ə n s ə r k l ə ɾ 'a n	 ə n s ə r k l ə ɾ 'a n 
retratat	r ə t ɾ ə t 'a t	 r ə t ɾ ə t 'a t 
escultòrica	ə s k u l t 'ɔ ɾ i k ə	 ə s k u l t 'ɔ ɾ i k ə 
encantador	ə ŋ k ə n t ə ð 'o	 ə ŋ k ə n t ə ð 'o 
L'arquitecte	l ə r k i t 'ɛ k t ə	 l ə r k i t 'ɛ k t ə 
ancià	ə n s i 'a	 ə n s i 'a 
sol	s 'ɔ l	 s 'ɔ l 
baix	b 'a ʃ	 b 'a ʃ 
afalagador	ə f ə l ə ɣ ə ð 'o	 ə f ə l ə ɣ ə ð 'o 
candidates	k ə n d i ð 'a t ə s	 k ə n d i ð 'a t ə s 
emet	ə m 'ɛ t	 ə m 'ɛ t 
empresonades	ə m p ɾ ə z u n 'a ð ə s	 ə m p ɾ ə z u n 'a ð ə s 
democràcia	d ə m u k ɾ 'a s i ə	 d ə m u k ɾ 'a s i ə 
venerats	b ə n ə ɾ 'a t s	 b ə n ə ɾ 'a t s 
jazzístic	ʒ ə z z 'i s t i k	 ʒ ə z z 'i s t i k 
empentades	ə m p ə n t 'a ð ə s	 ə m p ə n t 'a ð ə s 
desades	d ə z 'a ð ə s	 d ə z 'a ð ə s 
cromàtics	k ɾ u m 'a t i k s	 k ɾ u m 'a t i k s 
franja	f ɾ 'a n ʒ ə	 f ɾ 'a n ʒ ə 
derogatòria	d ə ɾ u ɣ ə t 'ɔ ɾ i ə	 d ə ɾ u ɣ ə t 'ɔ ɾ i ə 
retorni	r ə t 'ɔ r n i	 r ə t 'ɔ r n i 
enciam	ə n s i 'a m	 ə n s i 'a m 
arremolinada	ə r ə m u l i n 'a ð ə	 ə r ə m u l i n 'a ð ə 
alletant	ə ʎ ə t 'a n	 ə ʎ ə t 'a n 
varsovià	b ə r s u β i 'a	 b ə r s u β i 'a 
remarem	r ə m ə ɾ 'ɛ m	 r ə m ə ɾ 'ɛ m 
abominar	ə β u m i n 'a	 ə β u m i n 'a 
revenir	r ə β ə n 'i	 r ə β ə n 'i 
ossis	'ɔ s i s	 'ɔ s i s 
cirrosi	s i r 'ɔ z i	 s i r 'ɔ z i 
sotja	s 'ɔ d ʒ ə	 s 'ɔ d ʒ ə 
pentinada	p ə n t i n 'a ð ə	 p ə n t i n 'a ð ə 
eguinats	ə ɣ i n 'a t s	 ə ɣ i n 'a t s 
conversa	k u m b 'ɛ r s ə	 k u m b 'ɛ r s ə 
ombrejar	u m b ɾ ə ʒ 'a	 u m b ɾ ə ʒ 'a 
l'ajudi	l ə ʒ 'u ð i	 l ə ʒ 'u ð i 
cursiva	k u r s 'i β ə	 k u r s 'i β ə 
clamada	k l ə m 'a ð ə	 k l ə m 'a ð ə 
floral	f l u ɾ 'a l	 f l u ɾ 'a l 
consti	k 'ɔ n s t i	 k 'ɔ n s t i 
Transsiberià	t ɾ ə n s i β ə ɾ i 'a	 t ɾ ə n s i β ə ɾ i 'a 
fotografia	f u t u ɣ ɾ ə f 'i ə	 f u t u ɣ ɾ ə f 'i ə 
amenaces	ə m ə n 'a s ə s	 ə m ə n 'a s ə s 
efectuats	ə f ə k t u 'a t s	 ə f ə k t u 'a t s 
pirates	p i ɾ 'a t ə s	 p i ɾ 'a t ə s 
reprimir	r ə p ɾ i m 'i	 r ə p ɾ i m 'i 
torturava	t u r t u ɾ 'a β ə	 t u r t u ɾ 'a β ə 
vetar	b ə t 'a	 b ə t 'a 
evaporació	ə β ə p u ɾ ə s i 'o	 ə β ə p u ɾ ə s i 'o 
botavara	b u t ə β 'a ɾ ə	 b u t ə β 'a ɾ ə 
fraternitzada	f ɾ ə t ə r n i d z 'a ð ə	 f ɾ ə t ə r n i d z 'a ð ə 
Orfeu	u r f 'ɛ w	 u r f 'ɛ w 
dediquen	d ə ð 'i k ə n	 d ə ð 'i k ə n 
criminal	k ɾ i m i n 'a l	 k ɾ i m i n 'a l 
trigonomètriques	t ɾ i ɣ u n u m 'ɛ t ɾ i k ə s	 t ɾ i ɣ u n u m 'ɛ t ɾ i k ə s 
peguem	p ə ɣ 'ɛ m	 p ə ɣ 'ɛ m 
militares	m i l i t 'a ɾ ə s	 m i l i t 'a ɾ ə s 
bondat	b u n d 'a t	 b u n d 'a t 
exprimits	ə k s p ɾ i m 'i t s	 ə k s p ɾ i m 'i t s 
barret	b ə r 'ɛ t	 b ə r 'ɛ t 
nado	n 'a ð u	 n 'a ð u 
gelava	ʒ ə l 'a β ə	 ʒ ə l 'a β ə 
conclòs	k u ŋ k l 'ɔ s	 k u ŋ k l 'ɔ s 
aïnada	ə i n 'a ð ə	 ə i n 'a ð ə 
reproductor	r ə p ɾ u ð u k t 'o	 r ə p ɾ u ð u k t 'o 
participi	p ə r t i s 'i p i	 p ə r t i s 'i p i 
estripat	ə s t ɾ i p 'a t	 ə s t ɾ i p 'a t 
calmes	k 'a l m ə s	 k 'a l m ə s 
ell	'e ʎ	 'e ʎ 
quitat	k i t 'a t	 k i t 'a t 
pejoratives	p ə ʒ u ɾ ə t 'i β ə s	 p ə ʒ u ɾ ə t 'i β ə s 
emergits	ə m ə r ʒ 'i t s	 ə m ə r ʒ 'i t s 
encenedors	ə n s ə n ə ð 'o s	 ə n s ə n ə ð 'o s 
Vinya	b 'i ɲ ə	 b 'i ɲ ə 
Recull	r ə k 'u ʎ	 r ə k 'u ʎ 
tebanes	t ə β 'a n ə s	 t ə β 'a n ə s 
lusità	l u z i t 'a	 l u z i t 'a 
violeta	b i u l 'ɛ t ə	 b i u l 'ɛ t ə 
crisis	k ɾ 'i z i s	 k ɾ 'i z i s 
orelluda	u ɾ ə ʎ 'u ð ə	 u ɾ ə ʎ 'u ð ə 
envà	ə m b 'a	 ə m b 'a 
auscultada	ə w s k u l t 'a ð ə	 ə w s k u l t 'a ð ə 
beguin	b 'ɛ ɣ i n	 b 'ɛ ɣ i n 
convidava	k u m b i ð 'a β ə	 k u m b i ð 'a β ə 
bàsics	b 'a z i k s	 b 'a z i k s 
Navarra	n ə β 'a r ə	 n ə β 'a r ə 
Són	s 'o n	 s 'o n 
apícola	ə p 'i k u l ə	 ə p 'i k u l ə 
moravià	m u ɾ ə β i 'a	 m u ɾ ə β i 'a 
hermafroditisme	ə r m ə f ɾ u ð i t 'i z m ə	 ə r m ə f ɾ u ð i t 'i z m ə 
deturar	d ə t u ɾ 'a	 d ə t u ɾ 'a 
caucasians	k ə w k ə z i 'a n s	 k ə w k ə z i 'a n s 
iònics	i 'ɔ n i k s	 i 'ɔ n i k s 
misogínia	m i z u ʒ 'i n i ə	 m i z u ʒ 'i n i ə 
concurs	k u ŋ k 'u r s	 k u ŋ k 'u r s 
fonològic	f u n u l 'ɔ ʒ i k	 f u n u l 'ɔ ʒ i k 
poliedre	p u l i 'ɛ ð ɾ ə	 p u l i 'ɛ ð ɾ ə 
sancionats	s ə n s i u n 'a t s	 s ə n s i u n 'a t s 
aterrat	ə t ə r 'a t	 ə t ə r 'a t 
moda	m 'ɔ ð ə	 m 'ɔ ð ə 
saladina	s ə l ə ð 'i n ə	 s ə l ə ð 'i n ə 
s'emet	s ə m 'ɛ t	 s ə m 'ɛ t 
atansant-se	ə t ə n s 'a n s ə	 ə t ə n s 'a n s ə 
sales	s 'a l ə s	 s 'a l ə s 
forçaria	f u r s ə ɾ 'i ə	 f u r s ə ɾ 'i ə 
simulació	s i m u l ə s i 'o	 s i m u l ə s i 'o 
sèsam	s 'ɛ z ə m	 s 'ɛ z ə m 
l'especialitat	l ə s p ə s i ə l i t 'a t	 l ə s p ə s i ə l i t 'a t 
polititzar	p u l i t i d z 'a	 p u l i t i d z 'a 
fregir	f ɾ ə ʒ 'i	 f ɾ ə ʒ 'i 
irradiació	i r ə ð i ə s i 'o	 i r ə ð i ə s i 'o 
bavós	b ə β 'o s	 b ə β 'o s 
premeditats	p ɾ ə m ə ð i t 'a t s	 p ɾ ə m ə ð i t 'a t s 
màquina	m 'a k i n ə	 m 'a k i n ə 
ministra	m i n 'i s t ɾ ə	 m i n 'i s t ɾ ə 
elèctriques	ə l 'ɛ k t ɾ i k ə s	 ə l 'ɛ k t ɾ i k ə s 
laceració	l ə s ə ɾ ə s i 'o	 l ə s ə ɾ ə s i 'o 
incomoda	i ŋ k u m 'ɔ ð ə	 i ŋ k u m 'ɔ ð ə 
anomenats	ə n u m ə n 'a t s	 ə n u m ə n 'a t s 
solucionar	s u l u s i u n 'a	 s u l u s i u n 'a 
cornella	k u r n 'e ʎ ə	 k u r n 'e ʎ ə 
donis	d 'o n i s	 d 'o n i s 
embridats	ə m b ɾ i ð 'a t s	 ə m b ɾ i ð 'a t s 
caribenya	k ə ɾ i β 'ɛ ɲ ə	 k ə ɾ i β 'ɛ ɲ ə 
transformació	t ɾ ə n s f u r m ə s i 'o	 t ɾ ə n s f u r m ə s i 'o 
tiraria	t i ɾ ə ɾ 'i ə	 t i ɾ ə ɾ 'i ə 
capacitats	k ə p ə s i t 'a t s	 k ə p ə s i t 'a t s 
flerovi	f l ə ɾ 'ɔ β i	 f l ə ɾ 'ɔ β i 
planetari	p l ə n ə t 'a ɾ i	 p l ə n ə t 'a ɾ i 
atròfia	ə t ɾ 'ɔ f i ə	 ə t ɾ 'ɔ f i ə 
assímptotes	ə s 'i m t u t ə s	 ə s 'i m t u t ə s 
xenons	ʃ ə n 'o n s	 ʃ ə n 'o n s 
intrigar	i n t ɾ i ɣ 'a	 i n t ɾ i ɣ 'a 
decapitat	d ə k ə p i t 'a t	 d ə k ə p i t 'a t 
abandonament	ə β ə n d u n ə m 'e n	 ə β ə n d u n ə m 'e n 
toquis	t 'ɔ k i s	 t 'ɔ k i s 
kaó	k ə 'o	 k ə 'o 
queixal	k ə ʃ 'a l	 k ə ʃ 'a l 
amonestar	ə m u n ə s t 'a	 ə m u n ə s t 'a 
lingüística	l i ŋ g w 'i s t i k ə	 l i ŋ g w 'i s t i k ə 
peritoneal	p ə ɾ i t u n e 'a l	 p ə ɾ i t u n e 'a l 
mano	m 'a n u	 m 'a n u 
admissions	ə d m i s i 'o n s	 ə d m i s i 'o n s 
microprocessador	m i k ɾ u p ɾ u s ə s ə ð 'o	 m i k ɾ u p ɾ u s ə s ə ð 'o 
addicions	ə d d i s i 'o n s	 ə d d i s i 'o n s 
afligits	ə f l i ʒ 'i t s	 ə f l i ʒ 'i t s 
vendre	b 'ɛ n d ɾ ə	 b 'ɛ n d ɾ ə 
calma	k 'a l m ə	 k 'a l m ə 
associar	ə s u s i 'a	 ə s u s i 'a 
denotes	d ə n 'ɔ t ə s	 d ə n 'ɔ t ə s 
africana	ə f ɾ i k 'a n ə	 ə f ɾ i k 'a n ə 
bastió	b ə s t i 'o	 b ə s t i 'o 
Cuina	k 'u j n ə	 k 'u j n ə 
cridades	k ɾ i ð 'a ð ə s	 k ɾ i ð 'a ð ə s 
eixides	ə ʃ 'i ð ə s	 ə ʃ 'i ð ə s 
Havien	ə β 'i ə n	 ə β 'i ə n 
matí	m ə t 'i	 m ə t 'i 
perilloses	p ə ɾ i ʎ 'o z ə s	 p ə ɾ i ʎ 'o z ə s 
abominades	ə β u m i n 'a ð ə s	 ə β u m i n 'a ð ə s 
M'han	m 'a n	 m 'a n 
classificaria	k l ə s i f i k ə ɾ 'i ə	 k l ə s i f i k ə ɾ 'i ə 
d'orina	d u ɾ 'i n ə	 d u ɾ 'i n ə 
caciquejar	k ə s i k ə ʒ 'a	 k ə s i k ə ʒ 'a 
faixa	f 'a ʃ ə	 f 'a ʃ ə 
palmera	p ə l m 'e ɾ ə	 p ə l m 'e ɾ ə 
viscut	b i s k 'u t	 b i s k 'u t 
quiròfans	k i ɾ 'ɔ f ə n s	 k i ɾ 'ɔ f ə n s 
napolitanes	n ə p u l i t 'a n ə s	 n ə p u l i t 'a n ə s 
àpat	'a p ə t	 'a p ə t 
d'actuacions	d ə k t u ə s i 'o n s	 d ə k t u ə s i 'o n s 
afegitó	ə f ə ʒ i t 'o	 ə f ə ʒ i t 'o 
cuereta	k u ə ɾ 'ɛ t ə	 k u ə ɾ 'ɛ t ə 
mentó	m ə n t 'o	 m ə n t 'o 
d'executar	d ə g z ə k u t 'a	 d ə g z ə k u t 'a 
trametre	t ɾ ə m 'ɛ t ɾ ə	 t ɾ ə m 'ɛ t ɾ ə 
rèvola	r 'ɛ β u l ə	 r 'ɛ β u l ə 
miri	m 'i ɾ i	 m 'i ɾ i 
Mirúrgia	m i ɾ 'u r ʒ i ə	 m i ɾ 'u r ʒ i ə 
mecanografiats	m ə k ə n u ɣ ɾ ə f i 'a t s	 m ə k ə n u ɣ ɾ ə f i 'a t s 
gingivitis	ʒ i n ʒ i β 'i t i s	 ʒ i n ʒ i β 'i t i s 
Neteja	n ə t 'ɛ ʒ ə	 n ə t 'ɛ ʒ ə 
alliberades	ə ʎ i β ə ɾ 'a ð ə s	 ə ʎ i β ə ɾ 'a ð ə s 
mostres	m 'ɔ s t ɾ ə s	 m 'ɔ s t ɾ ə s 
proposades	p ɾ u p u z 'a ð ə s	 p ɾ u p u z 'a ð ə s 
enderrocat	ə n d ə r u k 'a t	 ə n d ə r u k 'a t 
d'engrunes	d ə ŋ g ɾ 'u n ə s	 d ə ŋ g ɾ 'u n ə s 
subestimava	s u p ə s t i m 'a β ə	 s u p ə s t i m 'a β ə 
convertia	k u m b ə r t 'i ə	 k u m b ə r t 'i ə 
ferms	f 'ɛ r m s	 f 'ɛ r m s 
trama	t ɾ 'a m ə	 t ɾ 'a m ə 
regulades	r ə ɣ u l 'a ð ə s	 r ə ɣ u l 'a ð ə s 
venerarem	b ə n ə ɾ ə ɾ 'ɛ m	 b ə n ə ɾ ə ɾ 'ɛ m 
plat	p l 'a t	 p l 'a t 
vexat	b ə k s 'a t	 b ə k s 'a t 
llevats	ʎ ə β 'a t s	 ʎ ə β 'a t s 
plegats	p l ə ɣ 'a t s	 p l ə ɣ 'a t s 
dissipar	d i s i p 'a	 d i s i p 'a 
trompeta	t ɾ u m p 'ɛ t ə	 t ɾ u m p 'ɛ t ə 
dicti	d 'i k t i	 d 'i k t i 
ziriè	z i ɾ i 'ɛ	 z i ɾ i 'ɛ 
desvetllades	d ə z β ə ʎ ʎ 'a ð ə s	 d ə z β ə ʎ ʎ 'a ð ə s 
Antena	ə n t 'ɛ n ə	 ə n t 'ɛ n ə 
protecció	p ɾ u t ə k s i 'o	 p ɾ u t ə k s i 'o 
Completar	k u m p l ə t 'a	 k u m p l ə t 'a 
ensitjada	ə n s i d ʒ 'a ð ə	 ə n s i d ʒ 'a ð ə 
melangia	m ə l ə n ʒ 'i ə	 m ə l ə n ʒ 'i ə 
Posidó	p u z i ð 'o	 p u z i ð 'o 
beates	b e 'a t ə s	 b e 'a t ə s 
l'avaluació	l ə β ə l u ə s i 'o	 l ə β ə l u ə s i 'o 
Berlín	b ə r l 'i n	 b ə r l 'i n 
explicarà	ə k s p l i k ə ɾ 'a	 ə k s p l i k ə ɾ 'a 
baixava	b ə ʃ 'a β ə	 b ə ʃ 'a β ə 
esmolada	ə z m u l 'a ð ə	 ə z m u l 'a ð ə 
oxigenació	u k s i ʒ ə n ə s i 'o	 u k s i ʒ ə n ə s i 'o 
Gràcia	g ɾ 'a s i ə	 g ɾ 'a s i ə 
trofeu	t ɾ u f 'ɛ w	 t ɾ u f 'ɛ w 
avortó	ə β u r t 'o	 ə β u r t 'o 
considerables	k u n s i ð ə ɾ 'a b b l ə s	 k u n s i ð ə ɾ 'a b b l ə s 
patir	p ə t 'i	 p ə t 'i 
fantasiós	f ə n t ə z i 'o s	 f ə n t ə z i 'o s 
eficiència	ə f i s i 'ɛ n s i ə	 ə f i s i 'ɛ n s i ə 
esgarrifoses	ə z ɣ ə r i f 'o z ə s	 ə z ɣ ə r i f 'o z ə s 
ample	'a m p l ə	 'a m p l ə 
estudiant	ə s t u ð i 'a n	 ə s t u ð i 'a n 
xocolatina	ʃ u k u l ə t 'i n ə	 ʃ u k u l ə t 'i n ə 
motiu	m u t 'i w	 m u t 'i w 
començarà	k u m ə n s ə ɾ 'a	 k u m ə n s ə ɾ 'a 
resseguida	r ə s ə ɣ 'i ð ə	 r ə s ə ɣ 'i ð ə 
traumàtic	t ɾ ə w m 'a t i k	 t ɾ ə w m 'a t i k 
pava	p 'a β ə	 p 'a β ə 
vulnerari	b u l n ə ɾ 'a ɾ i	 b u l n ə ɾ 'a ɾ i 
baqueta	b ə k 'ɛ t ə	 b ə k 'ɛ t ə 
ascensor	ə s ə n s 'o	 ə s ə n s 'o 
diminut	d i m i n 'u t	 d i m i n 'u t 
lis	l 'i s	 l 'i s 
papissotejar	p ə p i s u t ə ʒ 'a	 p ə p i s u t ə ʒ 'a 
costures	k u s t 'u ɾ ə s	 k u s t 'u ɾ ə s 
redefinia	r ə ð ə f i n 'i ə	 r ə ð ə f i n 'i ə 
palatalització	p ə l ə t ə l i d z ə s i 'o	 p ə l ə t ə l i d z ə s i 'o 
encomi	ə ŋ k 'ɔ m i	 ə ŋ k 'ɔ m i 
satures	s ə t 'u ɾ ə s	 s ə t 'u ɾ ə s 
bassal	b ə s 'a l	 b ə s 'a l 
seixanta	s ə ʃ 'a n t ə	 s ə ʃ 'a n t ə 
compassions	k u m p ə s i 'o n s	 k u m p ə s i 'o n s 
subestimàrem	s u p ə s t i m 'a ɾ ə m	 s u p ə s t i m 'a ɾ ə m 
nyàmera	ɲ 'a m ə ɾ ə	 ɲ 'a m ə ɾ ə 
Fàdua	f 'a ð u ə	 f 'a ð u ə 
pipeta	p i p 'ɛ t ə	 p i p 'ɛ t ə 
esperma	ə s p 'ɛ r m ə	 ə s p 'ɛ r m ə 
clar	k l 'a	 k l 'a 
traslladats	t ɾ ə z ʎ ə ð 'a t s	 t ɾ ə z ʎ ə ð 'a t s 
edificada	ə ð i f i k 'a ð ə	 ə ð i f i k 'a ð ə 
Alexandria	ə l ə k s ə n d ɾ 'i ə	 ə l ə k s ə n d ɾ 'i ə 
trossen	t ɾ 'ɔ s ə n	 t ɾ 'ɔ s ə n 
palpable	p ə l p 'a b b l ə	 p ə l p 'a b b l ə 
abdicarà	ə b d i k ə ɾ 'a	 ə b d i k ə ɾ 'a 
cinemàtics	s i n ə m 'a t i k s	 s i n ə m 'a t i k s 
estilístics	ə s t i l 'i s t i k s	 ə s t i l 'i s t i k s 
hidrur	i ð ɾ 'u	 i ð ɾ 'u 
proposen	p ɾ u p 'ɔ z ə n	 p ɾ u p 'ɔ z ə n 
impressores	i m p ɾ ə s 'o ɾ ə s	 i m p ɾ ə s 'o ɾ ə s 
dedicarà	d ə ð i k ə ɾ 'a	 d ə ð i k ə ɾ 'a 
potàssics	p u t 'a s i k s	 p u t 'a s i k s 
funcionalitat	f u n s i u n ə l i t 'a t	 f u n s i u n ə l i t 'a t 
pasturades	p ə s t u ɾ 'a ð ə s	 p ə s t u ɾ 'a ð ə s 
soroll	s u ɾ 'o ʎ	 s u ɾ 'o ʎ 
motoritzada	m u t u ɾ i d z 'a ð ə	 m u t u ɾ i d z 'a ð ə 
Pep	p 'ɛ p	 p 'ɛ p 
deixada	d ə ʃ 'a ð ə	 d ə ʃ 'a ð ə 
microscòpica	m i k ɾ u s k 'ɔ p i k ə	 m i k ɾ u s k 'ɔ p i k ə 
emmarcats	ə m m ə r k 'a t s	 ə m m ə r k 'a t s 
porter	p u r t 'e	 p u r t 'e 
judicialització	ʒ u ð i s i ə l i d z ə s i 'o	 ʒ u ð i s i ə l i d z ə s i 'o 
caperó	k ə p ə ɾ 'o	 k ə p ə ɾ 'o 
parodiada	p ə ɾ u ð i 'a ð ə	 p ə ɾ u ð i 'a ð ə 
vocalitzades	b u k ə l i d z 'a ð ə s	 b u k ə l i d z 'a ð ə s 
elegies	ə l ə ʒ 'i ə s	 ə l ə ʒ 'i ə s 
fracassada	f ɾ ə k ə s 'a ð ə	 f ɾ ə k ə s 'a ð ə 
capritxos	k ə p ɾ 'i t ʃ u s	 k ə p ɾ 'i t ʃ u s 
partides	p ə r t 'i ð ə s	 p ə r t 'i ð ə s 
apropiat	ə p ɾ u p i 'a t	 ə p ɾ u p i 'a t 
obridor	u β ɾ i ð 'o	 u β ɾ i ð 'o 
complicacions	k u m p l i k ə s i 'o n s	 k u m p l i k ə s i 'o n s 
comunistes	k u m u n 'i s t ə s	 k u m u n 'i s t ə s 
apagada	ə p ə ɣ 'a ð ə	 ə p ə ɣ 'a ð ə 
apliquem	ə p l i k 'ɛ m	 ə p l i k 'ɛ m 
rerepaís	r ə ɾ ə p ə 'i s	 r ə ɾ ə p ə 'i s 
alien	ə l 'i ə n	 ə l 'i ə n 
raspall	r ə s p 'a ʎ	 r ə s p 'a ʎ 
bisexuals	b i s ə k s u 'a l s	 b i s ə k s u 'a l s 
gratant	g ɾ ə t 'a n	 g ɾ ə t 'a n 
depauperar	d ə p ə w p ə ɾ 'a	 d ə p ə w p ə ɾ 'a 
endevinalla	ə n d ə β i n 'a ʎ ə	 ə n d ə β i n 'a ʎ ə 
damasquina	d ə m ə s k 'i n ə	 d ə m ə s k 'i n ə 
gènesi	ʒ 'ɛ n ə z i	 ʒ 'ɛ n ə z i 
llenguado	ʎ ə ŋ g w 'a ð u	 ʎ ə ŋ g w 'a ð u 
desvinculades	d ə z β i ŋ k u l 'a ð ə s	 d ə z β i ŋ k u l 'a ð ə s 
Antigua	ə n t 'i ɣ w ə	 ə n t 'i ɣ w ə 
músculs	m 'u s k u l s	 m 'u s k u l s 
declarares	d ə k l ə ɾ 'a ɾ ə s	 d ə k l ə ɾ 'a ɾ ə s 
desproporcionades	d ə s p ɾ u p u r s i u n 'a ð ə s	 d ə s p ɾ u p u r s i u n 'a ð ə s 
expressar	ə k s p ɾ ə s 'a	 ə k s p ɾ ə s 'a 
implantada	i m p l ə n t 'a ð ə	 i m p l ə n t 'a ð ə 
apurat	ə p u ɾ 'a t	 ə p u ɾ 'a t 
vaporitzades	b ə p u ɾ i d z 'a ð ə s	 b ə p u ɾ i d z 'a ð ə s 
abranda	ə β ɾ 'a n d ə	 ə β ɾ 'a n d ə 
senyals	s ə ɲ 'a l s	 s ə ɲ 'a l s 
Multimèdia	m u l t i m 'ɛ ð i ə	 m u l t i m 'ɛ ð i ə 
permès	p ə r m 'ɛ s	 p ə r m 'ɛ s 
peluts	p ə l 'u t s	 p ə l 'u t s 
messies	m ə s 'i ə s	 m ə s 'i ə s 
Dreceres	d ɾ ə s 'e ɾ ə s	 d ɾ ə s 'e ɾ ə s 
menú	m ə n 'u	 m ə n 'u 
culpabilitats	k u l p ə β i l i t 'a t s	 k u l p ə β i l i t 'a t s 
divises	d i β 'i z ə s	 d i β 'i z ə s 
nitrós	n i t ɾ 'o s	 n i t ɾ 'o s 
dinovè	d i n u β 'ɛ	 d i n u β 'ɛ 
cafeïna	k ə f ə 'i n ə	 k ə f ə 'i n ə 
empirista	ə m p i ɾ 'i s t ə	 ə m p i ɾ 'i s t ə 
trobis	t ɾ 'ɔ β i s	 t ɾ 'ɔ β i s 
militarista	m i l i t ə ɾ 'i s t ə	 m i l i t ə ɾ 'i s t ə 
aclarir	ə k l ə ɾ 'i	 ə k l ə ɾ 'i 
Terrassa	t ə r 'a s ə	 t ə r 'a s ə 
plasmar	p l ə z m 'a	 p l ə z m 'a 
tagarnina	t ə ɣ ə r n 'i n ə	 t ə ɣ ə r n 'i n ə 
rendits	r ə n d 'i t s	 r ə n d 'i t s 
carteria	k ə r t ə ɾ 'i ə	 k ə r t ə ɾ 'i ə 
envoltaven	ə m b u l t 'a β ə n	 ə m b u l t 'a β ə n 
inspirar	i n s p i ɾ 'a	 i n s p i ɾ 'a 
escarrassades	ə s k ə r ə s 'a ð ə s	 ə s k ə r ə s 'a ð ə s 
premia	p ɾ ə m 'i ə	 p ɾ ə m 'i ə 
cruïlla	k ɾ u 'i ʎ ə	 k ɾ u 'i ʎ ə 
homenatge	u m ə n 'a d ʒ ə	 u m ə n 'a d ʒ ə 
trinxades	t ɾ i n ʃ 'a ð ə s	 t ɾ i n ʃ 'a ð ə s 
adiabàtica	ə ð i ə β 'a t i k ə	 ə ð i ə β 'a t i k ə 
posà	p u z 'a	 p u z 'a 
catalpa	k ə t 'a l p ə	 k ə t 'a l p ə 
bust	b 'u s t	 b 'u s t 
metall	m ə t 'a ʎ	 m ə t 'a ʎ 
aconsellats	ə k u n s ə ʎ 'a t s	 ə k u n s ə ʎ 'a t s 
morigerar	m u ɾ i ʒ ə ɾ 'a	 m u ɾ i ʒ ə ɾ 'a 
instant	i n s t 'a n	 i n s t 'a n 
cumulè	k u m u l 'ɛ	 k u m u l 'ɛ 
deltes	d 'ɛ l t ə s	 d 'ɛ l t ə s 
perorada	p ə ɾ u ɾ 'a ð ə	 p ə ɾ u ɾ 'a ð ə 
titulat	t i t u l 'a t	 t i t u l 'a t 
concretar	k u ŋ k ɾ ə t 'a	 k u ŋ k ɾ ə t 'a 
dilatat	d i l ə t 'a t	 d i l ə t 'a t 
escassesa	ə s k ə s 'ɛ z ə	 ə s k ə s 'ɛ z ə 
acceptada	ə k s ə p t 'a ð ə	 ə k s ə p t 'a ð ə 
electorat	ə l ə k t u ɾ 'a t	 ə l ə k t u ɾ 'a t 
tenir-ne	t ə n 'i r n ə	 t ə n 'i r n ə 
destituir	d ə s t i t u 'i	 d ə s t i t u 'i 
simulada	s i m u l 'a ð ə	 s i m u l 'a ð ə 
calòric	k ə l 'ɔ ɾ i k	 k ə l 'ɔ ɾ i k 
Àlaba	'a l ə β ə	 'a l ə β ə 
Medina	m ə ð 'i n ə	 m ə ð 'i n ə 
entrenador	ə n t ɾ ə n ə ð 'o	 ə n t ɾ ə n ə ð 'o 
esgotada	ə z ɣ u t 'a ð ə	 ə z ɣ u t 'a ð ə 
comercialitzi	k u m ə r s i ə l 'i d z i	 k u m ə r s i ə l 'i d z i 
drap	d ɾ 'a p	 d ɾ 'a p 
esclafades	ə s k l ə f 'a ð ə s	 ə s k l ə f 'a ð ə s 
orades	u ɾ 'a ð ə s	 u ɾ 'a ð ə s 
alineades	ə l i n e 'a ð ə s	 ə l i n e 'a ð ə s 
amarrar	ə m ə r 'a	 ə m ə r 'a 
Terrassa	t ə r 'a s ə	 t ə r 'a s ə 
avorrida	ə β u r 'i ð ə	 ə β u r 'i ð ə 
coagulant	k u ə ɣ u l 'a n	 k u ə ɣ u l 'a n 
porrassina	p u r ə s 'i n ə	 p u r ə s 'i n ə 
Opina	u p 'i n ə	 u p 'i n ə 
pesuc	p ə z 'u k	 p ə z 'u k 
silicat	s i l i k 'a t	 s i l i k 'a t 
amputada	ə m p u t 'a ð ə	 ə m p u t 'a ð ə 
cauteritzat	k ə w t ə ɾ i d z 'a t	 k ə w t ə ɾ i d z 'a t 
encertat	ə n s ə r t 'a t	 ə n s ə r t 'a t 
llegats	ʎ ə ɣ 'a t s	 ʎ ə ɣ 'a t s 
impecable	i m p ə k 'a b b l ə	 i m p ə k 'a b b l ə 
existia	ə g z i s t 'i ə	 ə g z i s t 'i ə 
perfumat	p ə r f u m 'a t	 p ə r f u m 'a t 
bestiaris	b ə s t i 'a ɾ i s	 b ə s t i 'a ɾ i s 
subsistència	s u p s i s t 'ɛ n s i ə	 s u p s i s t 'ɛ n s i ə 
cogui	k 'ɔ ɣ i	 k 'ɔ ɣ i 
dubtats	d u p t 'a t s	 d u p t 'a t s 
cursa	k 'u r s ə	 k 'u r s ə 
ululat	u l u l 'a t	 u l u l 'a t 
Barcelona	b ə r s ə l 'o n ə	 b ə r s ə l 'o n ə 
oportunisme	u p u r t u n 'i z m ə	 u p u r t u n 'i z m ə 
radó	r ə ð 'o	 r ə ð 'o 
delerosa	d ə l ə ɾ 'o z ə	 d ə l ə ɾ 'o z ə 
eclipsats	ə k l i p s 'a t s	 ə k l i p s 'a t s 
riera	r i 'e ɾ ə	 r i 'e ɾ ə 
pòstit	p 'ɔ s t i t	 p 'ɔ s t i t 
apartament	ə p ə r t ə m 'e n	 ə p ə r t ə m 'e n 
mongol	m u ŋ g 'ɔ l	 m u ŋ g 'ɔ l 
auspici	ə w s p 'i s i	 ə w s p 'i s i 
gelem	ʒ ə l 'ɛ m	 ʒ ə l 'ɛ m 
Setena	s ə t 'ɛ n ə	 s ə t 'ɛ n ə 
entrar	ə n t ɾ 'a	 ə n t ɾ 'a 
satanisme	s ə t ə n 'i z m ə	 s ə t ə n 'i z m ə 
digitalització	d i ʒ i t ə l i d z ə s i 'o	 d i ʒ i t ə l i d z ə s i 'o 
Magí	m ə ʒ 'i	 m ə ʒ 'i 
perit	p ə ɾ 'i t	 p ə ɾ 'i t 
sentit	s ə n t 'i t	 s ə n t 'i t 
espessir	ə s p ə s 'i	 ə s p ə s 'i 
obsolets	u p s u l 'ɛ t s	 u p s u l 'ɛ t s 
eludits	ə l u ð 'i t s	 ə l u ð 'i t s 
propis	p ɾ 'ɔ p i s	 p ɾ 'ɔ p i s 
sèrie	s 'ɛ ɾ i ə	 s 'ɛ ɾ i ə 
d'eficàcia	d ə f i k 'a s i ə	 d ə f i k 'a s i ə 
d'usar	d u z 'a	 d u z 'a 
clítica	k l 'i t i k ə	 k l 'i t i k ə 
publicitàries	p u β l i s i t 'a ɾ i ə s	 p u β l i s i t 'a ɾ i ə s 
complexes	k u m p l 'ɛ k s ə s	 k u m p l 'ɛ k s ə s 
castanya	k ə s t 'a ɲ ə	 k ə s t 'a ɲ ə 
afortunat	ə f u r t u n 'a t	 ə f u r t u n 'a t 
blindats	b l i n d 'a t s	 b l i n d 'a t s 
ajuntament	ə ʒ u n t ə m 'e n	 ə ʒ u n t ə m 'e n 
pensi	p 'ɛ n s i	 p 'ɛ n s i 
tolerat	t u l ə ɾ 'a t	 t u l ə ɾ 'a t 
abiològica	ə β i u l 'ɔ ʒ i k ə	 ə β i u l 'ɔ ʒ i k ə 
Mostrarem	m u s t ɾ ə ɾ 'ɛ m	 m u s t ɾ ə ɾ 'ɛ m 
Laia	l 'a j ə	 l 'a j ə 
neret	n ə ɾ 'ɛ t	 n ə ɾ 'ɛ t 
acabats	ə k ə β 'a t s	 ə k ə β 'a t s 
catalítics	k ə t ə l 'i t i k s	 k ə t ə l 'i t i k s 
funcionarà	f u n s i u n ə ɾ 'a	 f u n s i u n ə ɾ 'a 
borsària	b u r s 'a ɾ i ə	 b u r s 'a ɾ i ə 
administrat	ə d m i n i s t ɾ 'a t	 ə d m i n i s t ɾ 'a t 
contrarestades	k u n t ɾ ə ɾ ə s t 'a ð ə s	 k u n t ɾ ə ɾ ə s t 'a ð ə s 
escurçó	ə s k u r s 'o	 ə s k u r s 'o 
simbolisme	s i m b u l 'i z m ə	 s i m b u l 'i z m ə 
toca	t 'ɔ k ə	 t 'ɔ k ə 
presumit	p ɾ ə z u m 'i t	 p ɾ ə z u m 'i t 
profanes	p ɾ u f 'a n ə s	 p ɾ u f 'a n ə s 
inseparable	i n s ə p ə ɾ 'a b b l ə	 i n s ə p ə ɾ 'a b b l ə 
s'espera	s ə s p 'e ɾ ə	 s ə s p 'e ɾ ə 
libanès	l i β ə n 'ɛ s	 l i β ə n 'ɛ s 
acabarem	ə k ə β ə ɾ 'ɛ m	 ə k ə β ə ɾ 'ɛ m 
tindré	t i n d ɾ 'e	 t i n d ɾ 'e 
planeta	p l ə n 'ɛ t ə	 p l ə n 'ɛ t ə 
Gibraltar	ʒ i β ɾ ə l t 'a	 ʒ i β ɾ ə l t 'a 
pruït	p ɾ u 'i t	 p ɾ u 'i t 
diàfana	d i 'a f ə n ə	 d i 'a f ə n ə 
jonc	ʒ 'o ŋ	 ʒ 'o ŋ 
badies	b ə ð 'i ə s	 b ə ð 'i ə s 
anhela	ə n 'ɛ l ə	 ə n 'ɛ l ə 
citava	s i t 'a β ə	 s i t 'a β ə 
calories	k ə l u ɾ 'i ə s	 k ə l u ɾ 'i ə s 
ansietat	ə n s i ə t 'a t	 ə n s i ə t 'a t 
abonyegar	ə β u ɲ ə ɣ 'a	 ə β u ɲ ə ɣ 'a 
cismàtic	s i z m 'a t i k	 s i z m 'a t i k 
Trucades	t ɾ u k 'a ð ə s	 t ɾ u k 'a ð ə s 
regir	r ə ʒ 'i	 r ə ʒ 'i 
Procura	p ɾ u k 'u ɾ ə	 p ɾ u k 'u ɾ ə 
Filipines	f i l i p 'i n ə s	 f i l i p 'i n ə s 
Togo	t 'ɔ ɣ u	 t 'ɔ ɣ u 
factories	f ə k t u ɾ 'i ə s	 f ə k t u ɾ 'i ə s 
picor	p i k 'o	 p i k 'o 
qatariana	k ə t ə ɾ i 'a n ə	 k ə t ə ɾ i 'a n ə 
francès	f ɾ ə n s 'ɛ s	 f ɾ ə n s 'ɛ s 
permeable	p ə r m e 'a b b l ə	 p ə r m e 'a b b l ə 
descarregar	d ə s k ə r ə ɣ 'a	 d ə s k ə r ə ɣ 'a 
directoris	d i ɾ ə k t 'ɔ ɾ i s	 d i ɾ ə k t 'ɔ ɾ i s 
fortes	f 'ɔ r t ə s	 f 'ɔ r t ə s 
passadís	p ə s ə ð 'i s	 p ə s ə ð 'i s 
equivocat	ə k i β u k 'a t	 ə k i β u k 'a t 
enrogallar	ə n r u ɣ ə ʎ 'a	 ə n r u ɣ ə ʎ 'a 
angiïtis	ə n ʒ i 'i t i s	 ə n ʒ i 'i t i s 
torri	t 'ɔ r i	 t 'ɔ r i 
clorat	k l u ɾ 'a t	 k l u ɾ 'a t 
prevenir	p ɾ ə β ə n 'i	 p ɾ ə β ə n 'i 
restaurat	r ə s t ə w ɾ 'a t	 r ə s t ə w ɾ 'a t 
Pasqua	p 'a s k w ə	 p 'a s k w ə 
astut	ə s t 'u t	 ə s t 'u t 
escrivint	ə s k ɾ i β 'i n	 ə s k ɾ i β 'i n 
fingir	f i n ʒ 'i	 f i n ʒ 'i 
escombraries	ə s k u m b ɾ ə ɾ 'i ə s	 ə s k u m b ɾ ə ɾ 'i ə s 
reincidència	r ə i n s i ð 'ɛ n s i ə	 r ə i n s i ð 'ɛ n s i ə 
pedalats	p ə ð ə l 'a t s	 p ə ð ə l 'a t s 
teratogèniques	t ə ɾ ə t u ʒ 'ɛ n i k ə s	 t ə ɾ ə t u ʒ 'ɛ n i k ə s 
fonollada	f u n u ʎ 'a ð ə	 f u n u ʎ 'a ð ə 
agafo	ə ɣ 'a f u	 ə ɣ 'a f u 
d'artilleria	d ə r t i ʎ ə ɾ 'i ə	 d ə r t i ʎ ə ɾ 'i ə 
ullerós	u ʎ ə ɾ 'o s	 u ʎ ə ɾ 'o s 
raspador	r ə s p ə ð 'o	 r ə s p ə ð 'o 
verrucós	b ə r u k 'o s	 b ə r u k 'o s 
molinades	m u l i n 'a ð ə s	 m u l i n 'a ð ə s 
detriment	d ə t ɾ i m 'e n	 d ə t ɾ i m 'e n 
sínia	s 'i n i ə	 s 'i n i ə 
salada	s ə l 'a ð ə	 s ə l 'a ð ə 
escoltem	ə s k u l t 'ɛ m	 ə s k u l t 'ɛ m 
Judicial	ʒ u ð i s i 'a l	 ʒ u ð i s i 'a l 
destinació	d ə s t i n ə s i 'o	 d ə s t i n ə s i 'o 
secretats	s ə k ɾ ə t 'a t s	 s ə k ɾ ə t 'a t s 
alada	ə l 'a ð ə	 ə l 'a ð ə 
ionitzar	i u n i d z 'a	 i u n i d z 'a 
aparcat	ə p ə r k 'a t	 ə p ə r k 'a t 
d'anàlisi	d ə n 'a l i z i	 d ə n 'a l i z i 
condemnat	k u n d ə m n 'a t	 k u n d ə m n 'a t 
cuida	k 'u j ð ə	 k 'u j ð ə 
estalviar	ə s t ə l β i 'a	 ə s t ə l β i 'a 
obri	'ɔ β ɾ i	 'ɔ β ɾ i 
Marxava	m ə r ʃ 'a β ə	 m ə r ʃ 'a β ə 
depurador	d ə p u ɾ ə ð 'o	 d ə p u ɾ ə ð 'o 
fòbia	f 'ɔ β i ə	 f 'ɔ β i ə 
antagonistes	ə n t ə ɣ u n 'i s t ə s	 ə n t ə ɣ u n 'i s t ə s 
agrícola	ə ɣ ɾ 'i k u l ə	 ə ɣ ɾ 'i k u l ə 
humanitat	u m ə n i t 'a t	 u m ə n i t 'a t 
concentració	k u n s ə n t ɾ ə s i 'o	 k u n s ə n t ɾ ə s i 'o 
concrecions	k u ŋ k ɾ ə s i 'o n s	 k u ŋ k ɾ ə s i 'o n s 
solemnes	s u l 'ɛ m n ə s	 s u l 'ɛ m n ə s 
ambient	ə m b i 'e n	 ə m b i 'e n 
hipòtesi	i p 'ɔ t ə z i	 i p 'ɔ t ə z i 
abraçades	ə β ɾ ə s 'a ð ə s	 ə β ɾ ə s 'a ð ə s 
útilment	'u t i l m 'e n	 'u t i l m 'e n 
àlgic	'a l ʒ i k	 'a l ʒ i k 
banqueta	b ə ŋ k 'ɛ t ə	 b ə ŋ k 'ɛ t ə 
patentar	p ə t ə n t 'a	 p ə t ə n t 'a 
suares	s u 'a ɾ ə s	 s u 'a ɾ ə s 
nuls	n 'u l s	 n 'u l s 
sasserès	s ə s ə ɾ 'ɛ s	 s ə s ə ɾ 'ɛ s 
discs	d 'i s k s	 d 'i s k s 
impartida	i m p ə r t 'i ð ə	 i m p ə r t 'i ð ə 
activat	ə k t i β 'a t	 ə k t i β 'a t 
llepades	ʎ ə p 'a ð ə s	 ʎ ə p 'a ð ə s 
varies	b ə ɾ 'i ə s	 b ə ɾ 'i ə s 
Crits	k ɾ 'i t s	 k ɾ 'i t s 
caniques	k ə n 'i k ə s	 k ə n 'i k ə s 
avalada	ə β ə l 'a ð ə	 ə β ə l 'a ð ə 
detonacions	d ə t u n ə s i 'o n s	 d ə t u n ə s i 'o n s 
bastarem	b ə s t ə ɾ 'ɛ m	 b ə s t ə ɾ 'ɛ m 
quitina	k i t 'i n ə	 k i t 'i n ə 
beat	b e 'a t	 b e 'a t 
beques	b 'ɛ k ə s	 b 'ɛ k ə s 
rehabilitació	r e ə β i l i t ə s i 'o	 r e ə β i l i t ə s i 'o 
dominó	d u m i n 'o	 d u m i n 'o 
espio	ə s p 'i u	 ə s p 'i u 
aliances	ə l i 'a n s ə s	 ə l i 'a n s ə s 
desigual	d ə z i ɣ w 'a l	 d ə z i ɣ w 'a l 
acídul	ə s 'i ð u l	 ə s 'i ð u l 
salari	s ə l 'a ɾ i	 s ə l 'a ɾ i 
avui	ə β 'u j	 ə β 'u j 
somriure	s u m r 'i w ɾ ə	 s u m r 'i w ɾ ə 
animació	ə n i m ə s i 'o	 ə n i m ə s i 'o 
immunològics	i m m u n u l 'ɔ ʒ i k s	 i m m u n u l 'ɔ ʒ i k s 
assessors	ə s ə s 'o s	 ə s ə s 'o s 
elàstics	ə l 'a s t i k s	 ə l 'a s t i k s 
vencé	b ə n s 'e	 b ə n s 'e 
almoràvit	ə l m u ɾ 'a β i t	 ə l m u ɾ 'a β i t 
patrocinat	p ə t ɾ u s i n 'a t	 p ə t ɾ u s i n 'a t 
majors	m ə ʒ 'o s	 m ə ʒ 'o s 
nard	n 'a r	 n 'a r 
dinàmiques	d i n 'a m i k ə s	 d i n 'a m i k ə s 
amazònic	ə m ə z 'ɔ n i k	 ə m ə z 'ɔ n i k 
evangèlica	ə β ə n ʒ 'ɛ l i k ə	 ə β ə n ʒ 'ɛ l i k ə 
antics	ə n t 'i k s	 ə n t 'i k s 
balancejar	b ə l ə n s ə ʒ 'a	 b ə l ə n s ə ʒ 'a 
físics	f 'i z i k s	 f 'i z i k s 
rampell	r ə m p 'e ʎ	 r ə m p 'e ʎ 
novè	n u β 'ɛ	 n u β 'ɛ 
bala	b 'a l ə	 b 'a l ə 
agulles	ə ɣ 'u ʎ ə s	 ə ɣ 'u ʎ ə s 
pastilles	p ə s t 'i ʎ ə s	 p ə s t 'i ʎ ə s 
distribucions	d i s t ɾ i β u s i 'o n s	 d i s t ɾ i β u s i 'o n s 
bitllet	b i ʎ ʎ 'ɛ t	 b i ʎ ʎ 'ɛ t 
suplir	s u p l 'i	 s u p l 'i 
esgarriar	ə z ɣ ə r i 'a	 ə z ɣ ə r i 'a 
tigres	t 'i ɣ ɾ ə s	 t 'i ɣ ɾ ə s 
usables	u z 'a b b l ə s	 u z 'a b b l ə s 
elitisme	ə l i t 'i z m ə	 ə l i t 'i z m ə 
cintes	s 'i n t ə s	 s 'i n t ə s 
flirtejar	f l i r t ə ʒ 'a	 f l i r t ə ʒ 'a 
pecadora	p ə k ə ð 'o ɾ ə	 p ə k ə ð 'o ɾ ə 
calaix	k ə l 'a ʃ	 k ə l 'a ʃ 
sonoritat	s u n u ɾ i t 'a t	 s u n u ɾ i t 'a t 
L'acumulació	l ə k u m u l ə s i 'o	 l ə k u m u l ə s i 'o 
sintonitzats	s i n t u n i d z 'a t s	 s i n t u n i d z 'a t s 
plaques	p l 'a k ə s	 p l 'a k ə s 
sensefeina	s ə n s ə f 'ɛ j n ə	 s ə n s ə f 'ɛ j n ə 
vorejats	b u ɾ ə ʒ 'a t s	 b u ɾ ə ʒ 'a t s 
canal	k ə n 'a l	 k ə n 'a l 
model	m u ð 'ɛ l	 m u ð 'ɛ l 
travessat	t ɾ ə β ə s 'a t	 t ɾ ə β ə s 'a t 
passades	p ə s 'a ð ə s	 p ə s 'a ð ə s 
bramades	b ɾ ə m 'a ð ə s	 b ɾ ə m 'a ð ə s 
adorà	ə ð u ɾ 'a	 ə ð u ɾ 'a 
menudes	m ə n 'u ð ə s	 m ə n 'u ð ə s 
dreta	d ɾ 'ɛ t ə	 d ɾ 'ɛ t ə 
oxímoron	u k s 'i m u ɾ u n	 u k s 'i m u ɾ u n 
senyalades	s ə ɲ ə l 'a ð ə s	 s ə ɲ ə l 'a ð ə s 
treu	t ɾ 'ɛ w	 t ɾ 'ɛ w 
fong	f 'o ŋ	 f 'o ŋ 
impresos	i m p ɾ 'ɛ z u s	 i m p ɾ 'ɛ z u s 
clavellada	k l ə β ə ʎ 'a ð ə	 k l ə β ə ʎ 'a ð ə 
coral	k u ɾ 'a l	 k u ɾ 'a l 
l'oftalmòleg	l u f t ə l m 'ɔ l ə k	 l u f t ə l m 'ɔ l ə k 
ocupats	u k u p 'a t s	 u k u p 'a t s 
sabria	s ə β ɾ 'i ə	 s ə β ɾ 'i ə 
esbart	ə z β 'a r t	 ə z β 'a r t 
comprant-se	k u m p ɾ 'a n s ə	 k u m p ɾ 'a n s ə 
oren	'ɔ ɾ ə n	 'ɔ ɾ ə n 
bronca	b ɾ 'ɔ ŋ k ə	 b ɾ 'ɔ ŋ k ə 
neurològic	n ə w ɾ u l 'ɔ ʒ i k	 n ə w ɾ u l 'ɔ ʒ i k 
empesos	ə m p 'ɛ z u s	 ə m p 'ɛ z u s 
antiga	ə n t 'i ɣ ə	 ə n t 'i ɣ ə 
gaèliques	g ə 'ɛ l i k ə s	 g ə 'ɛ l i k ə s 
Ribó	r i β 'o	 r i β 'o 
cadascun	k ə ð ə s k 'u n	 k ə ð ə s k 'u n 
limbe	l 'i m b ə	 l 'i m b ə 
persona	p ə r s 'o n ə	 p ə r s 'o n ə 
afegeixes	ə f ə ʒ 'ɛ ʃ ə s	 ə f ə ʒ 'ɛ ʃ ə s 
civeta	s i β 'ɛ t ə	 s i β 'ɛ t ə 
reni	r 'ɛ n i	 r 'ɛ n i 
fúmer	f 'u m ə r	 f 'u m ə r 
espicossar	ə s p i k u s 'a	 ə s p i k u s 'a 
Petites	p ə t 'i t ə s	 p ə t 'i t ə s 
concreció	k u ŋ k ɾ ə s i 'o	 k u ŋ k ɾ ə s i 'o 
preteses	p ɾ ə t 'ɛ z ə s	 p ɾ ə t 'ɛ z ə s 
pista	p 'i s t ə	 p 'i s t ə 
pesadesa	p ə z ə ð 'ɛ z ə	 p ə z ə ð 'ɛ z ə 
femenívol	f ə m ə n 'i β u l	 f ə m ə n 'i β u l 
Respongui	r ə s p 'ɔ ŋ g i	 r ə s p 'ɔ ŋ g i 
ennuvolat	ə n n u β u l 'a t	 ə n n u β u l 'a t 
Sessions	s ə s i 'o n s	 s ə s i 'o n s 
nínxol	n 'i n ʃ u l	 n 'i n ʃ u l 
veïna	b ə 'i n ə	 b ə 'i n ə 
coloració	k u l u ɾ ə s i 'o	 k u l u ɾ ə s i 'o 
gemir	ʒ ə m 'i	 ʒ ə m 'i 
Complements	k u m p l ə m 'e n s	 k u m p l ə m 'e n s 
creuar	k ɾ ə w 'a	 k ɾ ə w 'a 
conductives	k u n d u k t 'i β ə s	 k u n d u k t 'i β ə s 
coalició	k u ə l i s i 'o	 k u ə l i s i 'o 
apropant	ə p ɾ u p 'a n	 ə p ɾ u p 'a n 
immolades	i m m u l 'a ð ə s	 i m m u l 'a ð ə s 
animes	ə n 'i m ə s	 ə n 'i m ə s 
eclipsava	ə k l i p s 'a β ə	 ə k l i p s 'a β ə 
conceptual	k u n s ə p t u 'a l	 k u n s ə p t u 'a l 
descarnat	d ə s k ə r n 'a t	 d ə s k ə r n 'a t 
adinerades	ə ð i n ə ɾ 'a ð ə s	 ə ð i n ə ɾ 'a ð ə s 
vau	b 'a w	 b 'a w 
benes	b 'ɛ n ə s	 b 'ɛ n ə s 
intentar-ho	i n t ə n t 'a ɾ u	 i n t ə n t 'a ɾ u 
pisar	p i z 'a	 p i z 'a 
boixerica	b u ʃ ə ɾ 'i k ə	 b u ʃ ə ɾ 'i k ə 
codificares	k u ð i f i k 'a ɾ ə s	 k u ð i f i k 'a ɾ ə s 
convocatòria	k u m b u k ə t 'ɔ ɾ i ə	 k u m b u k ə t 'ɔ ɾ i ə 
arranjament	ə r ə n ʒ ə m 'e n	 ə r ə n ʒ ə m 'e n 
osteològics	u s t ə u l 'ɔ ʒ i k s	 u s t ə u l 'ɔ ʒ i k s 
balcó	b ə l k 'o	 b ə l k 'o 
tan	t 'a n	 t 'a n 
mata	m 'a t ə	 m 'a t ə 
falsedat	f ə l s ə ð 'a t	 f ə l s ə ð 'a t 
diana	d i 'a n ə	 d i 'a n ə 
pago	p 'a ɣ u	 p 'a ɣ u 
cànons	k 'a n u n s	 k 'a n u n s 
irreconeixibles	i r ə k u n ə ʃ 'i b b l ə s	 i r ə k u n ə ʃ 'i b b l ə s 
l'amplada	l ə m p l 'a ð ə	 l ə m p l 'a ð ə 
tebi	t 'ɛ β i	 t 'ɛ β i 
entremaliadures	ə n t ɾ ə m ə l i ə ð 'u ɾ ə s	 ə n t ɾ ə m ə l i ə ð 'u ɾ ə s 
instantanis	i n s t ə n t 'a n i s	 i n s t ə n t 'a n i s 
escama	ə s k 'a m ə	 ə s k 'a m ə 
collin	k 'ɔ ʎ i n	 k 'ɔ ʎ i n 
invertebrat	i m b ə r t ə β ɾ 'a t	 i m b ə r t ə β ɾ 'a t 
Agafo	ə ɣ 'a f u	 ə ɣ 'a f u 
Cançó	k ə n s 'o	 k ə n s 'o 
Un	'u n	 'u n 
branquillons	b ɾ ə ŋ k i ʎ 'o n s	 b ɾ ə ŋ k i ʎ 'o n s 
tubs	t 'u p s	 t 'u p s 
reciclats	r ə s i k l 'a t s	 r ə s i k l 'a t s 
castellanisme	k ə s t ə ʎ ə n 'i z m ə	 k ə s t ə ʎ ə n 'i z m ə 
fallats	f ə ʎ 'a t s	 f ə ʎ 'a t s 
Marràqueix	m ə r 'a k ə ʃ	 m ə r 'a k ə ʃ 
considerarà	k u n s i ð ə ɾ ə ɾ 'a	 k u n s i ð ə ɾ ə ɾ 'a 
limitares	l i m i t 'a ɾ ə s	 l i m i t 'a ɾ ə s 
mestís	m ə s t 'i s	 m ə s t 'i s 
llamàntol	ʎ ə m 'a n t u l	 ʎ ə m 'a n t u l 
advertit	ə d b ə r t 'i t	 ə d b ə r t 'i t 
incorregible	i ŋ k u r ə ʒ 'i b b l ə	 i ŋ k u r ə ʒ 'i b b l ə 
advertides	ə d b ə r t 'i ð ə s	 ə d b ə r t 'i ð ə s 
baixant	b ə ʃ 'a n	 b ə ʃ 'a n 
abaixem	ə β ə ʃ 'ɛ m	 ə β ə ʃ 'ɛ m 
esquilades	ə s k i l 'a ð ə s	 ə s k i l 'a ð ə s 
pellissa	p ə ʎ 'i s ə	 p ə ʎ 'i s ə 
Tarragona	t ə r ə ɣ 'o n ə	 t ə r ə ɣ 'o n ə 
apunts	ə p 'u n s	 ə p 'u n s 
caga	k 'a ɣ ə	 k 'a ɣ ə 
Educació	ə ð u k ə s i 'o	 ə ð u k ə s i 'o 
inhabilitar	i n ə β i l i t 'a	 i n ə β i l i t 'a 
vents	b 'e n s	 b 'e n s 
aclarides	ə k l ə ɾ 'i ð ə s	 ə k l ə ɾ 'i ð ə s 
fixats	f i k s 'a t s	 f i k s 'a t s 
consideraria	k u n s i ð ə ɾ ə ɾ 'i ə	 k u n s i ð ə ɾ ə ɾ 'i ə 
ofensiva	u f ə n s 'i β ə	 u f ə n s 'i β ə 
antic	ə n t 'i k	 ə n t 'i k 
pedicur	p ə ð i k 'u	 p ə ð i k 'u 
encriptar	ə ŋ k ɾ i p t 'a	 ə ŋ k ɾ i p t 'a 
desintegraria	d ə z i n t ə ɣ ɾ ə ɾ 'i ə	 d ə z i n t ə ɣ ɾ ə ɾ 'i ə 
congelaria	k u n ʒ ə l ə ɾ 'i ə	 k u n ʒ ə l ə ɾ 'i ə 
instituït	i n s t i t u 'i t	 i n s t i t u 'i t 
invaginar	i m b ə ʒ i n 'a	 i m b ə ʒ i n 'a 
siamesos	s i ə m 'ɛ z u s	 s i ə m 'ɛ z u s 
ceris	s 'ɛ ɾ i s	 s 'ɛ ɾ i s 
serpentària	s ə r p ə n t 'a ɾ i ə	 s ə r p ə n t 'a ɾ i ə 
no	n 'o	 n 'o 
Villena	b i ʎ 'ɛ n ə	 b i ʎ 'ɛ n ə 
brasiler	b ɾ ə z i l 'e	 b ɾ ə z i l 'e 
humit	u m 'i t	 u m 'i t 
abonar	ə β u n 'a	 ə β u n 'a 
fatxada	f ə t ʃ 'a ð ə	 f ə t ʃ 'a ð ə 
sentiment	s ə n t i m 'e n	 s ə n t i m 'e n 
capçó	k ə p s 'o	 k ə p s 'o 
agricultor	ə ɣ ɾ i k u l t 'o	 ə ɣ ɾ i k u l t 'o 
presidida	p ɾ ə z i ð 'i ð ə	 p ɾ ə z i ð 'i ð ə 
carruatge	k ə r u 'a d ʒ ə	 k ə r u 'a d ʒ ə 
vots	b 'ɔ t s	 b 'ɔ t s 
adormir-se	ə ð u r m 'i r s ə	 ə ð u r m 'i r s ə 
feminitzat	f ə m i n i d z 'a t	 f ə m i n i d z 'a t 
prevista	p ɾ ə β 'i s t ə	 p ɾ ə β 'i s t ə 
descontentar	d ə s k u n t ə n t 'a	 d ə s k u n t ə n t 'a 
bastits	b ə s t 'i t s	 b ə s t 'i t s 
expès	ə k s p 'ɛ s	 ə k s p 'ɛ s 
lírica	l 'i ɾ i k ə	 l 'i ɾ i k ə 
manejar	m ə n ə ʒ 'a	 m ə n ə ʒ 'a 
desconnectada	d ə s k u n n ə k t 'a ð ə	 d ə s k u n n ə k t 'a ð ə 
foguen	f 'ɔ ɣ ə n	 f 'ɔ ɣ ə n 
Frígia	f ɾ 'i ʒ i ə	 f ɾ 'i ʒ i ə 
entortellar	ə n t u r t ə ʎ 'a	 ə n t u r t ə ʎ 'a 
captivats	k ə p t i β 'a t s	 k ə p t i β 'a t s 
sortí	s u r t 'i	 s u r t 'i 
meravellosos	m ə ɾ ə β ə ʎ 'o z u s	 m ə ɾ ə β ə ʎ 'o z u s 
polinesi	p u l i n 'ɛ z i	 p u l i n 'ɛ z i 
convidarà	k u m b i ð ə ɾ 'a	 k u m b i ð ə ɾ 'a 
Cantàbria	k ə n t 'a β ɾ i ə	 k ə n t 'a β ɾ i ə 
complaguda	k u m p l ə ɣ 'u ð ə	 k u m p l ə ɣ 'u ð ə 
contraféu	k u n t ɾ ə f 'e w	 k u n t ɾ ə f 'e w 
safranó	s ə f ɾ ə n 'o	 s ə f ɾ ə n 'o 
temptació	t ə m t ə s i 'o	 t ə m t ə s i 'o 
obri	'ɔ β ɾ i	 'ɔ β ɾ i 
manipulat	m ə n i p u l 'a t	 m ə n i p u l 'a t 
reconquerida	r ə k u ŋ k ə ɾ 'i ð ə	 r ə k u ŋ k ə ɾ 'i ð ə 
capellà	k ə p ə ʎ 'a	 k ə p ə ʎ 'a 
estol	ə s t 'ɔ l	 ə s t 'ɔ l 
anticipats	ə n t i s i p 'a t s	 ə n t i s i p 'a t s 
parrús	p ə r 'u s	 p ə r 'u s 
punxó	p u n ʃ 'o	 p u n ʃ 'o 
condimentar	k u n d i m ə n t 'a	 k u n d i m ə n t 'a 
llamineria	ʎ ə m i n ə ɾ 'i ə	 ʎ ə m i n ə ɾ 'i ə 
malles	m 'a ʎ ə s	 m 'a ʎ ə s 
vertigen	b ə r t 'i ʒ ə n	 b ə r t 'i ʒ ə n 
ensitjarà	ə n s i d ʒ ə ɾ 'a	 ə n s i d ʒ ə ɾ 'a 
vells	b 'e ʎ s	 b 'e ʎ s 
nòvio	n 'ɔ β i u	 n 'ɔ β i u 
clavicèmbal	k l ə β i s 'ɛ m b ə l	 k l ə β i s 'ɛ m b ə l 
plutocràcia	p l u t u k ɾ 'a s i ə	 p l u t u k ɾ 'a s i ə 
comins	k u m 'i n s	 k u m 'i n s 
tipi	t 'i p i	 t 'i p i 
estiguis	ə s t 'i ɣ i s	 ə s t 'i ɣ i s 
Visualitzador	b i z u ə l i d z ə ð 'o	 b i z u ə l i d z ə ð 'o 
moixonet	m u ʃ u n 'ɛ t	 m u ʃ u n 'ɛ t 
caure	k 'a w ɾ ə	 k 'a w ɾ ə 
credo	k ɾ 'ɛ ð u	 k ɾ 'ɛ ð u 
saxó	s ə k s 'o	 s ə k s 'o 
Prefereixo	p ɾ ə f ə ɾ 'ɛ ʃ u	 p ɾ ə f ə ɾ 'ɛ ʃ u 
Príncep	p ɾ 'i n s ə p	 p ɾ 'i n s ə p 
fortificats	f u r t i f i k 'a t s	 f u r t i f i k 'a t s 
ensofrar	ə n s u f ɾ 'a	 ə n s u f ɾ 'a 
espermatòfit	ə s p ə r m ə t 'ɔ f i t	 ə s p ə r m ə t 'ɔ f i t 
fantasma	f ə n t 'a z m ə	 f ə n t 'a z m ə 
acadèmics	ə k ə ð 'ɛ m i k s	 ə k ə ð 'ɛ m i k s 
llars	ʎ 'a r s	 ʎ 'a r s 
menús	m ə n 'u s	 m ə n 'u s 
sifilítics	s i f i l 'i t i k s	 s i f i l 'i t i k s 
fluctuats	f l u k t u 'a t s	 f l u k t u 'a t s 
preguntin	p ɾ ə ɣ 'u n t i n	 p ɾ ə ɣ 'u n t i n 
desmantellar	d ə z m ə n t ə ʎ 'a	 d ə z m ə n t ə ʎ 'a 
aglomerar	ə ɣ l u m ə ɾ 'a	 ə ɣ l u m ə ɾ 'a 
acreditat	ə k ɾ ə ð i t 'a t	 ə k ɾ ə ð i t 'a t 
l'ultima	l u l t 'i m ə	 l u l t 'i m ə 
origen	u ɾ 'i ʒ ə n	 u ɾ 'i ʒ ə n 
emètic	ə m 'ɛ t i k	 ə m 'ɛ t i k 
completes	k u m p l 'ɛ t ə s	 k u m p l 'ɛ t ə s 
excedit	ə k s ə ð 'i t	 ə k s ə ð 'i t 
convertia	k u m b ə r t 'i ə	 k u m b ə r t 'i ə 
fermentats	f ə r m ə n t 'a t s	 f ə r m ə n t 'a t s 
prostro	p ɾ 'ɔ s t ɾ u	 p ɾ 'ɔ s t ɾ u 
cerimonial	s ə ɾ i m u n i 'a l	 s ə ɾ i m u n i 'a l 
Unitats	u n i t 'a t s	 u n i t 'a t s 
vocació	b u k ə s i 'o	 b u k ə s i 'o 
baga	b 'a ɣ ə	 b 'a ɣ ə 
programari	p ɾ u ɣ ɾ ə m 'a ɾ i	 p ɾ u ɣ ɾ ə m 'a ɾ i 
besuny	b ə z 'u ɲ	 b ə z 'u ɲ 
serpentí	s ə r p ə n t 'i	 s ə r p ə n t 'i 
destinaria	d ə s t i n ə ɾ 'i ə	 d ə s t i n ə ɾ 'i ə 
manomètrica	m ə n u m 'ɛ t ɾ i k ə	 m ə n u m 'ɛ t ɾ i k ə 
llong	ʎ 'o ŋ	 ʎ 'o ŋ 
dada	d 'a ð ə	 d 'a ð ə 
lexicalitzades	l ə k s i k ə l i d z 'a ð ə s	 l ə k s i k ə l i d z 'a ð ə s 
trencada	t ɾ ə ŋ k 'a ð ə	 t ɾ ə ŋ k 'a ð ə 
alcalins	ə l k ə l 'i n s	 ə l k ə l 'i n s 
disseminares	d i s ə m i n 'a ɾ ə s	 d i s ə m i n 'a ɾ ə s 
brossen	b ɾ 'ɔ s ə n	 b ɾ 'ɔ s ə n 
rebutjada	r ə β u d ʒ 'a ð ə	 r ə β u d ʒ 'a ð ə 
abraçar-lo	ə β ɾ ə s 'a r l u	 ə β ɾ ə s 'a r l u 
agosarats	ə ɣ u z ə ɾ 'a t s	 ə ɣ u z ə ɾ 'a t s 
penetro	p ə n 'ɛ t ɾ u	 p ə n 'ɛ t ɾ u 
closques	k l 'ɔ s k ə s	 k l 'ɔ s k ə s 
venço	b 'ɛ n s u	 b 'ɛ n s u 
despès	d ə s p 'ɛ s	 d ə s p 'ɛ s 
fatalitat	f ə t ə l i t 'a t	 f ə t ə l i t 'a t 
peregrinades	p ə ɾ ə ɣ ɾ i n 'a ð ə s	 p ə ɾ ə ɣ ɾ i n 'a ð ə s 
prismàtiques	p ɾ i z m 'a t i k ə s	 p ɾ i z m 'a t i k ə s 
aperitiu	ə p ə ɾ i t 'i w	 ə p ə ɾ i t 'i w 
bojos	b 'ɔ ʒ u s	 b 'ɔ ʒ u s 
bisbe	b 'i z β ə	 b 'i z β ə 
porquet	p u r k 'ɛ t	 p u r k 'ɛ t 
prudència	p ɾ u ð 'ɛ n s i ə	 p ɾ u ð 'ɛ n s i ə 
analitzat	ə n ə l i d z 'a t	 ə n ə l i d z 'a t 
mormonisme	m u r m u n 'i z m ə	 m u r m u n 'i z m ə 
cegard	s ə ɣ 'a r	 s ə ɣ 'a r 
miniatura	m i n i ə t 'u ɾ ə	 m i n i ə t 'u ɾ ə 
llunyans	ʎ u ɲ 'a n s	 ʎ u ɲ 'a n s 
callar	k ə ʎ 'a	 k ə ʎ 'a 
tàntal	t 'a n t ə l	 t 'a n t ə l 
essent	ə s 'e n	 ə s 'e n 
pedicura	p ə ð i k 'u ɾ ə	 p ə ð i k 'u ɾ ə 
frustrar	f ɾ u s t ɾ 'a	 f ɾ u s t ɾ 'a 
bromes	b ɾ 'o m ə s	 b ɾ 'o m ə s 
erris	'ɛ r i s	 'ɛ r i s 
àmniques	'a m n i k ə s	 'a m n i k ə s 
lubrificar	l u β ɾ i f i k 'a	 l u β ɾ i f i k 'a 
Visca	b 'i s k ə	 b 'i s k ə 
almescat	ə l m ə s k 'a t	 ə l m ə s k 'a t 
otològics	u t u l 'ɔ ʒ i k s	 u t u l 'ɔ ʒ i k s 
eterns	ə t 'ɛ r n s	 ə t 'ɛ r n s 
promocionades	p ɾ u m u s i u n 'a ð ə s	 p ɾ u m u s i u n 'a ð ə s 
crim	k ɾ 'i m	 k ɾ 'i m 
antimicrobians	ə n t i m i k ɾ u β i 'a n s	 ə n t i m i k ɾ u β i 'a n s 
hostatge	u s t 'a d ʒ ə	 u s t 'a d ʒ ə 
surades	s u ɾ 'a ð ə s	 s u ɾ 'a ð ə s 
espàrrec	ə s p 'a r ə k	 ə s p 'a r ə k 
beatificar	b e ə t i f i k 'a	 b e ə t i f i k 'a 
talossans	t ə l u s 'a n s	 t ə l u s 'a n s 
ofegada	u f ə ɣ 'a ð ə	 u f ə ɣ 'a ð ə 
moliner	m u l i n 'e	 m u l i n 'e 
xisclades	ʃ i s k l 'a ð ə s	 ʃ i s k l 'a ð ə s 
dadà	d ə ð 'a	 d ə ð 'a 
obert	u β 'ɛ r t	 u β 'ɛ r t 
emigro	ə m 'i ɣ ɾ u	 ə m 'i ɣ ɾ u 
divuit	d i β 'u j t	 d i β 'u j t 
entrada	ə n t ɾ 'a ð ə	 ə n t ɾ 'a ð ə 
són	s 'o n	 s 'o n 
afirmar	ə f i r m 'a	 ə f i r m 'a 
xemeneia	ʃ ə m ə n 'ɛ j ə	 ʃ ə m ə n 'ɛ j ə 
Alsina	ə l s 'i n ə	 ə l s 'i n ə 
tavernari	t ə β ə r n 'a ɾ i	 t ə β ə r n 'a ɾ i 
separem	s ə p ə ɾ 'ɛ m	 s ə p ə ɾ 'ɛ m 
donades	d u n 'a ð ə s	 d u n 'a ð ə s 
queixalades	k ə ʃ ə l 'a ð ə s	 k ə ʃ ə l 'a ð ə s 
professió	p ɾ u f ə s i 'o	 p ɾ u f ə s i 'o 
teular	t ə w l 'a	 t ə w l 'a 
mantinguda	m ə n t i ŋ g 'u ð ə	 m ə n t i ŋ g 'u ð ə 
jònics	ʒ 'ɔ n i k s	 ʒ 'ɔ n i k s 
compradors	k u m p ɾ ə ð 'o s	 k u m p ɾ ə ð 'o s 
estricte	ə s t ɾ 'i k t ə	 ə s t ɾ 'i k t ə 
eta	'ɛ t ə	 'ɛ t ə 
individualitzats	i n d i β i ð u ə l i d z 'a t s	 i n d i β i ð u ə l i d z 'a t s 
Pasqua	p 'a s k w ə	 p 'a s k w ə 
decoració	d ə k u ɾ ə s i 'o	 d ə k u ɾ ə s i 'o 
disfàgia	d i s f 'a ʒ i ə	 d i s f 'a ʒ i ə 
desplomar-se	d ə s p l u m 'a r s ə	 d ə s p l u m 'a r s ə 
sofregir	s u f ɾ ə ʒ 'i	 s u f ɾ ə ʒ 'i 
hiperònima	i p ə ɾ 'ɔ n i m ə	 i p ə ɾ 'ɔ n i m ə 
S'entén	s ə n t 'e n	 s ə n t 'e n 
enyorances	ə ɲ u ɾ 'a n s ə s	 ə ɲ u ɾ 'a n s ə s 
fomentades	f u m ə n t 'a ð ə s	 f u m ə n t 'a ð ə s 
candau	k ə n d 'a w	 k ə n d 'a w 
conjuntada	k u n ʒ u n t 'a ð ə	 k u n ʒ u n t 'a ð ə 
pernil	p ə r n 'i l	 p ə r n 'i l 
òpal	'ɔ p ə l	 'ɔ p ə l 
sacseja	s ə k s 'ɛ ʒ ə	 s ə k s 'ɛ ʒ ə 
substantiu	s u p s t ə n t 'i w	 s u p s t ə n t 'i w 
celebració	s ə l ə β ɾ ə s i 'o	 s ə l ə β ɾ ə s i 'o 
calendaris	k ə l ə n d 'a ɾ i s	 k ə l ə n d 'a ɾ i s 
marrana	m ə r 'a n ə	 m ə r 'a n ə 
assegurant	ə s ə ɣ u ɾ 'a n	 ə s ə ɣ u ɾ 'a n 
pernil	p ə r n 'i l	 p ə r n 'i l 
restaurares	r ə s t ə w ɾ 'a ɾ ə s	 r ə s t ə w ɾ 'a ɾ ə s 
arrodoniment	ə r u ð u n i m 'e n	 ə r u ð u n i m 'e n 
professada	p ɾ u f ə s 'a ð ə	 p ɾ u f ə s 'a ð ə 
contactada	k u n t ə k t 'a ð ə	 k u n t ə k t 'a ð ə 
posarien	p u z ə ɾ 'i ə n	 p u z ə ɾ 'i ə n 
madrina	m ə ð ɾ 'i n ə	 m ə ð ɾ 'i n ə 
mistificades	m i s t i f i k 'a ð ə s	 m i s t i f i k 'a ð ə s 
encalçada	ə ŋ k ə l s 'a ð ə	 ə ŋ k ə l s 'a ð ə 
blancs	b l 'a ŋ s	 b l 'a ŋ s 
avises	ə β 'i z ə s	 ə β 'i z ə s 
connectivitat	k u n n ə k t i β i t 'a t	 k u n n ə k t i β i t 'a t 
l'últim	l 'u l t i m	 l 'u l t i m 
nostre	n 'ɔ s t ɾ ə	 n 'ɔ s t ɾ ə 
bonics	b u n 'i k s	 b u n 'i k s 
etil	ə t 'i l	 ə t 'i l 
rars	r 'a r s	 r 'a r s 
estigui	ə s t 'i ɣ i	 ə s t 'i ɣ i 
esdeveniment	ə z ð ə β ə n i m 'e n	 ə z ð ə β ə n i m 'e n 
pressentiment	p ɾ ə s ə n t i m 'e n	 p ɾ ə s ə n t i m 'e n 
cosmòleg	k u z m 'ɔ l ə k	 k u z m 'ɔ l ə k 
consogre	k u n s 'ɔ ɣ ɾ ə	 k u n s 'ɔ ɣ ɾ ə 
s'envia	s ə m b 'i ə	 s ə m b 'i ə 
disposició	d i s p u z i s i 'o	 d i s p u z i s i 'o 
arcana	ə r k 'a n ə	 ə r k 'a n ə 
números	n 'u m ə ɾ u s	 n 'u m ə ɾ u s 
administrador	ə d m i n i s t ɾ ə ð 'o	 ə d m i n i s t ɾ ə ð 'o 
esofàgica	ə z u f 'a ʒ i k ə	 ə z u f 'a ʒ i k ə 
nétes	n 'e t ə s	 n 'e t ə s 
Montsec	m u n s 'ɛ k	 m u n s 'ɛ k 
estadant	ə s t ə ð 'a n	 ə s t ə ð 'a n 
caracarà	k ə ɾ ə k ə ɾ 'a	 k ə ɾ ə k ə ɾ 'a 
llòbregues	ʎ 'ɔ β ɾ ə ɣ ə s	 ʎ 'ɔ β ɾ ə ɣ ə s 
rotats	r u t 'a t s	 r u t 'a t s 
excepcionalitat	ə k s ə p s i u n ə l i t 'a t	 ə k s ə p s i u n ə l i t 'a t 
fredor	f ɾ ə ð 'o	 f ɾ ə ð 'o 
cep	s 'ɛ p	 s 'ɛ p 
invitades	i m b i t 'a ð ə s	 i m b i t 'a ð ə s 
internacionalitzada	i n t ə r n ə s i u n ə l i d z 'a ð ə	 i n t ə r n ə s i u n ə l i d z 'a ð ə 
isotropia	i z u t ɾ u p 'i ə	 i z u t ɾ u p 'i ə 
metres	m 'ɛ t ɾ ə s	 m 'ɛ t ɾ ə s 
ceilòmetre	s ə j l 'ɔ m ə t ɾ ə	 s ə j l 'ɔ m ə t ɾ ə 
masclisme	m ə s k l 'i z m ə	 m ə s k l 'i z m ə 
diputat	d i p u t 'a t	 d i p u t 'a t 
embarrancar	ə m b ə r ə ŋ k 'a	 ə m b ə r ə ŋ k 'a 
mil	m 'i l	 m 'i l 
absolucions	ə p s u l u s i 'o n s	 ə p s u l u s i 'o n s 
decadent	d ə k ə ð 'e n	 d ə k ə ð 'e n 
cistell	s i s t 'e ʎ	 s i s t 'e ʎ 
rara	r 'a ɾ ə	 r 'a ɾ ə 
teisme	t ə 'i z m ə	 t ə 'i z m ə 
xafar	ʃ ə f 'a	 ʃ ə f 'a 
caminats	k ə m i n 'a t s	 k ə m i n 'a t s 
crepuscles	k ɾ ə p 'u s k l ə s	 k ɾ ə p 'u s k l ə s 
abillats	ə β i ʎ 'a t s	 ə β i ʎ 'a t s 
cerqui	s 'ɛ r k i	 s 'ɛ r k i 
elegides	ə l ə ʒ 'i ð ə s	 ə l ə ʒ 'i ð ə s 
tastaria	t ə s t ə ɾ 'i ə	 t ə s t ə ɾ 'i ə 
allà	ə ʎ 'a	 ə ʎ 'a 
endevinar	ə n d ə β i n 'a	 ə n d ə β i n 'a 
contagiava	k u n t ə ʒ i 'a β ə	 k u n t ə ʒ i 'a β ə 
proveït	p ɾ u β ə 'i t	 p ɾ u β ə 'i t 
creixement	k ɾ ə ʃ ə m 'e n	 k ɾ ə ʃ ə m 'e n 
immunitzats	i m m u n i d z 'a t s	 i m m u n i d z 'a t s 
l'Estat	l ə s t 'a t	 l ə s t 'a t 
subvertir	s u b b ə r t 'i	 s u b b ə r t 'i 
gegant	ʒ ə ɣ 'a n	 ʒ ə ɣ 'a n 
tracta	t ɾ 'a k t ə	 t ɾ 'a k t ə 
tornaria	t u r n ə ɾ 'i ə	 t u r n ə ɾ 'i ə 
juntes	ʒ 'u n t ə s	 ʒ 'u n t ə s 
sorrejar	s u r ə ʒ 'a	 s u r ə ʒ 'a 
rementerola	r ə m ə n t ə ɾ 'ɔ l ə	 r ə m ə n t ə ɾ 'ɔ l ə 
ressonant	r ə s u n 'a n	 r ə s u n 'a n 
agitacions	ə ʒ i t ə s i 'o n s	 ə ʒ i t ə s i 'o n s 
Jesús	ʒ ə z 'u s	 ʒ ə z 'u s 
culpable	k u l p 'a b b l ə	 k u l p 'a b b l ə 
pluripartidisme	p l u ɾ i p ə r t i ð 'i z m ə	 p l u ɾ i p ə r t i ð 'i z m ə 
incoherents	i ŋ k u ə ɾ 'e n s	 i ŋ k u ə ɾ 'e n s 
m'has	m 'a s	 m 'a s 
peces	p 'e s ə s	 p 'e s ə s 
escorrialles	ə s k u r i 'a ʎ ə s	 ə s k u r i 'a ʎ ə s 
senilitat	s ə n i l i t 'a t	 s ə n i l i t 'a t 
queixar	k ə ʃ 'a	 k ə ʃ 'a 
dibuixa	d i β 'u ʃ ə	 d i β 'u ʃ ə 
lent	l 'e n	 l 'e n 
constitutiva	k u n s t i t u t 'i β ə	 k u n s t i t u t 'i β ə 
discutible	d i s k u t 'i b b l ə	 d i s k u t 'i b b l ə 
concorregudes	k u ŋ k u r ə ɣ 'u ð ə s	 k u ŋ k u r ə ɣ 'u ð ə s 
empesquen	ə m p 'ɛ s k ə n	 ə m p 'ɛ s k ə n 
llicenciats	ʎ i s ə n s i 'a t s	 ʎ i s ə n s i 'a t s 
inaugurades	i n ə w ɣ u ɾ 'a ð ə s	 i n ə w ɣ u ɾ 'a ð ə s 
clínics	k l 'i n i k s	 k l 'i n i k s 
salzes	s 'a l z ə s	 s 'a l z ə s 
ressopó	r ə s u p 'o	 r ə s u p 'o 
recomanar-me	r ə k u m ə n 'a r m ə	 r ə k u m ə n 'a r m ə 
trenqués	t ɾ ə ŋ k 'e s	 t ɾ ə ŋ k 'e s 
americanització	ə m ə ɾ i k ə n i d z ə s i 'o	 ə m ə ɾ i k ə n i d z ə s i 'o 
verals	b ə ɾ 'a l s	 b ə ɾ 'a l s 
generat	ʒ ə n ə ɾ 'a t	 ʒ ə n ə ɾ 'a t 
peritonitis	p ə ɾ i t u n 'i t i s	 p ə ɾ i t u n 'i t i s 
abaixat	ə β ə ʃ 'a t	 ə β ə ʃ 'a t 
oportunista	u p u r t u n 'i s t ə	 u p u r t u n 'i s t ə 
inclinar	i ŋ k l i n 'a	 i ŋ k l i n 'a 
potàssica	p u t 'a s i k ə	 p u t 'a s i k ə 
resat	r ə z 'a t	 r ə z 'a t 
vulgueu	b u l ɣ 'ɛ w	 b u l ɣ 'ɛ w 
ocupar	u k u p 'a	 u k u p 'a 
l'arrencada	l ə r ə ŋ k 'a ð ə	 l ə r ə ŋ k 'a ð ə 
avia	ə β 'i ə	 ə β 'i ə 
inventava	i m b ə n t 'a β ə	 i m b ə n t 'a β ə 
fumigats	f u m i ɣ 'a t s	 f u m i ɣ 'a t s 
rauxa	r 'a w ʃ ə	 r 'a w ʃ ə 
espanyolitzat	ə s p ə ɲ u l i d z 'a t	 ə s p ə ɲ u l i d z 'a t 
Llibres	ʎ 'i β ɾ ə s	 ʎ 'i β ɾ ə s 
sàpiguen	s 'a p i ɣ ə n	 s 'a p i ɣ ə n 
contraposada	k u n t ɾ ə p u z 'a ð ə	 k u n t ɾ ə p u z 'a ð ə 
aviem	ə β i 'ɛ m	 ə β i 'ɛ m 
cantor	k ə n t 'o	 k ə n t 'o 
assamès	ə s ə m 'ɛ s	 ə s ə m 'ɛ s 
venem	b ə n 'ɛ m	 b ə n 'ɛ m 
cimè	s i m 'ɛ	 s i m 'ɛ 
detallada	d ə t ə ʎ 'a ð ə	 d ə t ə ʎ 'a ð ə 
notar	n u t 'a	 n u t 'a 
nòmines	n 'ɔ m i n ə s	 n 'ɔ m i n ə s 
peluda	p ə l 'u ð ə	 p ə l 'u ð ə 
llibreter	ʎ i β ɾ ə t 'e	 ʎ i β ɾ ə t 'e 
cagares	k ə ɣ 'a ɾ ə s	 k ə ɣ 'a ɾ ə s 
implementat	i m p l ə m ə n t 'a t	 i m p l ə m ə n t 'a t 
captares	k ə p t 'a ɾ ə s	 k ə p t 'a ɾ ə s 
falsejat	f ə l s ə ʒ 'a t	 f ə l s ə ʒ 'a t 
sobrealimentades	s u β ɾ e ə l i m ə n t 'a ð ə s	 s u β ɾ e ə l i m ə n t 'a ð ə s 
delictives	d ə l i k t 'i β ə s	 d ə l i k t 'i β ə s 
arrasar	ə r ə z 'a	 ə r ə z 'a 
ermità	ə r m i t 'a	 ə r m i t 'a 
precisares	p ɾ ə s i z 'a ɾ ə s	 p ɾ ə s i z 'a ɾ ə s 
recobrada	r ə k u β ɾ 'a ð ə	 r ə k u β ɾ 'a ð ə 
reciprocitat	r ə s i p ɾ u s i t 'a t	 r ə s i p ɾ u s i t 'a t 
desafiar	d ə z ə f i 'a	 d ə z ə f i 'a 
muó	m u 'o	 m u 'o 
aclaparador	ə k l ə p ə ɾ ə ð 'o	 ə k l ə p ə ɾ ə ð 'o 
normal	n u r m 'a l	 n u r m 'a l 
nobiliari	n u β i l i 'a ɾ i	 n u β i l i 'a ɾ i 
demòcrata	d ə m 'ɔ k ɾ ə t ə	 d ə m 'ɔ k ɾ ə t ə 
transmetre	t ɾ ə n z m 'ɛ t ɾ ə	 t ɾ ə n z m 'ɛ t ɾ ə 
mecanografiar	m ə k ə n u ɣ ɾ ə f i 'a	 m ə k ə n u ɣ ɾ ə f i 'a 
equinàcia	ə k i n 'a s i ə	 ə k i n 'a s i ə 
commemoracions	k u m m ə m u ɾ ə s i 'o n s	 k u m m ə m u ɾ ə s i 'o n s 
rejovenir	r ə ʒ u β ə n 'i	 r ə ʒ u β ə n 'i 
fortificada	f u r t i f i k 'a ð ə	 f u r t i f i k 'a ð ə 
poderós	p u ð ə ɾ 'o s	 p u ð ə ɾ 'o s 
ponderar	p u n d ə ɾ 'a	 p u n d ə ɾ 'a 
pegaria	p ə ɣ ə ɾ 'i ə	 p ə ɣ ə ɾ 'i ə 
justificada	ʒ u s t i f i k 'a ð ə	 ʒ u s t i f i k 'a ð ə 
elevat	ə l ə β 'a t	 ə l ə β 'a t 
fotògrafs	f u t 'ɔ ɣ ɾ ə f s	 f u t 'ɔ ɣ ɾ ə f s 
ràpel	r 'a p ə l	 r 'a p ə l 
excepció	ə k s ə p s i 'o	 ə k s ə p s i 'o 
omnívor	u m n 'i β u r	 u m n 'i β u r 
probabilitat	p ɾ u β ə β i l i t 'a t	 p ɾ u β ə β i l i t 'a t 
plantejaments	p l ə n t ə ʒ ə m 'e n s	 p l ə n t ə ʒ ə m 'e n s 
homenatjats	u m ə n ə d ʒ 'a t s	 u m ə n ə d ʒ 'a t s 
seminífers	s ə m i n 'i f ə r s	 s ə m i n 'i f ə r s 
cedides	s ə ð 'i ð ə s	 s ə ð 'i ð ə s 
firmaran	f i r m ə ɾ 'a n	 f i r m ə ɾ 'a n 
primíssima	p ɾ i m 'i s i m ə	 p ɾ i m 'i s i m ə 
Llanço	ʎ 'a n s u	 ʎ 'a n s u 
realisme	r e ə l 'i z m ə	 r e ə l 'i z m ə 
rufa	r 'u f ə	 r 'u f ə 
Fugiria	f u ʒ i ɾ 'i ə	 f u ʒ i ɾ 'i ə 
papiroflèxia	p ə p i ɾ u f l 'ɛ k s i ə	 p ə p i ɾ u f l 'ɛ k s i ə 
coquet	k u k 'ɛ t	 k u k 'ɛ t 
assaltada	ə s ə l t 'a ð ə	 ə s ə l t 'a ð ə 
indè	i n d 'ɛ	 i n d 'ɛ 
aflorem	ə f l u ɾ 'ɛ m	 ə f l u ɾ 'ɛ m 
defensar-me	d ə f ə n s 'a r m ə	 d ə f ə n s 'a r m ə 
osteomielitis	u s t ə u m i ə l 'i t i s	 u s t ə u m i ə l 'i t i s 
utilitzi	u t i l 'i d z i	 u t i l 'i d z i 
bombones	b u m b 'o n ə s	 b u m b 'o n ə s 
ósses	'o s ə s	 'o s ə s 
vaccí	b ə k s 'i	 b ə k s 'i 
barres	b 'a r ə s	 b 'a r ə s 
còpies	k 'ɔ p i ə s	 k 'ɔ p i ə s 
ocells	u s 'e ʎ s	 u s 'e ʎ s 
momificat	m u m i f i k 'a t	 m u m i f i k 'a t 
d'arribar-hi	d ə r i β 'a ɾ i	 d ə r i β 'a ɾ i 
Ricard	r i k 'a r t	 r i k 'a r t 
rang	r 'a ŋ	 r 'a ŋ 
mobiliària	m u β i l i 'a ɾ i ə	 m u β i l i 'a ɾ i ə 
comentaristes	k u m ə n t ə ɾ 'i s t ə s	 k u m ə n t ə ɾ 'i s t ə s 
vibrada	b i β ɾ 'a ð ə	 b i β ɾ 'a ð ə 
asolellades	ə z u l ə ʎ 'a ð ə s	 ə z u l ə ʎ 'a ð ə s 
petgin	p 'ɛ d ʒ i n	 p 'ɛ d ʒ i n 
supeditar	s u p ə ð i t 'a	 s u p ə ð i t 'a 
aixecats	ə ʃ ə k 'a t s	 ə ʃ ə k 'a t s 
usem	u z 'ɛ m	 u z 'ɛ m 
predicades	p ɾ ə ð i k 'a ð ə s	 p ɾ ə ð i k 'a ð ə s 
beatificats	b e ə t i f i k 'a t s	 b e ə t i f i k 'a t s 
oris	'ɔ ɾ i s	 'ɔ ɾ i s 
paella	p ə 'e ʎ ə	 p ə 'e ʎ ə 
comunicatius	k u m u n i k ə t 'i w s	 k u m u n i k ə t 'i w s 
rovellat	r u β ə ʎ 'a t	 r u β ə ʎ 'a t 
perpetuades	p ə r p ə t u 'a ð ə s	 p ə r p ə t u 'a ð ə s 
raure	r 'a w ɾ ə	 r 'a w ɾ ə 
bàsica	b 'a z i k ə	 b 'a z i k ə 
composada	k u m p u z 'a ð ə	 k u m p u z 'a ð ə 
estimulant	ə s t i m u l 'a n	 ə s t i m u l 'a n 
emmarcades	ə m m ə r k 'a ð ə s	 ə m m ə r k 'a ð ə s 
estampa	ə s t 'a m p ə	 ə s t 'a m p ə 
denegada	d ə n ə ɣ 'a ð ə	 d ə n ə ɣ 'a ð ə 
coma	k 'o m ə	 k 'o m ə 
drenades	d ɾ ə n 'a ð ə s	 d ɾ ə n 'a ð ə s 
desqualificat	d ə s k w ə l i f i k 'a t	 d ə s k w ə l i f i k 'a t 
cercava	s ə r k 'a β ə	 s ə r k 'a β ə 
ancorat	ə ŋ k u ɾ 'a t	 ə ŋ k u ɾ 'a t 
traçabilitat	t ɾ ə s ə β i l i t 'a t	 t ɾ ə s ə β i l i t 'a t 
Rambla	r 'a m b l ə	 r 'a m b l ə 
desencadenat	d ə z ə ŋ k ə ð ə n 'a t	 d ə z ə ŋ k ə ð ə n 'a t 
tocar	t u k 'a	 t u k 'a 
alegria	ə l ə ɣ ɾ 'i ə	 ə l ə ɣ ɾ 'i ə 
assolits	ə s u l 'i t s	 ə s u l 'i t s 
manar	m ə n 'a	 m ə n 'a 
sorrut	s u r 'u t	 s u r 'u t 
alçapremar	ə l s ə p ɾ ə m 'a	 ə l s ə p ɾ ə m 'a 
agradats	ə ɣ ɾ ə ð 'a t s	 ə ɣ ɾ ə ð 'a t s 
irritada	i r i t 'a ð ə	 i r i t 'a ð ə 
xaira	ʃ 'a j ɾ ə	 ʃ 'a j ɾ ə 
sacsó	s ə k s 'o	 s ə k s 'o 
tibat	t i β 'a t	 t i β 'a t 
explicatiu	ə k s p l i k ə t 'i w	 ə k s p l i k ə t 'i w 
iris	'i ɾ i s	 'i ɾ i s 
propinar	p ɾ u p i n 'a	 p ɾ u p i n 'a 
besavi	b ə z 'a β i	 b ə z 'a β i 
eludir	ə l u ð 'i	 ə l u ð 'i 
teixidor	t ə ʃ i ð 'o	 t ə ʃ i ð 'o 
bancari	b ə ŋ k 'a ɾ i	 b ə ŋ k 'a ɾ i 
vociferant	b u s i f ə ɾ 'a n	 b u s i f ə ɾ 'a n 
d'introduir	d i n t ɾ u ð u 'i	 d i n t ɾ u ð u 'i 
féssim	f 'e s i m	 f 'e s i m 
entregada	ə n t ɾ ə ɣ 'a ð ə	 ə n t ɾ ə ɣ 'a ð ə 
eixugar	ə ʃ u ɣ 'a	 ə ʃ u ɣ 'a 
professionalitzades	p ɾ u f ə s i u n ə l i d z 'a ð ə s	 p ɾ u f ə s i u n ə l i d z 'a ð ə s 
emergir	ə m ə r ʒ 'i	 ə m ə r ʒ 'i 
d'obres	d 'ɔ β ɾ ə s	 d 'ɔ β ɾ ə s 
conté	k u n t 'e	 k u n t 'e 
combinem	k u m b i n 'ɛ m	 k u m b i n 'ɛ m 
tossut	t u s 'u t	 t u s 'u t 
colpistes	k u l p 'i s t ə s	 k u l p 'i s t ə s 
esturió	ə s t u ɾ i 'o	 ə s t u ɾ i 'o 
d'intercanvi	d i n t ə r k 'a m b i	 d i n t ə r k 'a m b i 
íxia	'i k s i ə	 'i k s i ə 
metodològiques	m ə t u ð u l 'ɔ ʒ i k ə s	 m ə t u ð u l 'ɔ ʒ i k ə s 
oblidada	u β l i ð 'a ð ə	 u β l i ð 'a ð ə 
d'altres	d 'a l t ɾ ə s	 d 'a l t ɾ ə s 
criatures	k ɾ i ə t 'u ɾ ə s	 k ɾ i ə t 'u ɾ ə s 
mariners	m ə ɾ i n 'e s	 m ə ɾ i n 'e s 
sostinguda	s u s t i ŋ g 'u ð ə	 s u s t i ŋ g 'u ð ə 
forjada	f u r ʒ 'a ð ə	 f u r ʒ 'a ð ə 
imitats	i m i t 'a t s	 i m i t 'a t s 
anyal	ə ɲ 'a l	 ə ɲ 'a l 
urgida	u r ʒ 'i ð ə	 u r ʒ 'i ð ə 
rosari	r u z 'a ɾ i	 r u z 'a ɾ i 
transgredida	t ɾ ə n z ɣ ɾ ə ð 'i ð ə	 t ɾ ə n z ɣ ɾ ə ð 'i ð ə 
circulades	s i r k u l 'a ð ə s	 s i r k u l 'a ð ə s 
determines	d ə t ə r m 'i n ə s	 d ə t ə r m 'i n ə s 
pellucar	p ə ʎ u k 'a	 p ə ʎ u k 'a 
panacea	p ə n ə s 'e ə	 p ə n ə s 'e ə 
eructada	ə ɾ u k t 'a ð ə	 ə ɾ u k t 'a ð ə 
metastatitzats	m ə t ə s t ə t i d z 'a t s	 m ə t ə s t ə t i d z 'a t s 
revelats	r ə β ə l 'a t s	 r ə β ə l 'a t s 
Diversitat	d i β ə r s i t 'a t	 d i β ə r s i t 'a t 
vocables	b u k 'a b b l ə s	 b u k 'a b b l ə s 
L'educació	l ə ð u k ə s i 'o	 l ə ð u k ə s i 'o 
eructades	ə ɾ u k t 'a ð ə s	 ə ɾ u k t 'a ð ə s 
Imagino	i m ə ʒ 'i n u	 i m ə ʒ 'i n u 
centenària	s ə n t ə n 'a ɾ i ə	 s ə n t ə n 'a ɾ i ə 
agraint	ə ɣ ɾ ə 'i n	 ə ɣ ɾ ə 'i n 
desconèixer	d ə s k u n 'ɛ ʃ ə	 d ə s k u n 'ɛ ʃ ə 
Malawi	m ə l 'a β i	 m ə l 'a β i 
cubans	k u β 'a n s	 k u β 'a n s 
desxifrada	d ə ʃ i f ɾ 'a ð ə	 d ə ʃ i f ɾ 'a ð ə 
reptats	r ə p t 'a t s	 r ə p t 'a t s 
escindir	ə s i n d 'i	 ə s i n d 'i 
noguts	n u ɣ 'u t s	 n u ɣ 'u t s 
n'escoltem	n ə s k u l t 'ɛ m	 n ə s k u l t 'ɛ m 
mantindran	m ə n t i n d ɾ 'a n	 m ə n t i n d ɾ 'a n 
especificat	ə s p ə s i f i k 'a t	 ə s p ə s i f i k 'a t 
interessats	i n t ə ɾ ə s 'a t s	 i n t ə ɾ ə s 'a t s 
Disposem	d i s p u z 'ɛ m	 d i s p u z 'ɛ m 
escull	ə s k 'u ʎ	 ə s k 'u ʎ 
tenacitat	t ə n ə s i t 'a t	 t ə n ə s i t 'a t 
renovada	r ə n u β 'a ð ə	 r ə n u β 'a ð ə 
quintuplicades	k i n t u p l i k 'a ð ə s	 k i n t u p l i k 'a ð ə s 
olivereta	u l i β ə ɾ 'ɛ t ə	 u l i β ə ɾ 'ɛ t ə 
pare	p 'a ɾ ə	 p 'a ɾ ə 
flirtejades	f l i r t ə ʒ 'a ð ə s	 f l i r t ə ʒ 'a ð ə s 
aprestat	ə p ɾ ə s t 'a t	 ə p ɾ ə s t 'a t 
cascavellejar	k ə s k ə β ə ʎ ə ʒ 'a	 k ə s k ə β ə ʎ ə ʒ 'a 
constatades	k u n s t ə t 'a ð ə s	 k u n s t ə t 'a ð ə s 
monetitzar	m u n ə t i d z 'a	 m u n ə t i d z 'a 
fico	f 'i k u	 f 'i k u 
gens	ʒ 'e n s	 ʒ 'e n s 
enviada	ə m b i 'a ð ə	 ə m b i 'a ð ə 
van	b 'a n	 b 'a n 
d'internet	d i n t ə r n 'ɛ t	 d i n t ə r n 'ɛ t 
mostrà	m u s t ɾ 'a	 m u s t ɾ 'a 
biogràfics	b i u ɣ ɾ 'a f i k s	 b i u ɣ ɾ 'a f i k s 
utilitzats	u t i l i d z 'a t s	 u t i l i d z 'a t s 
districte	d i s t ɾ 'i k t ə	 d i s t ɾ 'i k t ə 
ocupada	u k u p 'a ð ə	 u k u p 'a ð ə 
oligosacàrids	u l i ɣ u z ə k 'a ɾ i t s	 u l i ɣ u z ə k 'a ɾ i t s 
fagot	f ə ɣ 'ɔ t	 f ə ɣ 'ɔ t 
enyorades	ə ɲ u ɾ 'a ð ə s	 ə ɲ u ɾ 'a ð ə s 
promocionar	p ɾ u m u s i u n 'a	 p ɾ u m u s i u n 'a 
parodiar	p ə ɾ u ð i 'a	 p ə ɾ u ð i 'a 
immensa	i m m 'ɛ n s ə	 i m m 'ɛ n s ə 
astronomia	ə s t ɾ u n u m 'i ə	 ə s t ɾ u n u m 'i ə 
incomoditat	i ŋ k u m u ð i t 'a t	 i ŋ k u m u ð i t 'a t 
imminència	i m m i n 'ɛ n s i ə	 i m m i n 'ɛ n s i ə 
ratera	r ə t 'e ɾ ə	 r ə t 'e ɾ ə 
viudo	b 'i w ð u	 b 'i w ð u 
excavar	ə k s k ə β 'a	 ə k s k ə β 'a 
critica	k ɾ i t 'i k ə	 k ɾ i t 'i k ə 
matallums	m ə t ə ʎ 'u m s	 m ə t ə ʎ 'u m s 
Estònia	ə s t 'ɔ n i ə	 ə s t 'ɔ n i ə 
beneït	b ə n ə 'i t	 b ə n ə 'i t 
finançades	f i n ə n s 'a ð ə s	 f i n ə n s 'a ð ə s 
novena	n u β 'ɛ n ə	 n u β 'ɛ n ə 
detonada	d ə t u n 'a ð ə	 d ə t u n 'a ð ə 
incomparable	i ŋ k u m p ə ɾ 'a b b l ə	 i ŋ k u m p ə ɾ 'a b b l ə 
borrosa	b u r 'o z ə	 b u r 'o z ə 
transparents	t ɾ ə n s p ə ɾ 'e n s	 t ɾ ə n s p ə ɾ 'e n s 
Llaguna	ʎ ə ɣ 'u n ə	 ʎ ə ɣ 'u n ə 
presentador	p ɾ ə z ə n t ə ð 'o	 p ɾ ə z ə n t ə ð 'o 
aterrits	ə t ə r 'i t s	 ə t ə r 'i t s 
inconsistent	i ŋ k u n s i s t 'e n	 i ŋ k u n s i s t 'e n 
contrasts	k u n t ɾ 'a s t s	 k u n t ɾ 'a s t s 
lliteres	ʎ i t 'e ɾ ə s	 ʎ i t 'e ɾ ə s 
Guia	g 'i ə	 g 'i ə 
tocava	t u k 'a β ə	 t u k 'a β ə 
cromosomàtic	k ɾ u m u z u m 'a t i k	 k ɾ u m u z u m 'a t i k 
tombant	t u m b 'a n	 t u m b 'a n 
plàstica	p l 'a s t i k ə	 p l 'a s t i k ə 
collaret	k u ʎ ə ɾ 'ɛ t	 k u ʎ ə ɾ 'ɛ t 
ajupit	ə ʒ u p 'i t	 ə ʒ u p 'i t 
d'escriptori	d ə s k ɾ i p t 'ɔ ɾ i	 d ə s k ɾ i p t 'ɔ ɾ i 
alternativa	ə l t ə r n ə t 'i β ə	 ə l t ə r n ə t 'i β ə 
llegides	ʎ ə ʒ 'i ð ə s	 ʎ ə ʒ 'i ð ə s 
pegarà	p ə ɣ ə ɾ 'a	 p ə ɣ ə ɾ 'a 
eixuta	ə ʃ 'u t ə	 ə ʃ 'u t ə 
tela	t 'ɛ l ə	 t 'ɛ l ə 
Teseu	t ə z 'ɛ w	 t ə z 'ɛ w 
fanàtiques	f ə n 'a t i k ə s	 f ə n 'a t i k ə s 
beata	b e 'a t ə	 b e 'a t ə 
frego	f ɾ 'ɛ ɣ u	 f ɾ 'ɛ ɣ u 
obrador	u β ɾ ə ð 'o	 u β ɾ ə ð 'o 
corònim	k u ɾ 'ɔ n i m	 k u ɾ 'ɔ n i m 
treus	t ɾ 'ɛ w s	 t ɾ 'ɛ w s 
otoscòpia	u t u s k 'ɔ p i ə	 u t u s k 'ɔ p i ə 
perfum	p ə r f 'u m	 p ə r f 'u m 
calorimètriques	k ə l u ɾ i m 'ɛ t ɾ i k ə s	 k ə l u ɾ i m 'ɛ t ɾ i k ə s 
caigui	k 'a j ɣ i	 k 'a j ɣ i 
enclova	ə ŋ k l 'ɔ β ə	 ə ŋ k l 'ɔ β ə 
entaforar	ə n t ə f u ɾ 'a	 ə n t ə f u ɾ 'a 
lantani	l ə n t 'a n i	 l ə n t 'a n i 
ximpleria	ʃ i m p l ə ɾ 'i ə	 ʃ i m p l ə ɾ 'i ə 
irrogués	i r u ɣ 'e s	 i r u ɣ 'e s 
sociològiques	s u s i u l 'ɔ ʒ i k ə s	 s u s i u l 'ɔ ʒ i k ə s 
equivaldre	ə k i β 'a l d ɾ ə	 ə k i β 'a l d ɾ ə 
gravarem	g ɾ ə β ə ɾ 'ɛ m	 g ɾ ə β ə ɾ 'ɛ m 
escaldadura	ə s k ə l d ə ð 'u ɾ ə	 ə s k ə l d ə ð 'u ɾ ə 
s'acosta	s ə k 'ɔ s t ə	 s ə k 'ɔ s t ə 
activitat	ə k t i β i t 'a t	 ə k t i β i t 'a t 
forat	f u ɾ 'a t	 f u ɾ 'a t 
legislar	l ə ʒ i z l 'a	 l ə ʒ i z l 'a 
serralada	s ə r ə l 'a ð ə	 s ə r ə l 'a ð ə 
estaquem	ə s t ə k 'ɛ m	 ə s t ə k 'ɛ m 
additiva	ə d d i t 'i β ə	 ə d d i t 'i β ə 
emular	ə m u l 'a	 ə m u l 'a 
hidrogen	i ð ɾ 'ɔ ʒ ə n	 i ð ɾ 'ɔ ʒ ə n 
Sortint	s u r t 'i n	 s u r t 'i n 
consolar	k u n s u l 'a	 k u n s u l 'a 
s'ajusti	s ə ʒ 'u s t i	 s ə ʒ 'u s t i 
bizantí	b i z ə n t 'i	 b i z ə n t 'i 
especialitzades	ə s p ə s i ə l i d z 'a ð ə s	 ə s p ə s i ə l i d z 'a ð ə s 
sobresortits	s u β ɾ ə z u r t 'i t s	 s u β ɾ ə z u r t 'i t s 
barrat	b ə r 'a t	 b ə r 'a t 
heroïna	ə ɾ u 'i n ə	 ə ɾ u 'i n ə 
polars	p u l 'a r s	 p u l 'a r s 
naturalista	n ə t u ɾ ə l 'i s t ə	 n ə t u ɾ ə l 'i s t ə 
passejat	p ə s ə ʒ 'a t	 p ə s ə ʒ 'a t 
mújol	m 'u ʒ u l	 m 'u ʒ u l 
mitjan	m i d ʒ 'a n	 m i d ʒ 'a n 
ortogràfica	u r t u ɣ ɾ 'a f i k ə	 u r t u ɣ ɾ 'a f i k ə 
caragolí	k ə ɾ ə ɣ u l 'i	 k ə ɾ ə ɣ u l 'i 
insultades	i n s u l t 'a ð ə s	 i n s u l t 'a ð ə s 
persa	p 'ɛ r s ə	 p 'ɛ r s ə 
banderola	b ə n d ə ɾ 'ɔ l ə	 b ə n d ə ɾ 'ɔ l ə 
espunyir	ə s p u ɲ 'i	 ə s p u ɲ 'i 
pregunti	p ɾ ə ɣ 'u n t i	 p ɾ ə ɣ 'u n t i 
estalviades	ə s t ə l β i 'a ð ə s	 ə s t ə l β i 'a ð ə s 
descarrilar	d ə s k ə r i l 'a	 d ə s k ə r i l 'a 
epidemiòlegs	ə p i ð ə m i 'ɔ l ə k s	 ə p i ð ə m i 'ɔ l ə k s 
tel	t 'ɛ l	 t 'ɛ l 
l'armilla	l ə r m 'i ʎ ə	 l ə r m 'i ʎ ə 
aclucada	ə k l u k 'a ð ə	 ə k l u k 'a ð ə 
botonades	b u t u n 'a ð ə s	 b u t u n 'a ð ə s 
botella	b u t 'e ʎ ə	 b u t 'e ʎ ə 
ocupi	u k 'u p i	 u k 'u p i 
funcionament	f u n s i u n ə m 'e n	 f u n s i u n ə m 'e n 
cago	k 'a ɣ u	 k 'a ɣ u 
cookie	k u u k 'i ə	 k u u k 'i ə 
defensada	d ə f ə n s 'a ð ə	 d ə f ə n s 'a ð ə 
equipar	ə k i p 'a	 ə k i p 'a 
armava	ə r m 'a β ə	 ə r m 'a β ə 
sonso	s 'ɔ n s u	 s 'ɔ n s u 
trilió	t ɾ i l i 'o	 t ɾ i l i 'o 
anestèsica	ə n ə s t 'ɛ z i k ə	 ə n ə s t 'ɛ z i k ə 
tribòmetre	t ɾ i β 'ɔ m ə t ɾ ə	 t ɾ i β 'ɔ m ə t ɾ ə 
pletòric	p l ə t 'ɔ ɾ i k	 p l ə t 'ɔ ɾ i k 
quedava	k ə ð 'a β ə	 k ə ð 'a β ə 
Catalanes	k ə t ə l 'a n ə s	 k ə t ə l 'a n ə s 
sintetitzades	s i n t ə t i d z 'a ð ə s	 s i n t ə t i d z 'a ð ə s 
llotja	ʎ 'ɔ d ʒ ə	 ʎ 'ɔ d ʒ ə 
traça	t ɾ 'a s ə	 t ɾ 'a s ə 
exfoliats	ə k s f u l i 'a t s	 ə k s f u l i 'a t s 
vacances	b ə k 'a n s ə s	 b ə k 'a n s ə s 
escoltats	ə s k u l t 'a t s	 ə s k u l t 'a t s 
hortolà	u r t u l 'a	 u r t u l 'a 
rabassaire	r ə β ə s 'a j ɾ ə	 r ə β ə s 'a j ɾ ə 
accedíssim	ə k s ə ð 'i s i m	 ə k s ə ð 'i s i m 
adàmic	ə ð 'a m i k	 ə ð 'a m i k 
idòlatra	i ð 'ɔ l ə t ɾ ə	 i ð 'ɔ l ə t ɾ ə 
trempi	t ɾ 'ɛ m p i	 t ɾ 'ɛ m p i 
Calcular	k ə l k u l 'a	 k ə l k u l 'a 
conreu	k u n r 'ɛ w	 k u n r 'ɛ w 
Distinció	d i s t i n s i 'o	 d i s t i n s i 'o 
artell	ə r t 'e ʎ	 ə r t 'e ʎ 
brusques	b ɾ 'u s k ə s	 b ɾ 'u s k ə s 
sostres	s 'ɔ s t ɾ ə s	 s 'ɔ s t ɾ ə s 
embolicar	ə m b u l i k 'a	 ə m b u l i k 'a 
funcionades	f u n s i u n 'a ð ə s	 f u n s i u n 'a ð ə s 
rojes	r 'ɔ ʒ ə s	 r 'ɔ ʒ ə s 
japonès	ʒ ə p u n 'ɛ s	 ʒ ə p u n 'ɛ s 
prima	p ɾ 'i m ə	 p ɾ 'i m ə 
vestit	b ə s t 'i t	 b ə s t 'i t 
bati	b 'a t i	 b 'a t i 
empatats	ə m p ə t 'a t s	 ə m p ə t 'a t s 
cantonada	k ə n t u n 'a ð ə	 k ə n t u n 'a ð ə 
ajudades	ə ʒ u ð 'a ð ə s	 ə ʒ u ð 'a ð ə s 
canalla	k ə n 'a ʎ ə	 k ə n 'a ʎ ə 
correguts	k u r ə ɣ 'u t s	 k u r ə ɣ 'u t s 
escalfeir	ə s k ə l f ə 'i	 ə s k ə l f ə 'i 
corna	k 'ɔ r n ə	 k 'ɔ r n ə 
emprovar	ə m p ɾ u β 'a	 ə m p ɾ u β 'a 
desxifrats	d ə ʃ i f ɾ 'a t s	 d ə ʃ i f ɾ 'a t s 
mecanitzada	m ə k ə n i d z 'a ð ə	 m ə k ə n i d z 'a ð ə 
subscripció	s u p s k ɾ i p s i 'o	 s u p s k ɾ i p s i 'o 
dessalinitzat	d ə s ə l i n i d z 'a t	 d ə s ə l i n i d z 'a t 
fiscals	f i s k 'a l s	 f i s k 'a l s 
capitulat	k ə p i t u l 'a t	 k ə p i t u l 'a t 
actrius	ə k t ɾ 'i w s	 ə k t ɾ 'i w s 
escàs	ə s k 'a s	 ə s k 'a s 
prenyada	p ɾ ə ɲ 'a ð ə	 p ɾ ə ɲ 'a ð ə 
jaló	ʒ ə l 'o	 ʒ ə l 'o 
lilà	l i l 'a	 l i l 'a 
fonologia	f u n u l u ʒ 'i ə	 f u n u l u ʒ 'i ə 
enquestada	ə ŋ k ə s t 'a ð ə	 ə ŋ k ə s t 'a ð ə 
estocàstics	ə s t u k 'a s t i k s	 ə s t u k 'a s t i k s 
l'educació	l ə ð u k ə s i 'o	 l ə ð u k ə s i 'o 
condicionada	k u n d i s i u n 'a ð ə	 k u n d i s i u n 'a ð ə 
propiciades	p ɾ u p i s i 'a ð ə s	 p ɾ u p i s i 'a ð ə s 
escala	ə s k 'a l ə	 ə s k 'a l ə 
tapadora	t ə p ə ð 'o ɾ ə	 t ə p ə ð 'o ɾ ə 
fiasco	f i 'a s k u	 f i 'a s k u 
ecologistes	ə k u l u ʒ 'i s t ə s	 ə k u l u ʒ 'i s t ə s 
dissetena	d i s ə t 'ɛ n ə	 d i s ə t 'ɛ n ə 
monolític	m u n u l 'i t i k	 m u n u l 'i t i k 
bela	b 'ɛ l ə	 b 'ɛ l ə 
emula	ə m 'u l ə	 ə m 'u l ə 
d'entrada	d ə n t ɾ 'a ð ə	 d ə n t ɾ 'a ð ə 
solades	s u l 'a ð ə s	 s u l 'a ð ə s 
creguda	k ɾ ə ɣ 'u ð ə	 k ɾ ə ɣ 'u ð ə 
resumits	r ə z u m 'i t s	 r ə z u m 'i t s 
desfigurades	d ə s f i ɣ u ɾ 'a ð ə s	 d ə s f i ɣ u ɾ 'a ð ə s 
comprometem	k u m p ɾ u m ə t 'ɛ m	 k u m p ɾ u m ə t 'ɛ m 
estatut	ə s t ə t 'u t	 ə s t ə t 'u t 
colpista	k u l p 'i s t ə	 k u l p 'i s t ə 
catòlic	k ə t 'ɔ l i k	 k ə t 'ɔ l i k 
formant	f u r m 'a n	 f u r m 'a n 
humanitaris	u m ə n i t 'a ɾ i s	 u m ə n i t 'a ɾ i s 
encolomats	ə ŋ k u l u m 'a t s	 ə ŋ k u l u m 'a t s 
aniria	ə n i ɾ 'i ə	 ə n i ɾ 'i ə 
fons	f 'o n s	 f 'o n s 
perjudicat	p ə r ʒ u ð i k 'a t	 p ə r ʒ u ð i k 'a t 
tradicionals	t ɾ ə ð i s i u n 'a l s	 t ɾ ə ð i s i u n 'a l s 
impossibilitada	i m p u s i β i l i t 'a ð ə	 i m p u s i β i l i t 'a ð ə 
salma	s 'a l m ə	 s 'a l m ə 
assajant	ə s ə ʒ 'a n	 ə s ə ʒ 'a n 
juny	ʒ 'u ɲ	 ʒ 'u ɲ 
restada	r ə s t 'a ð ə	 r ə s t 'a ð ə 
exposat	ə k s p u z 'a t	 ə k s p u z 'a t 
durant	d u ɾ 'a n	 d u ɾ 'a n 
menin	m 'ɛ n i n	 m 'ɛ n i n 
feministes	f ə m i n 'i s t ə s	 f ə m i n 'i s t ə s 
Ripollès	r i p u ʎ 'ɛ s	 r i p u ʎ 'ɛ s 
autonòmic	ə w t u n 'ɔ m i k	 ə w t u n 'ɔ m i k 
ressortit	r ə s u r t 'i t	 r ə s u r t 'i t 
evitada	ə β i t 'a ð ə	 ə β i t 'a ð ə 
litogràfiques	l i t u ɣ ɾ 'a f i k ə s	 l i t u ɣ ɾ 'a f i k ə s 
establiment	ə s t ə b b l i m 'e n	 ə s t ə b b l i m 'e n 
ficava	f i k 'a β ə	 f i k 'a β ə 
massacrades	m ə s ə k ɾ 'a ð ə s	 m ə s ə k ɾ 'a ð ə s 
lubrificada	l u β ɾ i f i k 'a ð ə	 l u β ɾ i f i k 'a ð ə 
taràntules	t ə ɾ 'a n t u l ə s	 t ə ɾ 'a n t u l ə s 
decapitar-lo	d ə k ə p i t 'a r l u	 d ə k ə p i t 'a r l u 
introspeccions	i n t ɾ u s p ə k s i 'o n s	 i n t ɾ u s p ə k s i 'o n s 
borlis	b 'ɔ r l i s	 b 'ɔ r l i s 
gerani	ʒ ə ɾ 'a n i	 ʒ ə ɾ 'a n i 
allotjar	ə ʎ u d ʒ 'a	 ə ʎ u d ʒ 'a 
cruspides	k ɾ u s p 'i ð ə s	 k ɾ u s p 'i ð ə s 
acròbata	ə k ɾ 'ɔ β ə t ə	 ə k ɾ 'ɔ β ə t ə 
punta	p 'u n t ə	 p 'u n t ə 
causà	k ə w z 'a	 k ə w z 'a 
segellada	s ə ʒ ə ʎ 'a ð ə	 s ə ʒ ə ʎ 'a ð ə 
horari	u ɾ 'a ɾ i	 u ɾ 'a ɾ i 
conductes	k u n d 'u k t ə s	 k u n d 'u k t ə s 
navarreses	n ə β ə r 'ɛ z ə s	 n ə β ə r 'ɛ z ə s 
ingerit	i n ʒ ə ɾ 'i t	 i n ʒ ə ɾ 'i t 
obsequia	u p s ə k 'i ə	 u p s ə k 'i ə 
eurasiàtic	ə w ɾ ə z i 'a t i k	 ə w ɾ ə z i 'a t i k 
planxar	p l ə n ʃ 'a	 p l ə n ʃ 'a 
censuris	s ə n s 'u ɾ i s	 s ə n s 'u ɾ i s 
serrarà	s ə r ə ɾ 'a	 s ə r ə ɾ 'a 
disminuir	d i z m i n u 'i	 d i z m i n u 'i 
petgis	p 'ɛ d ʒ i s	 p 'ɛ d ʒ i s 
titubejades	t i t u β ə ʒ 'a ð ə s	 t i t u β ə ʒ 'a ð ə s 
abdica	ə b d 'i k ə	 ə b d 'i k ə 
penyal	p ə ɲ 'a l	 p ə ɲ 'a l 
m'amaga	m ə m 'a ɣ ə	 m ə m 'a ɣ ə 
plagi	p l 'a ʒ i	 p l 'a ʒ i 
inventat	i m b ə n t 'a t	 i m b ə n t 'a t 
reneboda	r ə n ə β 'ɔ ð ə	 r ə n ə β 'ɔ ð ə 
pistola	p i s t 'ɔ l ə	 p i s t 'ɔ l ə 
cull	k 'u ʎ	 k 'u ʎ 
còlics	k 'ɔ l i k s	 k 'ɔ l i k s 
colla	k 'ɔ ʎ ə	 k 'ɔ ʎ ə 
Meca	m 'ɛ k ə	 m 'ɛ k ə 
consagrar	k u n s ə ɣ ɾ 'a	 k u n s ə ɣ ɾ 'a 
deduïdes	d ə ð u 'i ð ə s	 d ə ð u 'i ð ə s 
aguantades	ə ɣ w ə n t 'a ð ə s	 ə ɣ w ə n t 'a ð ə s 
soguin	s 'ɔ ɣ i n	 s 'ɔ ɣ i n 
petxina	p ə t ʃ 'i n ə	 p ə t ʃ 'i n ə 
artigues	ə r t 'i ɣ ə s	 ə r t 'i ɣ ə s 
Carèlia	k ə ɾ 'ɛ l i ə	 k ə ɾ 'ɛ l i ə 
estrangeres	ə s t ɾ ə n ʒ 'e ɾ ə s	 ə s t ɾ ə n ʒ 'e ɾ ə s 
compensaria	k u m p ə n s ə ɾ 'i ə	 k u m p ə n s ə ɾ 'i ə 
Balaguer	b ə l ə ɣ 'e	 b ə l ə ɣ 'e 
belluguin	b ə ʎ 'u ɣ i n	 b ə ʎ 'u ɣ i n 
construïts	k u n s t ɾ u 'i t s	 k u n s t ɾ u 'i t s 
emigrares	ə m i ɣ ɾ 'a ɾ ə s	 ə m i ɣ ɾ 'a ɾ ə s 
interuniversitari	i n t ə ɾ u n i β ə r s i t 'a ɾ i	 i n t ə ɾ u n i β ə r s i t 'a ɾ i 
escaldat	ə s k ə l d 'a t	 ə s k ə l d 'a t 
inert	i n 'ɛ r t	 i n 'ɛ r t 
connectar-te	k u n n ə k t 'a r t ə	 k u n n ə k t 'a r t ə 
conduïda	k u n d u 'i ð ə	 k u n d u 'i ð ə 
endarreriment	ə n d ə r ə ɾ i m 'e n	 ə n d ə r ə ɾ i m 'e n 
units	u n 'i t s	 u n 'i t s 
omeses	u m 'ɛ z ə s	 u m 'ɛ z ə s 
degotats	d ə ɣ u t 'a t s	 d ə ɣ u t 'a t s 
apregonar	ə p ɾ ə ɣ u n 'a	 ə p ɾ ə ɣ u n 'a 
maldat	m ə l d 'a t	 m ə l d 'a t 
oboè	u β u 'ɛ	 u β u 'ɛ 
serrà	s ə r 'a	 s ə r 'a 
nin	n 'i n	 n 'i n 
profusió	p ɾ u f u z i 'o	 p ɾ u f u z i 'o 
suportes	s u p 'ɔ r t ə s	 s u p 'ɔ r t ə s 
l'estreta	l ə s t ɾ 'ɛ t ə	 l ə s t ɾ 'ɛ t ə 
riquesa	r i k 'ɛ z ə	 r i k 'ɛ z ə 
peten	p 'ɛ t ə n	 p 'ɛ t ə n 
ruïnós	r u i n 'o s	 r u i n 'o s 
girar	ʒ i ɾ 'a	 ʒ i ɾ 'a 
votem	b u t 'ɛ m	 b u t 'ɛ m 
exculpar	ə k s k u l p 'a	 ə k s k u l p 'a 
despentinat	d ə s p ə n t i n 'a t	 d ə s p ə n t i n 'a t 
hirsut	i r s 'u t	 i r s 'u t 
Riera	r i 'e ɾ ə	 r i 'e ɾ ə 
perruquer	p ə r u k 'e	 p ə r u k 'e 
immersió	i m m ə r s i 'o	 i m m ə r s i 'o 
caputxina	k ə p u t ʃ 'i n ə	 k ə p u t ʃ 'i n ə 
s'entregarà	s ə n t ɾ ə ɣ ə ɾ 'a	 s ə n t ɾ ə ɣ ə ɾ 'a 
intuïts	i n t u 'i t s	 i n t u 'i t s 
Antíoc	ə n t 'i u k	 ə n t 'i u k 
incorporades	i ŋ k u r p u ɾ 'a ð ə s	 i ŋ k u r p u ɾ 'a ð ə s 
taulades	t ə w l 'a ð ə s	 t ə w l 'a ð ə s 
psicopatològiques	p s i k u p ə t u l 'ɔ ʒ i k ə s	 p s i k u p ə t u l 'ɔ ʒ i k ə s 
l'atac	l ə t 'a k	 l ə t 'a k 
pica	p 'i k ə	 p 'i k ə 
madurat	m ə ð u ɾ 'a t	 m ə ð u ɾ 'a t 
uniformitzar	u n i f u r m i d z 'a	 u n i f u r m i d z 'a 
brams	b ɾ 'a m s	 b ɾ 'a m s 
aní	ə n 'i	 ə n 'i 
traçuda	t ɾ ə s 'u ð ə	 t ɾ ə s 'u ð ə 
japonesos	ʒ ə p u n 'ɛ z u s	 ʒ ə p u n 'ɛ z u s 
manso	m 'a n s u	 m 'a n s u 
homenot	u m ə n 'ɔ t	 u m ə n 'ɔ t 
temperada	t ə m p ə ɾ 'a ð ə	 t ə m p ə ɾ 'a ð ə 
sostracció	s u s t ɾ ə k s i 'o	 s u s t ɾ ə k s i 'o 
troca	t ɾ 'ɔ k ə	 t ɾ 'ɔ k ə 
arxius	ə r ʃ 'i w s	 ə r ʃ 'i w s 
raciocinació	r ə s i u s i n ə s i 'o	 r ə s i u s i n ə s i 'o 
alcoià	ə l k u j 'a	 ə l k u j 'a 
és	'e s	 'e s 
L'abraçava	l ə β ɾ ə s 'a β ə	 l ə β ɾ ə s 'a β ə 
mostrar	m u s t ɾ 'a	 m u s t ɾ 'a 
escalfor	ə s k ə l f 'o	 ə s k ə l f 'o 
olivina	u l i β 'i n ə	 u l i β 'i n ə 
Situar	s i t u 'a	 s i t u 'a 
duaner	d u ə n 'e	 d u ə n 'e 
numeràries	n u m ə ɾ 'a ɾ i ə s	 n u m ə ɾ 'a ɾ i ə s 
inoxidable	i n u k s i ð 'a b b l ə	 i n u k s i ð 'a b b l ə 
diaca	d i 'a k ə	 d i 'a k ə 
pleguen	p l 'ɛ ɣ ə n	 p l 'ɛ ɣ ə n 
reny	r 'ɛ ɲ	 r 'ɛ ɲ 
llista	ʎ 'i s t ə	 ʎ 'i s t ə 
complexa	k u m p l 'ɛ k s ə	 k u m p l 'ɛ k s ə 
mònada	m 'ɔ n ə ð ə	 m 'ɔ n ə ð ə 
tenint	t ə n 'i n	 t ə n 'i n 
laborada	l ə β u ɾ 'a ð ə	 l ə β u ɾ 'a ð ə 
cítrics	s 'i t ɾ i k s	 s 'i t ɾ i k s 
revisionisme	r ə β i z i u n 'i z m ə	 r ə β i z i u n 'i z m ə 
Però	p ə ɾ 'ɔ	 p ə ɾ 'ɔ 
captem	k ə p t 'ɛ m	 k ə p t 'ɛ m 
Zones	z 'o n ə s	 z 'o n ə s 
ignoréssim	i g n u ɾ 'e s i m	 i g n u ɾ 'e s i m 
quàntum	k w 'a n t u m	 k w 'a n t u m 
escurçat	ə s k u r s 'a t	 ə s k u r s 'a t 
aglutinar	ə ɣ l u t i n 'a	 ə ɣ l u t i n 'a 
embridada	ə m b ɾ i ð 'a ð ə	 ə m b ɾ i ð 'a ð ə 
Molt	m 'o l	 m 'o l 
suara	s u 'a ɾ ə	 s u 'a ɾ ə 
impressió	i m p ɾ ə s i 'o	 i m p ɾ ə s i 'o 
taller	t ə ʎ 'e	 t ə ʎ 'e 
cremat	k ɾ ə m 'a t	 k ɾ ə m 'a t 
s'ensenyen	s ə n s 'ɛ ɲ ə n	 s ə n s 'ɛ ɲ ə n 
assistits	ə s i s t 'i t s	 ə s i s t 'i t s 
adorada	ə ð u ɾ 'a ð ə	 ə ð u ɾ 'a ð ə 
eliminació	ə l i m i n ə s i 'o	 ə l i m i n ə s i 'o 
estarem	ə s t ə ɾ 'ɛ m	 ə s t ə ɾ 'ɛ m 
frustrat	f ɾ u s t ɾ 'a t	 f ɾ u s t ɾ 'a t 
admiris	ə d m 'i ɾ i s	 ə d m 'i ɾ i s 
biscaí	b i s k ə 'i	 b i s k ə 'i 
isquèmic	i s k 'ɛ m i k	 i s k 'ɛ m i k 
anat	ə n 'a t	 ə n 'a t 
sotraguejar	s u t ɾ ə ɣ ə ʒ 'a	 s u t ɾ ə ɣ ə ʒ 'a 
calàreu	k ə l 'a ɾ ə w	 k ə l 'a ɾ ə w 
robats	r u β 'a t s	 r u β 'a t s 
cornades	k u r n 'a ð ə s	 k u r n 'a ð ə s 
almiralls	ə l m i ɾ 'a ʎ s	 ə l m i ɾ 'a ʎ s 
atraccions	ə t ɾ ə k s i 'o n s	 ə t ɾ ə k s i 'o n s 
subornarà	s u β u r n ə ɾ 'a	 s u β u r n ə ɾ 'a 
militaria	m i l i t ə ɾ 'i ə	 m i l i t ə ɾ 'i ə 
patacada	p ə t ə k 'a ð ə	 p ə t ə k 'a ð ə 
comparegudes	k u m p ə ɾ ə ɣ 'u ð ə s	 k u m p ə ɾ ə ɣ 'u ð ə s 
decepció	d ə s ə p s i 'o	 d ə s ə p s i 'o 
bròcoli	b ɾ 'ɔ k u l i	 b ɾ 'ɔ k u l i 
l'Índia	l 'i n d i ə	 l 'i n d i ə 
occitanisme	u k s i t ə n 'i z m ə	 u k s i t ə n 'i z m ə 
Punxa	p 'u n ʃ ə	 p 'u n ʃ ə 
rememorat	r ə m ə m u ɾ 'a t	 r ə m ə m u ɾ 'a t 
vell	b 'e ʎ	 b 'e ʎ 
subtil	s u p t 'i l	 s u p t 'i l 
propòsit	p ɾ u p 'ɔ z i t	 p ɾ u p 'ɔ z i t 
coptes	k 'ɔ p t ə s	 k 'ɔ p t ə s 
palanca	p ə l 'a ŋ k ə	 p ə l 'a ŋ k ə 
fortuna	f u r t 'u n ə	 f u r t 'u n ə 
trossar	t ɾ u s 'a	 t ɾ u s 'a 
equival	ə k i β 'a l	 ə k i β 'a l 
consultarem	k u n s u l t ə ɾ 'ɛ m	 k u n s u l t ə ɾ 'ɛ m 
punyeta	p u ɲ 'ɛ t ə	 p u ɲ 'ɛ t ə 
moralitzat	m u ɾ ə l i d z 'a t	 m u ɾ ə l i d z 'a t 
expandits	ə k s p ə n d 'i t s	 ə k s p ə n d 'i t s 
esclops	ə s k l 'ɔ p s	 ə s k l 'ɔ p s 
rocalla	r u k 'a ʎ ə	 r u k 'a ʎ ə 
jurídic	ʒ u ɾ 'i ð i k	 ʒ u ɾ 'i ð i k 
Set	s 'ɛ t	 s 'ɛ t 
quadruplicats	k w ə ð ɾ u p l i k 'a t s	 k w ə ð ɾ u p l i k 'a t s 
topades	t u p 'a ð ə s	 t u p 'a ð ə s 
experimentació	ə k s p ə ɾ i m ə n t ə s i 'o	 ə k s p ə ɾ i m ə n t ə s i 'o 
contactes	k u n t 'a k t ə s	 k u n t 'a k t ə s 
considerava	k u n s i ð ə ɾ 'a β ə	 k u n s i ð ə ɾ 'a β ə 
racionalitat	r ə s i u n ə l i t 'a t	 r ə s i u n ə l i t 'a t 
especial	ə s p ə s i 'a l	 ə s p ə s i 'a l 
afeblir	ə f ə b b l 'i	 ə f ə b b l 'i 
aixecant-li	ə ʃ ə k 'a n l i	 ə ʃ ə k 'a n l i 
evitant	ə β i t 'a n	 ə β i t 'a n 
joc	ʒ 'ɔ k	 ʒ 'ɔ k 
escalinata	ə s k ə l i n 'a t ə	 ə s k ə l i n 'a t ə 
fanàtica	f ə n 'a t i k ə	 f ə n 'a t i k ə 
nyoqui	ɲ 'ɔ k i	 ɲ 'ɔ k i 
Pasqual	p ə s k w 'a l	 p ə s k w 'a l 
calzes	k 'a l z ə s	 k 'a l z ə s 
ataca	ə t 'a k ə	 ə t 'a k ə 
testeja	t ə s t 'ɛ ʒ ə	 t ə s t 'ɛ ʒ ə 
congelada	k u n ʒ ə l 'a ð ə	 k u n ʒ ə l 'a ð ə 
catalana	k ə t ə l 'a n ə	 k ə t ə l 'a n ə 
intersectar	i n t ə r s ə k t 'a	 i n t ə r s ə k t 'a 
calçapeu	k ə l s ə p 'ɛ w	 k ə l s ə p 'ɛ w 
amplificar	ə m p l i f i k 'a	 ə m p l i f i k 'a 
disfrutar	d i s f ɾ u t 'a	 d i s f ɾ u t 'a 
burgesos	b u r ʒ 'ɛ z u s	 b u r ʒ 'ɛ z u s 
dificultats	d i f i k u l t 'a t s	 d i f i k u l t 'a t s 
consumisme	k u n s u m 'i z m ə	 k u n s u m 'i z m ə 
gala	g 'a l ə	 g 'a l ə 
esquitxó	ə s k i t ʃ 'o	 ə s k i t ʃ 'o 
banyista	b ə ɲ 'i s t ə	 b ə ɲ 'i s t ə 
consciència	k u n s i 'ɛ n s i ə	 k u n s i 'ɛ n s i ə 
absurd	ə p s 'u r t	 ə p s 'u r t 
subcutani	s u p k u t 'a n i	 s u p k u t 'a n i 
prosseguit	p ɾ u s ə ɣ 'i t	 p ɾ u s ə ɣ 'i t 
Conec	k u n 'ɛ k	 k u n 'ɛ k 
primat	p ɾ i m 'a t	 p ɾ i m 'a t 
pegàrem	p ə ɣ 'a ɾ ə m	 p ə ɣ 'a ɾ ə m 
alabança	ə l ə β 'a n s ə	 ə l ə β 'a n s ə 
podin	p 'ɔ ð i n	 p 'ɔ ð i n 
Canyelles	k ə ɲ 'e ʎ ə s	 k ə ɲ 'e ʎ ə s 
trobadoresca	t ɾ u β ə ð u ɾ 'ɛ s k ə	 t ɾ u β ə ð u ɾ 'ɛ s k ə 
neptuni	n ə p t 'u n i	 n ə p t 'u n i 
rebi	r 'ɛ β i	 r 'ɛ β i 
soleta	s u l 'ɛ t ə	 s u l 'ɛ t ə 
Mònica	m 'ɔ n i k ə	 m 'ɔ n i k ə 
vedar	b ə ð 'a	 b ə ð 'a 
extensiu	ə k s t ə n s 'i w	 ə k s t ə n s 'i w 
tendir	t ə n d 'i	 t ə n d 'i 
votats	b u t 'a t s	 b u t 'a t s 
embrutats	ə m b ɾ u t 'a t s	 ə m b ɾ u t 'a t s 
concentracions	k u n s ə n t ɾ ə s i 'o n s	 k u n s ə n t ɾ ə s i 'o n s 
nupcial	n u p s i 'a l	 n u p s i 'a l 
ploris	p l 'ɔ ɾ i s	 p l 'ɔ ɾ i s 
indicatius	i n d i k ə t 'i w s	 i n d i k ə t 'i w s 
conducció	k u n d u k s i 'o	 k u n d u k s i 'o 
empipades	ə m p i p 'a ð ə s	 ə m p i p 'a ð ə s 
tisoreta	t i z u ɾ 'ɛ t ə	 t i z u ɾ 'ɛ t ə 
abduïda	ə b d u 'i ð ə	 ə b d u 'i ð ə 
aprofitàrem	ə p ɾ u f i t 'a ɾ ə m	 ə p ɾ u f i t 'a ɾ ə m 
eixamplat	ə ʃ ə m p l 'a t	 ə ʃ ə m p l 'a t 
troba	t ɾ 'ɔ β ə	 t ɾ 'ɔ β ə 
for	f 'o	 f 'o 
epilobi	ə p i l 'ɔ β i	 ə p i l 'ɔ β i 
atrapada	ə t ɾ ə p 'a ð ə	 ə t ɾ ə p 'a ð ə 
Constantí	k u n s t ə n t 'i	 k u n s t ə n t 'i 
abaixarà	ə β ə ʃ ə ɾ 'a	 ə β ə ʃ ə ɾ 'a 
subornaria	s u β u r n ə ɾ 'i ə	 s u β u r n ə ɾ 'i ə 
mecànica	m ə k 'a n i k ə	 m ə k 'a n i k ə 
tendència	t ə n d 'ɛ n s i ə	 t ə n d 'ɛ n s i ə 
domat	d u m 'a t	 d u m 'a t 
deïficats	d ə i f i k 'a t s	 d ə i f i k 'a t s 
portat	p u r t 'a t	 p u r t 'a t 
amistoses	ə m i s t 'o z ə s	 ə m i s t 'o z ə s 
hirsutisme	i r s u t 'i z m ə	 i r s u t 'i z m ə 
determinats	d ə t ə r m i n 'a t s	 d ə t ə r m i n 'a t s 
Hestia	ə s t 'i ə	 ə s t 'i ə 
barreja	b ə r 'ɛ ʒ ə	 b ə r 'ɛ ʒ ə 
estabilitzada	ə s t ə β i l i d z 'a ð ə	 ə s t ə β i l i d z 'a ð ə 
discrepar	d i s k ɾ ə p 'a	 d i s k ɾ ə p 'a 
calcificades	k ə l s i f i k 'a ð ə s	 k ə l s i f i k 'a ð ə s 
incontrolable	i ŋ k u n t ɾ u l 'a b b l ə	 i ŋ k u n t ɾ u l 'a b b l ə 
lleial	ʎ ə j 'a l	 ʎ ə j 'a l 
descontentava	d ə s k u n t ə n t 'a β ə	 d ə s k u n t ə n t 'a β ə 
fusteta	f u s t 'ɛ t ə	 f u s t 'ɛ t ə 
demanem	d ə m ə n 'ɛ m	 d ə m ə n 'ɛ m 
esglaonades	ə z ɣ l ə u n 'a ð ə s	 ə z ɣ l ə u n 'a ð ə s 
brillava	b ɾ i ʎ 'a β ə	 b ɾ i ʎ 'a β ə 
comèdia	k u m 'ɛ ð i ə	 k u m 'ɛ ð i ə 
menjadora	m ə n ʒ ə ð 'o ɾ ə	 m ə n ʒ ə ð 'o ɾ ə 
telegrafiat	t ə l ə ɣ ɾ ə f i 'a t	 t ə l ə ɣ ɾ ə f i 'a t 
auxiliats	ə w k s i l i 'a t s	 ə w k s i l i 'a t s 
protestantisme	p ɾ u t ə s t ə n t 'i z m ə	 p ɾ u t ə s t ə n t 'i z m ə 
pesca	p 'ɛ s k ə	 p 'ɛ s k ə 
majestuosa	m ə ʒ ə s t u 'o z ə	 m ə ʒ ə s t u 'o z ə 
desconegut	d ə s k u n ə ɣ 'u t	 d ə s k u n ə ɣ 'u t 
obturar	u p t u ɾ 'a	 u p t u ɾ 'a 
Selecciona	s ə l ə k s i 'o n ə	 s ə l ə k s i 'o n ə 
sòbries	s 'ɔ β ɾ i ə s	 s 'ɔ β ɾ i ə s 
modernista	m u ð ə r n 'i s t ə	 m u ð ə r n 'i s t ə 
d'intentar	d i n t ə n t 'a	 d i n t ə n t 'a 
trencall	t ɾ ə ŋ k 'a ʎ	 t ɾ ə ŋ k 'a ʎ 
aquesta	ə k 'ɛ s t ə	 ə k 'ɛ s t ə 
balda	b 'a l d ə	 b 'a l d ə 
abeurada	ə β ə w ɾ 'a ð ə	 ə β ə w ɾ 'a ð ə 
desocupació	d ə z u k u p ə s i 'o	 d ə z u k u p ə s i 'o 
datar	d ə t 'a	 d ə t 'a 
armari	ə r m 'a ɾ i	 ə r m 'a ɾ i 
revocar	r ə β u k 'a	 r ə β u k 'a 
Roger	r u ʒ 'e	 r u ʒ 'e 
cuculla	k u k 'u ʎ ə	 k u k 'u ʎ ə 
Quasi	k w 'a z i	 k w 'a z i 
perseverada	p ə r s ə β ə ɾ 'a ð ə	 p ə r s ə β ə ɾ 'a ð ə 
desitjades	d ə z i d ʒ 'a ð ə s	 d ə z i d ʒ 'a ð ə s 
disseny	d i s 'ɛ ɲ	 d i s 'ɛ ɲ 
Extensió	ə k s t ə n s i 'o	 ə k s t ə n s i 'o 
ànodes	'a n u ð ə s	 'a n u ð ə s 
sabatilla	s ə β ə t 'i ʎ ə	 s ə β ə t 'i ʎ ə 
omanita	u m ə n 'i t ə	 u m ə n 'i t ə 
reprèn	r ə p ɾ 'ɛ n	 r ə p ɾ 'ɛ n 
passadissos	p ə s ə ð 'i s u s	 p ə s ə ð 'i s u s 
imposat	i m p u z 'a t	 i m p u z 'a t 
eucaliptus	ə w k ə l 'i p t u s	 ə w k ə l 'i p t u s 
baixes	b 'a ʃ ə s	 b 'a ʃ ə s 
trenares	t ɾ ə n 'a ɾ ə s	 t ɾ ə n 'a ɾ ə s 
sostenir	s u s t ə n 'i	 s u s t ə n 'i 
esquàlid	ə s k w 'a l i t	 ə s k w 'a l i t 
dissuadits	d i s u ə ð 'i t s	 d i s u ə ð 'i t s 
podria	p u ð ɾ 'i ə	 p u ð ɾ 'i ə 
diligent	d i l i ʒ 'e n	 d i l i ʒ 'e n 
arrapar	ə r ə p 'a	 ə r ə p 'a 
coixí	k u ʃ 'i	 k u ʃ 'i 
materna	m ə t 'ɛ r n ə	 m ə t 'ɛ r n ə 
destacar	d ə s t ə k 'a	 d ə s t ə k 'a 
l'esperit	l ə s p ə ɾ 'i t	 l ə s p ə ɾ 'i t 
bugaderies	b u ɣ ə ð ə ɾ 'i ə s	 b u ɣ ə ð ə ɾ 'i ə s 
actuar	ə k t u 'a	 ə k t u 'a 
utòpics	u t 'ɔ p i k s	 u t 'ɔ p i k s 
accessibles	ə k s ə s 'i b b l ə s	 ə k s ə s 'i b b l ə s 
Àlvar	'a l β ə r	 'a l β ə r 
encongides	ə ŋ k u n ʒ 'i ð ə s	 ə ŋ k u n ʒ 'i ð ə s 
premsis	p ɾ 'ɛ m s i s	 p ɾ 'ɛ m s i s 
especificada	ə s p ə s i f i k 'a ð ə	 ə s p ə s i f i k 'a ð ə 
cort	k 'o r t	 k 'o r t 
tim	t 'i m	 t 'i m 
Català	k ə t ə l 'a	 k ə t ə l 'a 
metatextual	m ə t ə t ə k s t u 'a l	 m ə t ə t ə k s t u 'a l 
històrica	i s t 'ɔ ɾ i k ə	 i s t 'ɔ ɾ i k ə 
boicotejar	b u j k u t ə ʒ 'a	 b u j k u t ə ʒ 'a 
acabàvem	ə k ə β 'a β ə m	 ə k ə β 'a β ə m 
rebotudes	r ə β u t 'u ð ə s	 r ə β u t 'u ð ə s 
classifico	k l ə s i f 'i k u	 k l ə s i f 'i k u 
abusiu	ə β u z 'i w	 ə β u z 'i w 
osco	'ɔ s k u	 'ɔ s k u 
corretjut	k u r ə d ʒ 'u t	 k u r ə d ʒ 'u t 
farmacèutics	f ə r m ə s 'ɛ w t i k s	 f ə r m ə s 'ɛ w t i k s 
escaparat	ə s k ə p ə ɾ 'a t	 ə s k ə p ə ɾ 'a t 
desbrossades	d ə z β ɾ u s 'a ð ə s	 d ə z β ɾ u s 'a ð ə s 
incorporem	i ŋ k u r p u ɾ 'ɛ m	 i ŋ k u r p u ɾ 'ɛ m 
intermediari	i n t ə r m ə ð i 'a ɾ i	 i n t ə r m ə ð i 'a ɾ i 
aplanar	ə p l ə n 'a	 ə p l ə n 'a 
prefix	p ɾ ə f 'i k s	 p ɾ ə f 'i k s 
refutat	r ə f u t 'a t	 r ə f u t 'a t 
sedació	s ə ð ə s i 'o	 s ə ð ə s i 'o 
nino	n 'i n u	 n 'i n u 
complicaria	k u m p l i k ə ɾ 'i ə	 k u m p l i k ə ɾ 'i ə 
cornises	k u r n 'i z ə s	 k u r n 'i z ə s 
flirtejats	f l i r t ə ʒ 'a t s	 f l i r t ə ʒ 'a t s 
desprès	d ə s p ɾ 'ɛ s	 d ə s p ɾ 'ɛ s 
cobren	k 'ɔ β ɾ ə n	 k 'ɔ β ɾ ə n 
traïdors	t ɾ ə i ð 'o s	 t ɾ ə i ð 'o s 
digressió	d i ɣ ɾ ə s i 'o	 d i ɣ ɾ ə s i 'o 
Frip	f ɾ 'i p	 f ɾ 'i p 
adults	ə ð 'u l s	 ə ð 'u l s 
pretenem	p ɾ ə t ə n 'ɛ m	 p ɾ ə t ə n 'ɛ m 
D'això	d ə ʃ 'ɔ	 d ə ʃ 'ɔ 
digerits	d i ʒ ə ɾ 'i t s	 d i ʒ ə ɾ 'i t s 
gent	ʒ 'e n	 ʒ 'e n 
catòlics	k ə t 'ɔ l i k s	 k ə t 'ɔ l i k s 
hospitalitzar	u s p i t ə l i d z 'a	 u s p i t ə l i d z 'a 
invertida	i m b ə r t 'i ð ə	 i m b ə r t 'i ð ə 
submarinista	s u b m ə ɾ i n 'i s t ə	 s u b m ə ɾ i n 'i s t ə 
amplificades	ə m p l i f i k 'a ð ə s	 ə m p l i f i k 'a ð ə s 
majoritaris	m ə ʒ u ɾ i t 'a ɾ i s	 m ə ʒ u ɾ i t 'a ɾ i s 
propina	p ɾ u p 'i n ə	 p ɾ u p 'i n ə 
l'ofrena	l u f ɾ 'ɛ n ə	 l u f ɾ 'ɛ n ə 
detingut	d ə t i ŋ g 'u t	 d ə t i ŋ g 'u t 
persuadir	p ə r s u ə ð 'i	 p ə r s u ə ð 'i 
toquen	t 'ɔ k ə n	 t 'ɔ k ə n 
fusionats	f u z i u n 'a t s	 f u z i u n 'a t s 
Cacumen	k ə k 'u m ə n	 k ə k 'u m ə n 
desunit	d ə z u n 'i t	 d ə z u n 'i t 
reconèixer	r ə k u n 'ɛ ʃ ə	 r ə k u n 'ɛ ʃ ə 
tractades	t ɾ ə k t 'a ð ə s	 t ɾ ə k t 'a ð ə s 
tucans	t u k 'a n s	 t u k 'a n s 
blasfemar	b l ə s f ə m 'a	 b l ə s f ə m 'a 
agua	'a ɣ w ə	 'a ɣ w ə 
compostar	k u m p u s t 'a	 k u m p u s t 'a 
afegim	ə f ə ʒ 'i m	 ə f ə ʒ 'i m 
tanta	t 'a n t ə	 t 'a n t ə 
eurocèntric	ə w ɾ u s 'ɛ n t ɾ i k	 ə w ɾ u s 'ɛ n t ɾ i k 
encàrrecs	ə ŋ k 'a r ə k s	 ə ŋ k 'a r ə k s 
tenebrosa	t ə n ə β ɾ 'o z ə	 t ə n ə β ɾ 'o z ə 
llaüt	ʎ ə 'u t	 ʎ ə 'u t 
marxin	m 'a r ʃ i n	 m 'a r ʃ i n 
escalfar	ə s k ə l f 'a	 ə s k ə l f 'a 
sintonitzat	s i n t u n i d z 'a t	 s i n t u n i d z 'a t 
alarmes	ə l 'a r m ə s	 ə l 'a r m ə s 
carni	k 'a r n i	 k 'a r n i 
agrupacions	ə ɣ ɾ u p ə s i 'o n s	 ə ɣ ɾ u p ə s i 'o n s 
timbala	t i m b 'a l ə	 t i m b 'a l ə 
fresar	f ɾ ə z 'a	 f ɾ ə z 'a 
exportar	ə k s p u r t 'a	 ə k s p u r t 'a 
nadada	n ə ð 'a ð ə	 n ə ð 'a ð ə 
ventrut	b ə n t ɾ 'u t	 b ə n t ɾ 'u t 
acció	ə k s i 'o	 ə k s i 'o 
brillants	b ɾ i ʎ 'a n s	 b ɾ i ʎ 'a n s 
catapulta	k ə t ə p 'u l t ə	 k ə t ə p 'u l t ə 
comptada	k u m t 'a ð ə	 k u m t 'a ð ə 
opcions	u p s i 'o n s	 u p s i 'o n s 
brotades	b ɾ u t 'a ð ə s	 b ɾ u t 'a ð ə s 
alodial	ə l u ð i 'a l	 ə l u ð i 'a l 
refringir	r ə f ɾ i n ʒ 'i	 r ə f ɾ i n ʒ 'i 
obrim	u β ɾ 'i m	 u β ɾ 'i m 
apunyalats	ə p u ɲ ə l 'a t s	 ə p u ɲ ə l 'a t s 
reformadors	r ə f u r m ə ð 'o s	 r ə f u r m ə ð 'o s 
poloneses	p u l u n 'ɛ z ə s	 p u l u n 'ɛ z ə s 
econòmica	ə k u n 'ɔ m i k ə	 ə k u n 'ɔ m i k ə 
melva	m 'ɛ l β ə	 m 'ɛ l β ə 
contestat	k u n t ə s t 'a t	 k u n t ə s t 'a t 
mansega	m ə n s 'ɛ ɣ ə	 m ə n s 'ɛ ɣ ə 
sessió	s ə s i 'o	 s ə s i 'o 
clota	k l 'ɔ t ə	 k l 'ɔ t ə 
multiplicatius	m u l t i p l i k ə t 'i w s	 m u l t i p l i k ə t 'i w s 
suavitzar	s u ə β i d z 'a	 s u ə β i d z 'a 
l'embaràs	l ə m b ə ɾ 'a s	 l ə m b ə ɾ 'a s 
excedent	ə k s ə ð 'e n	 ə k s ə ð 'e n 
ascensió	ə s ə n s i 'o	 ə s ə n s i 'o 
canto	k 'a n t u	 k 'a n t u 
intentar	i n t ə n t 'a	 i n t ə n t 'a 
debatre	d ə β 'a t ɾ ə	 d ə β 'a t ɾ ə 
navilis	n ə β 'i l i s	 n ə β 'i l i s 
ballada	b ə ʎ 'a ð ə	 b ə ʎ 'a ð ə 
gestada	ʒ ə s t 'a ð ə	 ʒ ə s t 'a ð ə 
clavellet	k l ə β ə ʎ 'ɛ t	 k l ə β ə ʎ 'ɛ t 
lubricat	l u β ɾ i k 'a t	 l u β ɾ i k 'a t 
precedits	p ɾ ə s ə ð 'i t s	 p ɾ ə s ə ð 'i t s 
barroc	b ə r 'ɔ k	 b ə r 'ɔ k 
insultàrem	i n s u l t 'a ɾ ə m	 i n s u l t 'a ɾ ə m 
pràctica	p ɾ 'a k t i k ə	 p ɾ 'a k t i k ə 
reflexoteràpia	r ə f l ə k s u t ə ɾ 'a p i ə	 r ə f l ə k s u t ə ɾ 'a p i ə 
grip	g ɾ 'i p	 g ɾ 'i p 
flotador	f l u t ə ð 'o	 f l u t ə ð 'o 
raonat	r ə u n 'a t	 r ə u n 'a t 
gratuïtes	g ɾ ə t u 'i t ə s	 g ɾ ə t u 'i t ə s 
tempra	t 'ɛ m p ɾ ə	 t 'ɛ m p ɾ ə 
meritoris	m ə ɾ i t 'ɔ ɾ i s	 m ə ɾ i t 'ɔ ɾ i s 
broca	b ɾ 'ɔ k ə	 b ɾ 'ɔ k ə 
vedàrem	b ə ð 'a ɾ ə m	 b ə ð 'a ɾ ə m 
assegurats	ə s ə ɣ u ɾ 'a t s	 ə s ə ɣ u ɾ 'a t s 
anestèsia	ə n ə s t 'ɛ z i ə	 ə n ə s t 'ɛ z i ə 
originar	u ɾ i ʒ i n 'a	 u ɾ i ʒ i n 'a 
caducitats	k ə ð u s i t 'a t s	 k ə ð u s i t 'a t s 
Llatina	ʎ ə t 'i n ə	 ʎ ə t 'i n ə 
cabritilla	k ə β ɾ i t 'i ʎ ə	 k ə β ɾ i t 'i ʎ ə 
benevolència	b ə n ə β u l 'ɛ n s i ə	 b ə n ə β u l 'ɛ n s i ə 
sensibilitat	s ə n s i β i l i t 'a t	 s ə n s i β i l i t 'a t 
fluixesa	f l u ʃ 'ɛ z ə	 f l u ʃ 'ɛ z ə 
Salut	s ə l 'u t	 s ə l 'u t 
atributs	ə t ɾ i β 'u t s	 ə t ɾ i β 'u t s 
inutilitzar	i n u t i l i d z 'a	 i n u t i l i d z 'a 
ompli	'ɔ m p l i	 'ɔ m p l i 
vandalisme	b ə n d ə l 'i z m ə	 b ə n d ə l 'i z m ə 
calli	k 'a ʎ i	 k 'a ʎ i 
barralet	b ə r ə l 'ɛ t	 b ə r ə l 'ɛ t 
capitalitats	k ə p i t ə l i t 'a t s	 k ə p i t ə l i t 'a t s 
concentrat	k u n s ə n t ɾ 'a t	 k u n s ə n t ɾ 'a t 
Catalunya	k ə t ə l 'u ɲ ə	 k ə t ə l 'u ɲ ə 
abundares	ə β u n d 'a ɾ ə s	 ə β u n d 'a ɾ ə s 
Ús	'u s	 'u s 
manovella	m ə n u β 'e ʎ ə	 m ə n u β 'e ʎ ə 
rares	r 'a ɾ ə s	 r 'a ɾ ə s 
abrandats	ə β ɾ ə n d 'a t s	 ə β ɾ ə n d 'a t s 
accelerades	ə k s ə l ə ɾ 'a ð ə s	 ə k s ə l ə ɾ 'a ð ə s 
Deixem-ho	d ə ʃ 'ɛ m u	 d ə ʃ 'ɛ m u 
enquadrar	ə ŋ k w ə ð ɾ 'a	 ə ŋ k w ə ð ɾ 'a 
calma	k 'a l m ə	 k 'a l m ə 
cosmopolites	k u z m u p u l 'i t ə s	 k u z m u p u l 'i t ə s 
cadena	k ə ð 'ɛ n ə	 k ə ð 'ɛ n ə 
existien	ə g z i s t 'i ə n	 ə g z i s t 'i ə n 
entremaliadura	ə n t ɾ ə m ə l i ə ð 'u ɾ ə	 ə n t ɾ ə m ə l i ə ð 'u ɾ ə 
ermàs	ə r m 'a s	 ə r m 'a s 
dur	d 'u	 d 'u 
suposada	s u p u z 'a ð ə	 s u p u z 'a ð ə 
impures	i m p 'u ɾ ə s	 i m p 'u ɾ ə s 
combregador	k u m b ɾ ə ɣ ə ð 'o	 k u m b ɾ ə ɣ ə ð 'o 
coincidirà	k u i n s i ð i ɾ 'a	 k u i n s i ð i ɾ 'a 
bolígraf	b u l 'i ɣ ɾ ə f	 b u l 'i ɣ ɾ ə f 
semàfor	s ə m 'a f u r	 s ə m 'a f u r 
monegasca	m u n ə ɣ 'a s k ə	 m u n ə ɣ 'a s k ə 
Moràvia	m u ɾ 'a β i ə	 m u ɾ 'a β i ə 
implantat	i m p l ə n t 'a t	 i m p l ə n t 'a t 
local	l u k 'a l	 l u k 'a l 
ubiqui	u β 'i k i	 u β 'i k i 
martell	m ə r t 'e ʎ	 m ə r t 'e ʎ 
aprovat	ə p ɾ u β 'a t	 ə p ɾ u β 'a t 
mancomunar	m ə ŋ k u m u n 'a	 m ə ŋ k u m u n 'a 
difamació	d i f ə m ə s i 'o	 d i f ə m ə s i 'o 
fronterera	f ɾ u n t ə ɾ 'e ɾ ə	 f ɾ u n t ə ɾ 'e ɾ ə 
refregat	r ə f ɾ ə ɣ 'a t	 r ə f ɾ ə ɣ 'a t 
distanciats	d i s t ə n s i 'a t s	 d i s t ə n s i 'a t s 
delinquir	d ə l i ŋ k 'i	 d ə l i ŋ k 'i 
repetirà	r ə p ə t i ɾ 'a	 r ə p ə t i ɾ 'a 
contraposat	k u n t ɾ ə p u z 'a t	 k u n t ɾ ə p u z 'a t 
encetats	ə n s ə t 'a t s	 ə n s ə t 'a t s 
alçada	ə l s 'a ð ə	 ə l s 'a ð ə 
arcà	ə r k 'a	 ə r k 'a 
traces	t ɾ 'a s ə s	 t ɾ 'a s ə s 
integritat	i n t ə ɣ ɾ i t 'a t	 i n t ə ɣ ɾ i t 'a t 
artigar	ə r t i ɣ 'a	 ə r t i ɣ 'a 
bàdminton	b 'a d m i n t u n	 b 'a d m i n t u n 
antibacteriana	ə n t i β ə k t ə ɾ i 'a n ə	 ə n t i β ə k t ə ɾ i 'a n ə 
Alfils	ə l f 'i l s	 ə l f 'i l s 
trampa	t ɾ 'a m p ə	 t ɾ 'a m p ə 
abrasiu	ə β ɾ ə z 'i w	 ə β ɾ ə z 'i w 
grava	g ɾ 'a β ə	 g ɾ 'a β ə 
orientació	u ɾ i ə n t ə s i 'o	 u ɾ i ə n t ə s i 'o 
calorimètrica	k ə l u ɾ i m 'ɛ t ɾ i k ə	 k ə l u ɾ i m 'ɛ t ɾ i k ə 
brogit	b ɾ u ʒ 'i t	 b ɾ u ʒ 'i t 
lleonat	ʎ ə u n 'a t	 ʎ ə u n 'a t 
professor	p ɾ u f ə s 'o	 p ɾ u f ə s 'o 
brindares	b ɾ i n d 'a ɾ ə s	 b ɾ i n d 'a ɾ ə s 
incomodada	i ŋ k u m u ð 'a ð ə	 i ŋ k u m u ð 'a ð ə 
tradicionalista	t ɾ ə ð i s i u n ə l 'i s t ə	 t ɾ ə ð i s i u n ə l 'i s t ə 
manifestaria	m ə n i f ə s t ə ɾ 'i ə	 m ə n i f ə s t ə ɾ 'i ə 
alletat	ə ʎ ə t 'a t	 ə ʎ ə t 'a t 
ideal	i ð e 'a l	 i ð e 'a l 
estiu	ə s t 'i w	 ə s t 'i w 
abraçades	ə β ɾ ə s 'a ð ə s	 ə β ɾ ə s 'a ð ə s 
s'aguanten	s ə ɣ w 'a n t ə n	 s ə ɣ w 'a n t ə n 
exculpats	ə k s k u l p 'a t s	 ə k s k u l p 'a t s 
establint-se	ə s t ə b b l 'i n s ə	 ə s t ə b b l 'i n s ə 
adulteri	ə ð u l t 'ɛ ɾ i	 ə ð u l t 'ɛ ɾ i 
patró	p ə t ɾ 'o	 p ə t ɾ 'o 
propà	p ɾ u p 'a	 p ɾ u p 'a 
falsificar	f ə l s i f i k 'a	 f ə l s i f i k 'a 
acidificar	ə s i ð i f i k 'a	 ə s i ð i f i k 'a 
marcaria	m ə r k ə ɾ 'i ə	 m ə r k ə ɾ 'i ə 
oportú	u p u r t 'u	 u p u r t 'u 
treballar	t ɾ ə β ə ʎ 'a	 t ɾ ə β ə ʎ 'a 
arquitecta	ə r k i t 'ɛ k t ə	 ə r k i t 'ɛ k t ə 
tresorer	t ɾ ə z u ɾ 'e	 t ɾ ə z u ɾ 'e 
debilitat	d ə β i l i t 'a t	 d ə β i l i t 'a t 
punxuts	p u n ʃ 'u t s	 p u n ʃ 'u t s 
progressats	p ɾ u ɣ ɾ ə s 'a t s	 p ɾ u ɣ ɾ ə s 'a t s 
cosmòloga	k u z m 'ɔ l u ɣ ə	 k u z m 'ɔ l u ɣ ə 
panoràmics	p ə n u ɾ 'a m i k s	 p ə n u ɾ 'a m i k s 
bobinada	b u β i n 'a ð ə	 b u β i n 'a ð ə 
rutè	r u t 'ɛ	 r u t 'ɛ 
irrellevant	i r ə ʎ ə β 'a n	 i r ə ʎ ə β 'a n 
mielina	m i ə l 'i n ə	 m i ə l 'i n ə 
esquitxats	ə s k i t ʃ 'a t s	 ə s k i t ʃ 'a t s 
cena	s 'ɛ n ə	 s 'ɛ n ə 
llavades	ʎ ə β 'a ð ə s	 ʎ ə β 'a ð ə s 
quasiposterior	k w ə z i p u s t ə ɾ i 'o	 k w ə z i p u s t ə ɾ i 'o 
fermentaria	f ə r m ə n t ə ɾ 'i ə	 f ə r m ə n t ə ɾ 'i ə 
empalat	ə m p ə l 'a t	 ə m p ə l 'a t 
acadèmic	ə k ə ð 'ɛ m i k	 ə k ə ð 'ɛ m i k 
d'atacar	d ə t ə k 'a	 d ə t ə k 'a 
assemblant	ə s ə m b l 'a n	 ə s ə m b l 'a n 
poltra	p 'ɔ l t ɾ ə	 p 'ɔ l t ɾ ə 
selva	s 'ɛ l β ə	 s 'ɛ l β ə 
poncir	p u n s 'i	 p u n s 'i 
romanesa	r u m ə n 'ɛ z ə	 r u m ə n 'ɛ z ə 
decorat	d ə k u ɾ 'a t	 d ə k u ɾ 'a t 
elles	'e ʎ ə s	 'e ʎ ə s 
assabentada	ə s ə β ə n t 'a ð ə	 ə s ə β ə n t 'a ð ə 
cançó	k ə n s 'o	 k ə n s 'o 
americanitzada	ə m ə ɾ i k ə n i d z 'a ð ə	 ə m ə ɾ i k ə n i d z 'a ð ə 
paris	p 'a ɾ i s	 p 'a ɾ i s 
restringida	r ə s t ɾ i n ʒ 'i ð ə	 r ə s t ɾ i n ʒ 'i ð ə 
auto	'a w t u	 'a w t u 
calaràs	k ə l ə ɾ 'a s	 k ə l ə ɾ 'a s 
espinosa	ə s p i n 'o z ə	 ə s p i n 'o z ə 
analitzador	ə n ə l i d z ə ð 'o	 ə n ə l i d z ə ð 'o 
xaria	ʃ ə ɾ 'i ə	 ʃ ə ɾ 'i ə 
Sara	s 'a ɾ ə	 s 'a ɾ ə 
fenàs	f ə n 'a s	 f ə n 'a s 
comprenent	k u m p ɾ ə n 'e n	 k u m p ɾ ə n 'e n 
seduir	s ə ð u 'i	 s ə ð u 'i 
variació	b ə ɾ i ə s i 'o	 b ə ɾ i ə s i 'o 
ostentar	u s t ə n t 'a	 u s t ə n t 'a 
inacabada	i n ə k ə β 'a ð ə	 i n ə k ə β 'a ð ə 
aïnar	ə i n 'a	 ə i n 'a 
gravi	g ɾ 'a β i	 g ɾ 'a β i 
doblatge	d u b b l 'a d ʒ ə	 d u b b l 'a d ʒ ə 
sorneguera	s u r n ə ɣ 'e ɾ ə	 s u r n ə ɣ 'e ɾ ə 
pescaclics	p ə s k ə k l 'i k s	 p ə s k ə k l 'i k s 
estripades	ə s t ɾ i p 'a ð ə s	 ə s t ɾ i p 'a ð ə s 
sofriment	s u f ɾ i m 'e n	 s u f ɾ i m 'e n 
rebuf	r ə β 'u f	 r ə β 'u f 
rumorejat	r u m u ɾ ə ʒ 'a t	 r u m u ɾ ə ʒ 'a t 
ronronejar	r u n r u n ə ʒ 'a	 r u n r u n ə ʒ 'a 
destinada	d ə s t i n 'a ð ə	 d ə s t i n 'a ð ə 
s'escola	s ə s k 'ɔ l ə	 s ə s k 'ɔ l ə 
rambles	r 'a m b l ə s	 r 'a m b l ə s 
ultimàtum	u l t i m 'a t u m	 u l t i m 'a t u m 
nitrificats	n i t ɾ i f i k 'a t s	 n i t ɾ i f i k 'a t s 
Sorprèn	s u r p ɾ 'ɛ n	 s u r p ɾ 'ɛ n 
xisclat	ʃ i s k l 'a t	 ʃ i s k l 'a t 
Joaquim	ʒ u ə k 'i m	 ʒ u ə k 'i m 
cosit	k u z 'i t	 k u z 'i t 
llençada	ʎ ə n s 'a ð ə	 ʎ ə n s 'a ð ə 
violinista	b i u l i n 'i s t ə	 b i u l i n 'i s t ə 
molt	m 'o l	 m 'o l 
marianista	m ə ɾ i ə n 'i s t ə	 m ə ɾ i ə n 'i s t ə 
travessar	t ɾ ə β ə s 'a	 t ɾ ə β ə s 'a 
guants	g w 'a n s	 g w 'a n s 
contradiccions	k u n t ɾ ə ð i k s i 'o n s	 k u n t ɾ ə ð i k s i 'o n s 
rogallós	r u ɣ ə ʎ 'o s	 r u ɣ ə ʎ 'o s 
deducció	d ə ð u k s i 'o	 d ə ð u k s i 'o 
solti	s 'ɔ l t i	 s 'ɔ l t i 
vulnerat	b u l n ə ɾ 'a t	 b u l n ə ɾ 'a t 
matolls	m ə t 'o ʎ s	 m ə t 'o ʎ s 
individu	i n d i β 'i ð u	 i n d i β 'i ð u 
octa	'ɔ k t ə	 'ɔ k t ə 
afalagades	ə f ə l ə ɣ 'a ð ə s	 ə f ə l ə ɣ 'a ð ə s 
domada	d u m 'a ð ə	 d u m 'a ð ə 
plantejament	p l ə n t ə ʒ ə m 'e n	 p l ə n t ə ʒ ə m 'e n 
subcutànies	s u p k u t 'a n i ə s	 s u p k u t 'a n i ə s 
operats	u p ə ɾ 'a t s	 u p ə ɾ 'a t s 
esquaix	ə s k w 'a ʃ	 ə s k w 'a ʃ 
Antilia	ə n t i l 'i ə	 ə n t i l 'i ə 
felina	f ə l 'i n ə	 f ə l 'i n ə 
caricaturista	k ə ɾ i k ə t u ɾ 'i s t ə	 k ə ɾ i k ə t u ɾ 'i s t ə 
raspades	r ə s p 'a ð ə s	 r ə s p 'a ð ə s 
IVE	'i β ə	 'i β ə 
estropiares	ə s t ɾ u p i 'a ɾ ə s	 ə s t ɾ u p i 'a ɾ ə s 
amblis	'a m b l i s	 'a m b l i s 
immunològica	i m m u n u l 'ɔ ʒ i k ə	 i m m u n u l 'ɔ ʒ i k ə 
habituals	ə β i t u 'a l s	 ə β i t u 'a l s 
Victòria	b i k t 'ɔ ɾ i ə	 b i k t 'ɔ ɾ i ə 
invitada	i m b i t 'a ð ə	 i m b i t 'a ð ə 
cursors	k u r s 'o s	 k u r s 'o s 
bèquic	b 'ɛ k i k	 b 'ɛ k i k 
agradar	ə ɣ ɾ ə ð 'a	 ə ɣ ɾ ə ð 'a 
nosocomial	n u z u k u m i 'a l	 n u z u k u m i 'a l 
neoclàssica	n ə u k l 'a s i k ə	 n ə u k l 'a s i k ə 
escrivint-te	ə s k ɾ i β 'i n t ə	 ə s k ɾ i β 'i n t ə 
reproduïdes	r ə p ɾ u ð u 'i ð ə s	 r ə p ɾ u ð u 'i ð ə s 
depressió	d ə p ɾ ə s i 'o	 d ə p ɾ ə s i 'o 
diluviar	d i l u β i 'a	 d i l u β i 'a 
metodològiques	m ə t u ð u l 'ɔ ʒ i k ə s	 m ə t u ð u l 'ɔ ʒ i k ə s 
llaviejar	ʎ ə β i ə ʒ 'a	 ʎ ə β i ə ʒ 'a 
moixina	m u ʃ 'i n ə	 m u ʃ 'i n ə 
potència	p u t 'ɛ n s i ə	 p u t 'ɛ n s i ə 
càlid	k 'a l i t	 k 'a l i t 
versificat	b ə r s i f i k 'a t	 b ə r s i f i k 'a t 
espacial	ə s p ə s i 'a l	 ə s p ə s i 'a l 
M'esforçava	m ə s f u r s 'a β ə	 m ə s f u r s 'a β ə 
finalitza	f i n ə l 'i d z ə	 f i n ə l 'i d z ə 
copsats	k u p s 'a t s	 k u p s 'a t s 
d'acompanyar	d ə k u m p ə ɲ 'a	 d ə k u m p ə ɲ 'a 
radioajudes	r ə ð i u ə ʒ 'u ð ə s	 r ə ð i u ə ʒ 'u ð ə s 
reflectia	r ə f l ə k t 'i ə	 r ə f l ə k t 'i ə 
demanda	d ə m 'a n d ə	 d ə m 'a n d ə 
plaga	p l 'a ɣ ə	 p l 'a ɣ ə 
harmonia	ə r m u n 'i ə	 ə r m u n 'i ə 
eclèctic	ə k l 'ɛ k t i k	 ə k l 'ɛ k t i k 
Carretera	k ə r ə t 'e ɾ ə	 k ə r ə t 'e ɾ ə 
fóssim	f 'o s i m	 f 'o s i m 
Llocs	ʎ 'ɔ k s	 ʎ 'ɔ k s 
mixta	m 'i k s t ə	 m 'i k s t ə 
costés	k u s t 'e s	 k u s t 'e s 
conren	k 'ɔ n r ə n	 k 'ɔ n r ə n 
clonat	k l u n 'a t	 k l u n 'a t 
encaixat	ə ŋ k ə ʃ 'a t	 ə ŋ k ə ʃ 'a t 
besada	b ə z 'a ð ə	 b ə z 'a ð ə 
altiu	ə l t 'i w	 ə l t 'i w 
fiar	f i 'a	 f i 'a 
Sortir	s u r t 'i	 s u r t 'i 
implícita	i m p l 'i s i t ə	 i m p l 'i s i t ə 
tallats	t ə ʎ 'a t s	 t ə ʎ 'a t s 
batallons	b ə t ə ʎ 'o n s	 b ə t ə ʎ 'o n s 
remaràs	r ə m ə ɾ 'a s	 r ə m ə ɾ 'a s 
ramegall	r ə m ə ɣ 'a ʎ	 r ə m ə ɣ 'a ʎ 
urtar	u r t 'a	 u r t 'a 
tàctica	t 'a k t i k ə	 t 'a k t i k ə 
temperament	t ə m p ə ɾ ə m 'e n	 t ə m p ə ɾ ə m 'e n 
originàries	u ɾ i ʒ i n 'a ɾ i ə s	 u ɾ i ʒ i n 'a ɾ i ə s 
interrogar	i n t ə r u ɣ 'a	 i n t ə r u ɣ 'a 
Genís	ʒ ə n 'i s	 ʒ ə n 'i s 
còmic	k 'ɔ m i k	 k 'ɔ m i k 
mínima	m 'i n i m ə	 m 'i n i m ə 
cert	s 'ɛ r t	 s 'ɛ r t 
Sam	s 'a m	 s 'a m 
s'avorria	s ə β u r 'i ə	 s ə β u r 'i ə 
imprimíssim	i m p ɾ i m 'i s i m	 i m p ɾ i m 'i s i m 
escondir	ə s k u n d 'i	 ə s k u n d 'i 
mediació	m ə ð i ə s i 'o	 m ə ð i ə s i 'o 
obsessió	u p s ə s i 'o	 u p s ə s i 'o 
suportats	s u p u r t 'a t s	 s u p u r t 'a t s 
acrobàtiques	ə k ɾ u β 'a t i k ə s	 ə k ɾ u β 'a t i k ə s 
elàstiques	ə l 'a s t i k ə s	 ə l 'a s t i k ə s 
francs	f ɾ 'a ŋ s	 f ɾ 'a ŋ s 
pronunciem	p ɾ u n u n s i 'ɛ m	 p ɾ u n u n s i 'ɛ m 
cabrons	k ə β ɾ 'o n s	 k ə β ɾ 'o n s 
espantar-los	ə s p ə n t 'a r l u s	 ə s p ə n t 'a r l u s 
musculós	m u s k u l 'o s	 m u s k u l 'o s 
evidenciat	ə β i ð ə n s i 'a t	 ə β i ð ə n s i 'a t 
piuar	p i w 'a	 p i w 'a 
fonètiques	f u n 'ɛ t i k ə s	 f u n 'ɛ t i k ə s 
completades	k u m p l ə t 'a ð ə s	 k u m p l ə t 'a ð ə s 
repicatalons	r ə p i k ə t ə l 'o n s	 r ə p i k ə t ə l 'o n s 
opinaria	u p i n ə ɾ 'i ə	 u p i n ə ɾ 'i ə 
teclegen	t ə k l 'ɛ ʒ ə n	 t ə k l 'ɛ ʒ ə n 
inaccentuat	i n ə k s ə n t u 'a t	 i n ə k s ə n t u 'a t 
abastar	ə β ə s t 'a	 ə β ə s t 'a 
ciències	s i 'ɛ n s i ə s	 s i 'ɛ n s i ə s 
tantalitzada	t ə n t ə l i d z 'a ð ə	 t ə n t ə l i d z 'a ð ə 
avenir	ə β ə n 'i	 ə β ə n 'i 
foscor	f u s k 'o	 f u s k 'o 
desballestar	d ə z β ə ʎ ə s t 'a	 d ə z β ə ʎ ə s t 'a 
campionat	k ə m p i u n 'a t	 k ə m p i u n 'a t 
deïtat	d ə i t 'a t	 d ə i t 'a t 
impura	i m p 'u ɾ ə	 i m p 'u ɾ ə 
liquen	l 'i k ə n	 l 'i k ə n 
esmòquing	ə z m 'ɔ k i ŋ	 ə z m 'ɔ k i ŋ 
incapacitar	i ŋ k ə p ə s i t 'a	 i ŋ k ə p ə s i t 'a 
minvada	m i m b 'a ð ə	 m i m b 'a ð ə 
completin	k u m p l 'ɛ t i n	 k u m p l 'ɛ t i n 
recalades	r ə k ə l 'a ð ə s	 r ə k ə l 'a ð ə s 
cansalades	k ə n s ə l 'a ð ə s	 k ə n s ə l 'a ð ə s 
descartada	d ə s k ə r t 'a ð ə	 d ə s k ə r t 'a ð ə 
rebotats	r ə β u t 'a t s	 r ə β u t 'a t s 
competida	k u m p ə t 'i ð ə	 k u m p ə t 'i ð ə 
involuntaris	i m b u l u n t 'a ɾ i s	 i m b u l u n t 'a ɾ i s 
Jònia	ʒ 'ɔ n i ə	 ʒ 'ɔ n i ə 
funeral	f u n ə ɾ 'a l	 f u n ə ɾ 'a l 
intersectades	i n t ə r s ə k t 'a ð ə s	 i n t ə r s ə k t 'a ð ə s 
pornogràfica	p u r n u ɣ ɾ 'a f i k ə	 p u r n u ɣ ɾ 'a f i k ə 
ciutadana	s i w t ə ð 'a n ə	 s i w t ə ð 'a n ə 
encaminar	ə ŋ k ə m i n 'a	 ə ŋ k ə m i n 'a 
acollidor	ə k u ʎ i ð 'o	 ə k u ʎ i ð 'o 
pinya	p 'i ɲ ə	 p 'i ɲ ə 
ossos	'ɔ s u s	 'ɔ s u s 
contàrem	k u n t 'a ɾ ə m	 k u n t 'a ɾ ə m 
filipins	f i l i p 'i n s	 f i l i p 'i n s 
disputo	d i s p 'u t u	 d i s p 'u t u 
adaptada	ə ð ə p t 'a ð ə	 ə ð ə p t 'a ð ə 
pregada	p ɾ ə ɣ 'a ð ə	 p ɾ ə ɣ 'a ð ə 
millorar	m i ʎ u ɾ 'a	 m i ʎ u ɾ 'a 
arrancar	ə r ə ŋ k 'a	 ə r ə ŋ k 'a 
cercaria	s ə r k ə ɾ 'i ə	 s ə r k ə ɾ 'i ə 
prefaci	p ɾ ə f 'a s i	 p ɾ ə f 'a s i 
saxífraga	s ə k s 'i f ɾ ə ɣ ə	 s ə k s 'i f ɾ ə ɣ ə 
sexta	s 'ɛ k s t ə	 s 'ɛ k s t ə 
teses	t 'ɛ z ə s	 t 'ɛ z ə s 
Malgrat	m ə l ɣ ɾ 'a t	 m ə l ɣ ɾ 'a t 
commemorada	k u m m ə m u ɾ 'a ð ə	 k u m m ə m u ɾ 'a ð ə 
batall	b ə t 'a ʎ	 b ə t 'a ʎ 
girant	ʒ i ɾ 'a n	 ʒ i ɾ 'a n 
aïllat	ə i ʎ 'a t	 ə i ʎ 'a t 
banda	b 'a n d ə	 b 'a n d ə 
esforçada	ə s f u r s 'a ð ə	 ə s f u r s 'a ð ə 
barons	b ə ɾ 'o n s	 b ə ɾ 'o n s 
fragatí	f ɾ ə ɣ ə t 'i	 f ɾ ə ɣ ə t 'i 
d'estil	d ə s t 'i l	 d ə s t 'i l 
cuirassat	k u j ɾ ə s 'a t	 k u j ɾ ə s 'a t 
Dimissió	d i m i s i 'o	 d i m i s i 'o 
tranquilitzar	t ɾ ə ŋ k i l i d z 'a	 t ɾ ə ŋ k i l i d z 'a 
bitxac	b i t ʃ 'a k	 b i t ʃ 'a k 
estressada	ə s t ɾ ə s 'a ð ə	 ə s t ɾ ə s 'a ð ə 
bequis	b 'ɛ k i s	 b 'ɛ k i s 
vibrades	b i β ɾ 'a ð ə s	 b i β ɾ 'a ð ə s 
aconseguides	ə k u n s ə ɣ 'i ð ə s	 ə k u n s ə ɣ 'i ð ə s 
bast	b 'a s t	 b 'a s t 
revolució	r ə β u l u s i 'o	 r ə β u l u s i 'o 
accentuar	ə k s ə n t u 'a	 ə k s ə n t u 'a 
convida	k u m b 'i ð ə	 k u m b 'i ð ə 
fabulós	f ə β u l 'o s	 f ə β u l 'o s 
despertats	d ə s p ə r t 'a t s	 d ə s p ə r t 'a t s 
comtats	k u m t 'a t s	 k u m t 'a t s 
estada	ə s t 'a ð ə	 ə s t 'a ð ə 
invertebrats	i m b ə r t ə β ɾ 'a t s	 i m b ə r t ə β ɾ 'a t s 
mà	m 'a	 m 'a 
televisiu	t ə l ə β i z 'i w	 t ə l ə β i z 'i w 
fredejat	f ɾ ə ð ə ʒ 'a t	 f ɾ ə ð ə ʒ 'a t 
burocràcia	b u ɾ u k ɾ 'a s i ə	 b u ɾ u k ɾ 'a s i ə 
vector	b ə k t 'o	 b ə k t 'o 
bosseta	b u s 'ɛ t ə	 b u s 'ɛ t ə 
baixos	b 'a ʃ u s	 b 'a ʃ u s 
Nissaga	n i s 'a ɣ ə	 n i s 'a ɣ ə 
diversió	d i β ə r s i 'o	 d i β ə r s i 'o 
desglossa	d ə z ɣ l 'ɔ s ə	 d ə z ɣ l 'ɔ s ə 
ceràmic	s ə ɾ 'a m i k	 s ə ɾ 'a m i k 
aprimats	ə p ɾ i m 'a t s	 ə p ɾ i m 'a t s 
marines	m ə ɾ 'i n ə s	 m ə ɾ 'i n ə s 
motí	m u t 'i	 m u t 'i 
Farners	f ə r n 'e s	 f ə r n 'e s 
arilè	ə ɾ i l 'ɛ	 ə ɾ i l 'ɛ 
l'envoltava	l ə m b u l t 'a β ə	 l ə m b u l t 'a β ə 
apedregades	ə p ə ð ɾ ə ɣ 'a ð ə s	 ə p ə ð ɾ ə ɣ 'a ð ə s 
ajornant	ə ʒ u r n 'a n	 ə ʒ u r n 'a n 
dinamitats	d i n ə m i t 'a t s	 d i n ə m i t 'a t s 
caricatures	k ə ɾ i k ə t 'u ɾ ə s	 k ə ɾ i k ə t 'u ɾ ə s 
parlaire	p ə r l 'a j ɾ ə	 p ə r l 'a j ɾ ə 
vegem	b ə ʒ 'ɛ m	 b ə ʒ 'ɛ m 
ratxós	r ə t ʃ 'o s	 r ə t ʃ 'o s 
quinzena	k i n z 'ɛ n ə	 k i n z 'ɛ n ə 
visqui	b 'i s k i	 b 'i s k i 
patiràs	p ə t i ɾ 'a s	 p ə t i ɾ 'a s 
estellador	ə s t ə ʎ ə ð 'o	 ə s t ə ʎ ə ð 'o 
atacs	ə t 'a k s	 ə t 'a k s 
moralitat	m u ɾ ə l i t 'a t	 m u ɾ ə l i t 'a t 
asseguda	ə s ə ɣ 'u ð ə	 ə s ə ɣ 'u ð ə 
dirimia	d i ɾ i m 'i ə	 d i ɾ i m 'i ə 
flotilla	f l u t 'i ʎ ə	 f l u t 'i ʎ ə 
noces	n 'ɔ s ə s	 n 'ɔ s ə s 
bel	b 'ɛ l	 b 'ɛ l 
Digues	d 'i ɣ ə s	 d 'i ɣ ə s 
acabàreu	ə k ə β 'a ɾ ə w	 ə k ə β 'a ɾ ə w 
quota	k w 'ɔ t ə	 k w 'ɔ t ə 
vidus	b 'i ð u s	 b 'i ð u s 
manetes	m ə n 'ɛ t ə s	 m ə n 'ɛ t ə s 
panícula	p ə n 'i k u l ə	 p ə n 'i k u l ə 
companyó	k u m p ə ɲ 'o	 k u m p ə ɲ 'o 
àrid	'a ɾ i t	 'a ɾ i t 
casteller	k ə s t ə ʎ 'e	 k ə s t ə ʎ 'e 
centra	s 'e n t ɾ ə	 s 'e n t ɾ ə 
refetor	r ə f ə t 'o	 r ə f ə t 'o 
mirall	m i ɾ 'a ʎ	 m i ɾ 'a ʎ 
capida	k ə p 'i ð ə	 k ə p 'i ð ə 
l'extensió	l ə k s t ə n s i 'o	 l ə k s t ə n s i 'o 
seleccionat	s ə l ə k s i u n 'a t	 s ə l ə k s i u n 'a t 
Àvila	'a β i l ə	 'a β i l ə 
baf	b 'a f	 b 'a f 
armisticis	ə r m i s t 'i s i s	 ə r m i s t 'i s i s 
ravenissa	r ə β ə n 'i s ə	 r ə β ə n 'i s ə 
agressivitat	ə ɣ ɾ ə s i β i t 'a t	 ə ɣ ɾ ə s i β i t 'a t 
apologitzat	ə p u l u ʒ i d z 'a t	 ə p u l u ʒ i d z 'a t 
digestiu	d i ʒ ə s t 'i w	 d i ʒ ə s t 'i w 
disculpats	d i s k u l p 'a t s	 d i s k u l p 'a t s 
verinós	b ə ɾ i n 'o s	 b ə ɾ i n 'o s 
beina	b 'ɛ j n ə	 b 'ɛ j n ə 
olímpica	u l 'i m p i k ə	 u l 'i m p i k ə 
exagerades	ə g z ə ʒ ə ɾ 'a ð ə s	 ə g z ə ʒ ə ɾ 'a ð ə s 
rebregar	r ə β ɾ ə ɣ 'a	 r ə β ɾ ə ɣ 'a 
trencar	t ɾ ə ŋ k 'a	 t ɾ ə ŋ k 'a 
distribuïda	d i s t ɾ i β u 'i ð ə	 d i s t ɾ i β u 'i ð ə 
instaurats	i n s t ə w ɾ 'a t s	 i n s t ə w ɾ 'a t s 
bacallà	b ə k ə ʎ 'a	 b ə k ə ʎ 'a 
entraríem	ə n t ɾ ə ɾ 'i ə m	 ə n t ɾ ə ɾ 'i ə m 
miop	m i 'ɔ p	 m i 'ɔ p 
llampar	ʎ ə m p 'a	 ʎ ə m p 'a 
macerades	m ə s ə ɾ 'a ð ə s	 m ə s ə ɾ 'a ð ə s 
Mòdena	m 'ɔ ð ə n ə	 m 'ɔ ð ə n ə 
L'art	l 'a r t	 l 'a r t 
aclucat	ə k l u k 'a t	 ə k l u k 'a t 
bufera	b u f 'e ɾ ə	 b u f 'e ɾ ə 
certificats	s ə r t i f i k 'a t s	 s ə r t i f i k 'a t s 
onsevulga	u n s ə β 'u l ɣ ə	 u n s ə β 'u l ɣ ə 
llinya	ʎ 'i ɲ ə	 ʎ 'i ɲ ə 
Entitat	ə n t i t 'a t	 ə n t i t 'a t 
unànimes	u n 'a n i m ə s	 u n 'a n i m ə s 
tossa	t 'ɔ s ə	 t 'ɔ s ə 
crustaci	k ɾ u s t 'a s i	 k ɾ u s t 'a s i 
descarregable	d ə s k ə r ə ɣ 'a b b l ə	 d ə s k ə r ə ɣ 'a b b l ə 
afligir	ə f l i ʒ 'i	 ə f l i ʒ 'i 
condicionats	k u n d i s i u n 'a t s	 k u n d i s i u n 'a t s 
fita	f 'i t ə	 f 'i t ə 
fantàstica	f ə n t 'a s t i k ə	 f ə n t 'a s t i k ə 
quantitatius	k w ə n t i t ə t 'i w s	 k w ə n t i t ə t 'i w s 
fantasiades	f ə n t ə z i 'a ð ə s	 f ə n t ə z i 'a ð ə s 
negació	n ə ɣ ə s i 'o	 n ə ɣ ə s i 'o 
llorigó	ʎ u ɾ i ɣ 'o	 ʎ u ɾ i ɣ 'o 
qüestió	k w ə s t i 'o	 k w ə s t i 'o 
tovalles	t u β 'a ʎ ə s	 t u β 'a ʎ ə s 
permet	p ə r m 'ɛ t	 p ə r m 'ɛ t 
Teresa	t ə ɾ 'ɛ z ə	 t ə ɾ 'ɛ z ə 
extingir	ə k s t i n ʒ 'i	 ə k s t i n ʒ 'i 
cadires	k ə ð 'i ɾ ə s	 k ə ð 'i ɾ ə s 
natura	n ə t 'u ɾ ə	 n ə t 'u ɾ ə 
mascle	m 'a s k l ə	 m 'a s k l ə 
refer	r ə f 'e	 r ə f 'e 
nidificació	n i ð i f i k ə s i 'o	 n i ð i f i k ə s i 'o 
exceptuar	ə k s ə p t u 'a	 ə k s ə p t u 'a 
terciaris	t ə r s i 'a ɾ i s	 t ə r s i 'a ɾ i s 
suspicaç	s u s p i k 'a s	 s u s p i k 'a s 
trèvols	t ɾ 'ɛ β u l s	 t ɾ 'ɛ β u l s 
t'havia	t ə β 'i ə	 t ə β 'i ə 
camí	k ə m 'i	 k ə m 'i 
polonès	p u l u n 'ɛ s	 p u l u n 'ɛ s 
astronòmic	ə s t ɾ u n 'ɔ m i k	 ə s t ɾ u n 'ɔ m i k 
elegits	ə l ə ʒ 'i t s	 ə l ə ʒ 'i t s 
balbuç	b ə l β 'u s	 b ə l β 'u s 
covard	k u β 'a r t	 k u β 'a r t 
s'elabora	s ə l ə β 'o ɾ ə	 s ə l ə β 'o ɾ ə 
feina	f 'ɛ j n ə	 f 'ɛ j n ə 
alegrar	ə l ə ɣ ɾ 'a	 ə l ə ɣ ɾ 'a 
mortalitat	m u r t ə l i t 'a t	 m u r t ə l i t 'a t 
dictadura	d i k t ə ð 'u ɾ ə	 d i k t ə ð 'u ɾ ə 
esquitxen	ə s k 'i t ʃ ə n	 ə s k 'i t ʃ ə n 
bocudes	b u k 'u ð ə s	 b u k 'u ð ə s 
Ewing	ə β 'i ŋ	 ə β 'i ŋ 
boxin	b 'ɔ k s i n	 b 'ɔ k s i n 
federal	f ə ð ə ɾ 'a l	 f ə ð ə ɾ 'a l 
logístiques	l u ʒ 'i s t i k ə s	 l u ʒ 'i s t i k ə s 
cadenats	k ə ð ə n 'a t s	 k ə ð ə n 'a t s 
vedàreu	b ə ð 'a ɾ ə w	 b ə ð 'a ɾ ə w 
aplegats	ə p l ə ɣ 'a t s	 ə p l ə ɣ 'a t s 
denunciada	d ə n u n s i 'a ð ə	 d ə n u n s i 'a ð ə 
baixant	b ə ʃ 'a n	 b ə ʃ 'a n 
Piles	p 'i l ə s	 p 'i l ə s 
faldilla	f ə l d 'i ʎ ə	 f ə l d 'i ʎ ə 
complementada	k u m p l ə m ə n t 'a ð ə	 k u m p l ə m ə n t 'a ð ə 
cançons	k ə n s 'o n s	 k ə n s 'o n s 
Perramon	p ə r ə m 'o n	 p ə r ə m 'o n 
superposat	s u p ə r p u z 'a t	 s u p ə r p u z 'a t 
apunyalat	ə p u ɲ ə l 'a t	 ə p u ɲ ə l 'a t 
aprenentatges	ə p ɾ ə n ə n t 'a d ʒ ə s	 ə p ɾ ə n ə n t 'a d ʒ ə s 
impetrada	i m p ə t ɾ 'a ð ə	 i m p ə t ɾ 'a ð ə 
coixejar	k u ʃ ə ʒ 'a	 k u ʃ ə ʒ 'a 
dau	d 'a w	 d 'a w 
diferencien	d i f ə ɾ ə n s 'i ə n	 d i f ə ɾ ə n s 'i ə n 
socials	s u s i 'a l s	 s u s i 'a l s 
essencials	ə s ə n s i 'a l s	 ə s ə n s i 'a l s 
despentinat	d ə s p ə n t i n 'a t	 d ə s p ə n t i n 'a t 
acceptable	ə k s ə p t 'a b b l ə	 ə k s ə p t 'a b b l ə 
neolítiques	n ə u l 'i t i k ə s	 n ə u l 'i t i k ə s 
descartar	d ə s k ə r t 'a	 d ə s k ə r t 'a 
Inscripció	i n s k ɾ i p s i 'o	 i n s k ɾ i p s i 'o 
tributari	t ɾ i β u t 'a ɾ i	 t ɾ i β u t 'a ɾ i 
crocus	k ɾ 'ɔ k u s	 k ɾ 'ɔ k u s 
idèntic	i ð 'ɛ n t i k	 i ð 'ɛ n t i k 
interaccionat	i n t ə ɾ ə k s i u n 'a t	 i n t ə ɾ ə k s i u n 'a t 
idolatraven	i ð u l ə t ɾ 'a β ə n	 i ð u l ə t ɾ 'a β ə n 
Líban	l 'i β ə n	 l 'i β ə n 
l'homenatge	l u m ə n 'a d ʒ ə	 l u m ə n 'a d ʒ ə 
fracturat	f ɾ ə k t u ɾ 'a t	 f ɾ ə k t u ɾ 'a t 
tridimensional	t ɾ i ð i m ə n s i u n 'a l	 t ɾ i ð i m ə n s i u n 'a l 
internades	i n t ə r n 'a ð ə s	 i n t ə r n 'a ð ə s 
roden	r 'ɔ ð ə n	 r 'ɔ ð ə n 
L'entrevista	l ə n t ɾ ə β 'i s t ə	 l ə n t ɾ ə β 'i s t ə 
radi	r 'a ð i	 r 'a ð i 
agrada	ə ɣ ɾ 'a ð ə	 ə ɣ ɾ 'a ð ə 
arizotònic	ə ɾ i z u t 'ɔ n i k	 ə ɾ i z u t 'ɔ n i k 
ruble	r 'u b b l ə	 r 'u b b l ə 
retall	r ə t 'a ʎ	 r ə t 'a ʎ 
analfabeta	ə n ə l f ə β 'ɛ t ə	 ə n ə l f ə β 'ɛ t ə 
l'obra	l 'ɔ β ɾ ə	 l 'ɔ β ɾ ə 
Cambrils	k ə m b ɾ 'i l s	 k ə m b ɾ 'i l s 
dreço	d ɾ 'ɛ s u	 d ɾ 'ɛ s u 
corregir	k u r ə ʒ 'i	 k u r ə ʒ 'i 
patrocino	p ə t ɾ u s 'i n u	 p ə t ɾ u s 'i n u 
parés	p ə ɾ 'e s	 p ə ɾ 'e s 
subestimin	s u p ə s t 'i m i n	 s u p ə s t 'i m i n 
classificació	k l ə s i f i k ə s i 'o	 k l ə s i f i k ə s i 'o 
llàgrimes	ʎ 'a ɣ ɾ i m ə s	 ʎ 'a ɣ ɾ i m ə s 
mogudes	m u ɣ 'u ð ə s	 m u ɣ 'u ð ə s 
bascs	b 'a s k s	 b 'a s k s 
desafectat	d ə z ə f ə k t 'a t	 d ə z ə f ə k t 'a t 
voladís	b u l ə ð 'i s	 b u l ə ð 'i s 
renyes	r 'ɛ ɲ ə s	 r 'ɛ ɲ ə s 
fricció	f ɾ i k s i 'o	 f ɾ i k s i 'o 
centrals	s ə n t ɾ 'a l s	 s ə n t ɾ 'a l s 
intensa	i n t 'ɛ n s ə	 i n t 'ɛ n s ə 
disculpat	d i s k u l p 'a t	 d i s k u l p 'a t 
reemplaçades	r e ə m p l ə s 'a ð ə s	 r e ə m p l ə s 'a ð ə s 
reunificació	r ə u n i f i k ə s i 'o	 r ə u n i f i k ə s i 'o 
natives	n ə t 'i β ə s	 n ə t 'i β ə s 
funcionar	f u n s i u n 'a	 f u n s i u n 'a 
crostó	k ɾ u s t 'o	 k ɾ u s t 'o 
empresarial	ə m p ɾ ə z ə ɾ i 'a l	 ə m p ɾ ə z ə ɾ i 'a l 
fonamentalisme	f u n ə m ə n t ə l 'i z m ə	 f u n ə m ə n t ə l 'i z m ə 
calculava	k ə l k u l 'a β ə	 k ə l k u l 'a β ə 
sisó	s i z 'o	 s i z 'o 
conspirat	k u n s p i ɾ 'a t	 k u n s p i ɾ 'a t 
emmurallats	ə m m u ɾ ə ʎ 'a t s	 ə m m u ɾ ə ʎ 'a t s 
voluntaris	b u l u n t 'a ɾ i s	 b u l u n t 'a ɾ i s 
mèdica	m 'ɛ ð i k ə	 m 'ɛ ð i k ə 
xacra	ʃ 'a k ɾ ə	 ʃ 'a k ɾ ə 
peresa	p ə ɾ 'ɛ z ə	 p ə ɾ 'ɛ z ə 
compartida	k u m p ə r t 'i ð ə	 k u m p ə r t 'i ð ə 
instaurades	i n s t ə w ɾ 'a ð ə s	 i n s t ə w ɾ 'a ð ə s 
axó	ə k s 'o	 ə k s 'o 
corista	k u ɾ 'i s t ə	 k u ɾ 'i s t ə 
Zamora	z ə m 'o ɾ ə	 z ə m 'o ɾ ə 
tudó	t u ð 'o	 t u ð 'o 
noves	n 'ɔ β ə s	 n 'ɔ β ə s 
successives	s u k s ə s 'i β ə s	 s u k s ə s 'i β ə s 
sudanesos	s u ð ə n 'ɛ z u s	 s u ð ə n 'ɛ z u s 
eructar	ə ɾ u k t 'a	 ə ɾ u k t 'a 
tragèdia	t ɾ ə ʒ 'ɛ ð i ə	 t ɾ ə ʒ 'ɛ ð i ə 
classe	k l 'a s ə	 k l 'a s ə 
compensats	k u m p ə n s 'a t s	 k u m p ə n s 'a t s 
localitzat	l u k ə l i d z 'a t	 l u k ə l i d z 'a t 
dolgui	d 'ɔ l ɣ i	 d 'ɔ l ɣ i 
octà	u k t 'a	 u k t 'a 
ululada	u l u l 'a ð ə	 u l u l 'a ð ə 
amansida	ə m ə n s 'i ð ə	 ə m ə n s 'i ð ə 
necrosi	n ə k ɾ 'ɔ z i	 n ə k ɾ 'ɔ z i 
acidosi	ə s i ð 'ɔ z i	 ə s i ð 'ɔ z i 
artiga	ə r t 'i ɣ ə	 ə r t 'i ɣ ə 
quòniam	k w 'ɔ n i ə m	 k w 'ɔ n i ə m 
anciana	ə n s i 'a n ə	 ə n s i 'a n ə 
autòcton	ə w t 'ɔ k t u n	 ə w t 'ɔ k t u n 
cobria	k u β ɾ 'i ə	 k u β ɾ 'i ə 
escalfa	ə s k 'a l f ə	 ə s k 'a l f ə 
provin	p ɾ 'ɔ β i n	 p ɾ 'ɔ β i n 
comprès	k u m p ɾ 'ɛ s	 k u m p ɾ 'ɛ s 
cadenes	k ə ð 'ɛ n ə s	 k ə ð 'ɛ n ə s 
nits	n 'i t s	 n 'i t s 
imparcialitat	i m p ə r s i ə l i t 'a t	 i m p ə r s i ə l i t 'a t 
quitó	k i t 'o	 k i t 'o 
intrafamiliar	i n t ɾ ə f ə m i l i 'a	 i n t ɾ ə f ə m i l i 'a 
osquen	'ɔ s k ə n	 'ɔ s k ə n 
simplificares	s i m p l i f i k 'a ɾ ə s	 s i m p l i f i k 'a ɾ ə s 
sotal	s u t 'a l	 s u t 'a l 
subministrar	s u b m i n i s t ɾ 'a	 s u b m i n i s t ɾ 'a 
Serra	s 'ɛ r ə	 s 'ɛ r ə 
vulcanòlogues	b u l k ə n 'ɔ l u ɣ ə s	 b u l k ə n 'ɔ l u ɣ ə s 
fundats	f u n d 'a t s	 f u n d 'a t s 
consagrades	k u n s ə ɣ ɾ 'a ð ə s	 k u n s ə ɣ ɾ 'a ð ə s 
invertit	i m b ə r t 'i t	 i m b ə r t 'i t 
mobiliari	m u β i l i 'a ɾ i	 m u β i l i 'a ɾ i 
polaritzades	p u l ə ɾ i d z 'a ð ə s	 p u l ə ɾ i d z 'a ð ə s 
sàtrapa	s 'a t ɾ ə p ə	 s 'a t ɾ ə p ə 
solleric	s u ʎ ə ɾ 'i k	 s u ʎ ə ɾ 'i k 
encapçalar	ə ŋ k ə p s ə l 'a	 ə ŋ k ə p s ə l 'a 
diminuta	d i m i n 'u t ə	 d i m i n 'u t ə 
sal	s 'a l	 s 'a l 
senyors	s ə ɲ 'o s	 s ə ɲ 'o s 
crisantem	k ɾ i z ə n t 'ɛ m	 k ɾ i z ə n t 'ɛ m 
curable	k u ɾ 'a b b l ə	 k u ɾ 'a b b l ə 
antibacterianes	ə n t i β ə k t ə ɾ i 'a n ə s	 ə n t i β ə k t ə ɾ i 'a n ə s 
estiuada	ə s t i w 'a ð ə	 ə s t i w 'a ð ə 
mena	m 'ɛ n ə	 m 'ɛ n ə 
visible	b i z 'i b b l ə	 b i z 'i b b l ə 
catalanades	k ə t ə l ə n 'a ð ə s	 k ə t ə l ə n 'a ð ə s 
fertilització	f ə r t i l i d z ə s i 'o	 f ə r t i l i d z ə s i 'o 
encoratjades	ə ŋ k u ɾ ə d ʒ 'a ð ə s	 ə ŋ k u ɾ ə d ʒ 'a ð ə s 
farratge	f ə r 'a d ʒ ə	 f ə r 'a d ʒ ə 
ceretà	s ə ɾ ə t 'a	 s ə ɾ ə t 'a 
restoblar	r ə s t u b b l 'a	 r ə s t u b b l 'a 
Sap	s 'a p	 s 'a p 
ressaltades	r ə s ə l t 'a ð ə s	 r ə s ə l t 'a ð ə s 
desnerit	d ə z n ə ɾ 'i t	 d ə z n ə ɾ 'i t 
cloïssa	k l u 'i s ə	 k l u 'i s ə 
explorar	ə k s p l u ɾ 'a	 ə k s p l u ɾ 'a 
beneficiosa	b ə n ə f i s i 'o z ə	 b ə n ə f i s i 'o z ə 
desallotjat	d ə z ə ʎ u d ʒ 'a t	 d ə z ə ʎ u d ʒ 'a t 
insurreccionar	i n s u r ə k s i u n 'a	 i n s u r ə k s i u n 'a 
italiana	i t ə l i 'a n ə	 i t ə l i 'a n ə 
toques	t 'ɔ k ə s	 t 'ɔ k ə s 
plegà	p l ə ɣ 'a	 p l ə ɣ 'a 
laïcitzar	l ə i s i d z 'a	 l ə i s i d z 'a 
respiració	r ə s p i ɾ ə s i 'o	 r ə s p i ɾ ə s i 'o 
hiperactiva	i p ə ɾ ə k t 'i β ə	 i p ə ɾ ə k t 'i β ə 
pilota	p i l 'ɔ t ə	 p i l 'ɔ t ə 
dugués	d u ɣ 'e s	 d u ɣ 'e s 
erodit	ə ɾ u ð 'i t	 ə ɾ u ð 'i t 
encadellar	ə ŋ k ə ð ə ʎ 'a	 ə ŋ k ə ð ə ʎ 'a 
casals	k ə z 'a l s	 k ə z 'a l s 
dos	d 'o s	 d 'o s 
proliferació	p ɾ u l i f ə ɾ ə s i 'o	 p ɾ u l i f ə ɾ ə s i 'o 
comprar	k u m p ɾ 'a	 k u m p ɾ 'a 
escapes	ə s k 'a p ə s	 ə s k 'a p ə s 
etimologista	ə t i m u l u ʒ 'i s t ə	 ə t i m u l u ʒ 'i s t ə 
transferència	t ɾ ə n s f ə ɾ 'ɛ n s i ə	 t ɾ ə n s f ə ɾ 'ɛ n s i ə 
sobrassada	s u β ɾ ə s 'a ð ə	 s u β ɾ ə s 'a ð ə 
conversades	k u m b ə r s 'a ð ə s	 k u m b ə r s 'a ð ə s 
amagar	ə m ə ɣ 'a	 ə m ə ɣ 'a 
Finlàndia	f i n l 'a n d i ə	 f i n l 'a n d i ə 
conspirar	k u n s p i ɾ 'a	 k u n s p i ɾ 'a 
molèsties	m u l 'ɛ s t i ə s	 m u l 'ɛ s t i ə s 
motllura	m u ʎ ʎ 'u ɾ ə	 m u ʎ ʎ 'u ɾ ə 
venós	b ə n 'o s	 b ə n 'o s 
pròsper	p ɾ 'ɔ s p ə r	 p ɾ 'ɔ s p ə r 
metastatitzat	m ə t ə s t ə t i d z 'a t	 m ə t ə s t ə t i d z 'a t 
allunyats	ə ʎ u ɲ 'a t s	 ə ʎ u ɲ 'a t s 
hiperònims	i p ə ɾ 'ɔ n i m s	 i p ə ɾ 'ɔ n i m s 
dopar	d u p 'a	 d u p 'a 
Barceloneta	b ə r s ə l u n 'ɛ t ə	 b ə r s ə l u n 'ɛ t ə 
subhastada	s u β ə s t 'a ð ə	 s u β ə s t 'a ð ə 
identificació	i ð ə n t i f i k ə s i 'o	 i ð ə n t i f i k ə s i 'o 
afegir	ə f ə ʒ 'i	 ə f ə ʒ 'i 
animalons	ə n i m ə l 'o n s	 ə n i m ə l 'o n s 
otoscòpies	u t u s k 'ɔ p i ə s	 u t u s k 'ɔ p i ə s 
ecològica	ə k u l 'ɔ ʒ i k ə	 ə k u l 'ɔ ʒ i k ə 
esponjats	ə s p u n ʒ 'a t s	 ə s p u n ʒ 'a t s 
Films	f 'i l m s	 f 'i l m s 
tebana	t ə β 'a n ə	 t ə β 'a n ə 
acurades	ə k u ɾ 'a ð ə s	 ə k u ɾ 'a ð ə s 
nòvia	n 'ɔ β i ə	 n 'ɔ β i ə 
vesper	b ə s p 'e	 b ə s p 'e 
coincidia	k u i n s i ð 'i ə	 k u i n s i ð 'i ə 
acaronar	ə k ə ɾ u n 'a	 ə k ə ɾ u n 'a 
liti	l 'i t i	 l 'i t i 
romàntiques	r u m 'a n t i k ə s	 r u m 'a n t i k ə s 
regional	r ə ʒ i u n 'a l	 r ə ʒ i u n 'a l 
regies	r ə ʒ 'i ə s	 r ə ʒ 'i ə s 
cabàs	k ə β 'a s	 k ə β 'a s 
subornàveu	s u β u r n 'a β ə w	 s u β u r n 'a β ə w 
mesurat	m ə z u ɾ 'a t	 m ə z u ɾ 'a t 
elegíaques	ə l ə ʒ 'i ə k ə s	 ə l ə ʒ 'i ə k ə s 
escopinada	ə s k u p i n 'a ð ə	 ə s k u p i n 'a ð ə 
alburn	ə l β 'u r n	 ə l β 'u r n 
restaurada	r ə s t ə w ɾ 'a ð ə	 r ə s t ə w ɾ 'a ð ə 
xerrac	ʃ ə r 'a k	 ʃ ə r 'a k 
perseverança	p ə r s ə β ə ɾ 'a n s ə	 p ə r s ə β ə ɾ 'a n s ə 
refon	r ə f 'o n	 r ə f 'o n 
considera	k u n s i ð 'e ɾ ə	 k u n s i ð 'e ɾ ə 
txeques	t ʃ 'ɛ k ə s	 t ʃ 'ɛ k ə s 
allisar	ə ʎ i z 'a	 ə ʎ i z 'a 
cat	k 'a t	 k 'a t 
femta	f 'ɛ m t ə	 f 'ɛ m t ə 
situar-nos	s i t u 'a r n u s	 s i t u 'a r n u s 
determino	d ə t ə r m 'i n u	 d ə t ə r m 'i n u 
metatarsianes	m ə t ə t ə r s i 'a n ə s	 m ə t ə t ə r s i 'a n ə s 
bandit	b ə n d 'i t	 b ə n d 'i t 
interromputs	i n t ə r u m p 'u t s	 i n t ə r u m p 'u t s 
herètic	ə ɾ 'ɛ t i k	 ə ɾ 'ɛ t i k 
s'adonà	s ə ð u n 'a	 s ə ð u n 'a 
escandalitzades	ə s k ə n d ə l i d z 'a ð ə s	 ə s k ə n d ə l i d z 'a ð ə s 
invocar	i m b u k 'a	 i m b u k 'a 
Cabrera	k ə β ɾ 'e ɾ ə	 k ə β ɾ 'e ɾ ə 
embarassar	ə m b ə ɾ ə s 'a	 ə m b ə ɾ ə s 'a 
recomanà	r ə k u m ə n 'a	 r ə k u m ə n 'a 
metafísica	m ə t ə f 'i z i k ə	 m ə t ə f 'i z i k ə 
fogonet	f u ɣ u n 'ɛ t	 f u ɣ u n 'ɛ t 
companyia	k u m p ə ɲ 'i ə	 k u m p ə ɲ 'i ə 
monoarticular	m u n u ə r t i k u l 'a	 m u n u ə r t i k u l 'a 
departament	d ə p ə r t ə m 'e n	 d ə p ə r t ə m 'e n 
gravació	g ɾ ə β ə s i 'o	 g ɾ ə β ə s i 'o 
lluir	ʎ u 'i	 ʎ u 'i 
Polònia	p u l 'ɔ n i ə	 p u l 'ɔ n i ə 
Fons	f 'o n s	 f 'o n s 
fisiòleg	f i z i 'ɔ l ə k	 f i z i 'ɔ l ə k 
olivaci	u l i β 'a s i	 u l i β 'a s i 
renyada	r ə ɲ 'a ð ə	 r ə ɲ 'a ð ə 
aiguat	ə j ɣ w 'a t	 ə j ɣ w 'a t 
escoltar	ə s k u l t 'a	 ə s k u l t 'a 
dominicà	d u m i n i k 'a	 d u m i n i k 'a 
busquen	b 'u s k ə n	 b 'u s k ə n 
aturar-se	ə t u ɾ 'a r s ə	 ə t u ɾ 'a r s ə 
distribuït	d i s t ɾ i β u 'i t	 d i s t ɾ i β u 'i t 
labiovelaritzats	l ə β i u β ə l ə ɾ i d z 'a t s	 l ə β i u β ə l ə ɾ i d z 'a t s 
esmorteïdes	ə z m u r t ə 'i ð ə s	 ə z m u r t ə 'i ð ə s 
subvertida	s u b b ə r t 'i ð ə	 s u b b ə r t 'i ð ə 
frisar	f ɾ i z 'a	 f ɾ i z 'a 
malapte	m ə l 'a p t ə	 m ə l 'a p t ə 
anivellada	ə n i β ə ʎ 'a ð ə	 ə n i β ə ʎ 'a ð ə 
atabalar	ə t ə β ə l 'a	 ə t ə β ə l 'a 
bloqui	b l 'ɔ k i	 b l 'ɔ k i 
movia	m u β 'i ə	 m u β 'i ə 
binaris	b i n 'a ɾ i s	 b i n 'a ɾ i s 
encallades	ə ŋ k ə ʎ 'a ð ə s	 ə ŋ k ə ʎ 'a ð ə s 
metzina	m ə d z 'i n ə	 m ə d z 'i n ə 
ovació	u β ə s i 'o	 u β ə s i 'o 
Robots	r u β 'ɔ t s	 r u β 'ɔ t s 
balbucejar	b ə l β u s ə ʒ 'a	 b ə l β u s ə ʒ 'a 
cove	k 'ɔ β ə	 k 'ɔ β ə 
casuística	k ə z u 'i s t i k ə	 k ə z u 'i s t i k ə 
oblidaria	u β l i ð ə ɾ 'i ə	 u β l i ð ə ɾ 'i ə 
transvasat	t ɾ ə n z β ə z 'a t	 t ɾ ə n z β ə z 'a t 
estabilitzades	ə s t ə β i l i d z 'a ð ə s	 ə s t ə β i l i d z 'a ð ə s 
separats	s ə p ə ɾ 'a t s	 s ə p ə ɾ 'a t s 
vinilidè	b i n i l i ð 'ɛ	 b i n i l i ð 'ɛ 
asfixiant	ə s f i k s i 'a n	 ə s f i k s i 'a n 
arquimesa	ə r k i m 'ɛ z ə	 ə r k i m 'ɛ z ə 
Serpentari	s ə r p ə n t 'a ɾ i	 s ə r p ə n t 'a ɾ i 
armadura	ə r m ə ð 'u ɾ ə	 ə r m ə ð 'u ɾ ə 
sedejar	s ə ð ə ʒ 'a	 s ə ð ə ʒ 'a 
conreats	k u n r e 'a t s	 k u n r e 'a t s 
sedentari	s ə ð ə n t 'a ɾ i	 s ə ð ə n t 'a ɾ i 
Ferrer	f ə r 'e	 f ə r 'e 
decideixo	d ə s i ð 'ɛ ʃ u	 d ə s i ð 'ɛ ʃ u 
lèxiques	l 'ɛ k s i k ə s	 l 'ɛ k s i k ə s 
despresos	d ə s p ɾ 'ɛ z u s	 d ə s p ɾ 'ɛ z u s 
entès	ə n t 'ɛ s	 ə n t 'ɛ s 
atrapat	ə t ɾ ə p 'a t	 ə t ɾ ə p 'a t 
renovable	r ə n u β 'a b b l ə	 r ə n u β 'a b b l ə 
conxorxa	k u n ʃ 'ɔ r ʃ ə	 k u n ʃ 'ɔ r ʃ ə 
identificades	i ð ə n t i f i k 'a ð ə s	 i ð ə n t i f i k 'a ð ə s 
néts	n 'e t s	 n 'e t s 
explotadors	ə k s p l u t ə ð 'o s	 ə k s p l u t ə ð 'o s 
esclatés	ə s k l ə t 'e s	 ə s k l ə t 'e s 
búdiques	b 'u ð i k ə s	 b 'u ð i k ə s 
calefacció	k ə l ə f ə k s i 'o	 k ə l ə f ə k s i 'o 
cumarina	k u m ə ɾ 'i n ə	 k u m ə ɾ 'i n ə 
assolellat	ə s u l ə ʎ 'a t	 ə s u l ə ʎ 'a t 
Guíxols	g 'i k s u l s	 g 'i k s u l s 
alienació	ə l i ə n ə s i 'o	 ə l i ə n ə s i 'o 
encarregada	ə ŋ k ə r ə ɣ 'a ð ə	 ə ŋ k ə r ə ɣ 'a ð ə 
d'execució	d ə g z ə k u s i 'o	 d ə g z ə k u s i 'o 
vidriola	b i ð ɾ i 'ɔ l ə	 b i ð ɾ i 'ɔ l ə 
bord	b 'o r t	 b 'o r t 
Regalimaven	r ə ɣ ə l i m 'a β ə n	 r ə ɣ ə l i m 'a β ə n 
competitivitats	k u m p ə t i t i β i t 'a t s	 k u m p ə t i t i β i t 'a t s 
repassant	r ə p ə s 'a n	 r ə p ə s 'a n 
xilòfon	ʃ i l 'ɔ f u n	 ʃ i l 'ɔ f u n 
panxa	p 'a n ʃ ə	 p 'a n ʃ ə 
Creació	k ɾ e ə s i 'o	 k ɾ e ə s i 'o 
aplicació	ə p l i k ə s i 'o	 ə p l i k ə s i 'o 
emprenyador	ə m p ɾ ə ɲ ə ð 'o	 ə m p ɾ ə ɲ ə ð 'o 
llampoina	ʎ ə m p 'ɔ j n ə	 ʎ ə m p 'ɔ j n ə 
legislat	l ə ʒ i z l 'a t	 l ə ʒ i z l 'a t 
virus	b 'i ɾ u s	 b 'i ɾ u s 
acollides	ə k u ʎ 'i ð ə s	 ə k u ʎ 'i ð ə s 
imprudència	i m p ɾ u ð 'ɛ n s i ə	 i m p ɾ u ð 'ɛ n s i ə 
artesà	ə r t ə z 'a	 ə r t ə z 'a 
simi	s 'i m i	 s 'i m i 
disset	d i s 'ɛ t	 d i s 'ɛ t 
reducció	r ə ð u k s i 'o	 r ə ð u k s i 'o 
malalt	m ə l 'a l	 m ə l 'a l 
marquesa	m ə r k 'ɛ z ə	 m ə r k 'ɛ z ə 
homofòbia	u m u f 'ɔ β i ə	 u m u f 'ɔ β i ə 
vuit	b 'u j t	 b 'u j t 
minusvàlid	m i n u z β 'a l i t	 m i n u z β 'a l i t 
reportada	r ə p u r t 'a ð ə	 r ə p u r t 'a ð ə 
frenis	f ɾ 'ɛ n i s	 f ɾ 'ɛ n i s 
operativa	u p ə ɾ ə t 'i β ə	 u p ə ɾ ə t 'i β ə 
optimitzar	u p t i m i d z 'a	 u p t i m i d z 'a 
frescor	f ɾ ə s k 'o	 f ɾ ə s k 'o 
diàspora	d i 'a s p u ɾ ə	 d i 'a s p u ɾ ə 
falsificar	f ə l s i f i k 'a	 f ə l s i f i k 'a 
existent	ə g z i s t 'e n	 ə g z i s t 'e n 
comportats	k u m p u r t 'a t s	 k u m p u r t 'a t s 
esportivitat	ə s p u r t i β i t 'a t	 ə s p u r t i β i t 'a t 
metamorfosis	m ə t ə m u r f 'ɔ z i s	 m ə t ə m u r f 'ɔ z i s 
L'estabilitat	l ə s t ə β i l i t 'a t	 l ə s t ə β i l i t 'a t 
sèrum	s 'ɛ ɾ u m	 s 'ɛ ɾ u m 
natural	n ə t u ɾ 'a l	 n ə t u ɾ 'a l 
oftalmològiques	u f t ə l m u l 'ɔ ʒ i k ə s	 u f t ə l m u l 'ɔ ʒ i k ə s 
espolsant	ə s p u l s 'a n	 ə s p u l s 'a n 
millorat	m i ʎ u ɾ 'a t	 m i ʎ u ɾ 'a t 
dominades	d u m i n 'a ð ə s	 d u m i n 'a ð ə s 
mortificades	m u r t i f i k 'a ð ə s	 m u r t i f i k 'a ð ə s 
solda	s 'ɔ l d ə	 s 'ɔ l d ə 
aflorava	ə f l u ɾ 'a β ə	 ə f l u ɾ 'a β ə 
tornaven	t u r n 'a β ə n	 t u r n 'a β ə n 
furat	f u ɾ 'a t	 f u ɾ 'a t 
Santer	s ə n t 'e	 s ə n t 'e 
despesos	d ə s p 'ɛ z u s	 d ə s p 'ɛ z u s 
Assís	ə s 'i s	 ə s 'i s 
explicar	ə k s p l i k 'a	 ə k s p l i k 'a 
esòfag	ə z 'ɔ f ə k	 ə z 'ɔ f ə k 
poblat	p u b b l 'a t	 p u b b l 'a t 
agençada	ə ʒ ə n s 'a ð ə	 ə ʒ ə n s 'a ð ə 
biològic	b i u l 'ɔ ʒ i k	 b i u l 'ɔ ʒ i k 
idolatrat	i ð u l ə t ɾ 'a t	 i ð u l ə t ɾ 'a t 
assassiní	ə s ə s i n 'i	 ə s ə s i n 'i 
batia	b ə t 'i ə	 b ə t 'i ə 
parasitades	p ə ɾ ə z i t 'a ð ə s	 p ə ɾ ə z i t 'a ð ə s 
malària	m ə l 'a ɾ i ə	 m ə l 'a ɾ i ə 
davantalada	d ə β ə n t ə l 'a ð ə	 d ə β ə n t ə l 'a ð ə 
analfabets	ə n ə l f ə β 'ɛ t s	 ə n ə l f ə β 'ɛ t s 
destructible	d ə s t ɾ u k t 'i b b l ə	 d ə s t ɾ u k t 'i b b l ə 
presumir	p ɾ ə z u m 'i	 p ɾ ə z u m 'i 
altaveu	ə l t ə β 'ɛ w	 ə l t ə β 'ɛ w 
endevinat	ə n d ə β i n 'a t	 ə n d ə β i n 'a t 
aqueus	ə k 'ɛ w s	 ə k 'ɛ w s 
arquitecte	ə r k i t 'ɛ k t ə	 ə r k i t 'ɛ k t ə 
bàlec	b 'a l ə k	 b 'a l ə k 
acabéssim	ə k ə β 'e s i m	 ə k ə β 'e s i m 
preventiu	p ɾ ə β ə n t 'i w	 p ɾ ə β ə n t 'i w 
dedins	d ə ð 'i n s	 d ə ð 'i n s 
molí	m u l 'i	 m u l 'i 
canines	k ə n 'i n ə s	 k ə n 'i n ə s 
menstruat	m ə n s t ɾ u 'a t	 m ə n s t ɾ u 'a t 
telescòpic	t ə l ə s k 'ɔ p i k	 t ə l ə s k 'ɔ p i k 
atrofies	ə t ɾ u f 'i ə s	 ə t ɾ u f 'i ə s 
carrutxes	k ə r 'u t ʃ ə s	 k ə r 'u t ʃ ə s 
embarcat	ə m b ə r k 'a t	 ə m b ə r k 'a t 
afectant	ə f ə k t 'a n	 ə f ə k t 'a n 
autogir	ə w t u ʒ 'i	 ə w t u ʒ 'i 
propers	p ɾ u p 'e s	 p ɾ u p 'e s 
afiliat	ə f i l i 'a t	 ə f i l i 'a t 
treball	t ɾ ə β 'a ʎ	 t ɾ ə β 'a ʎ 
rebotré	r ə β u t ɾ 'e	 r ə β u t ɾ 'e 
crusant	k ɾ u z 'a n	 k ɾ u z 'a n 
varicós	b ə ɾ i k 'o s	 b ə ɾ i k 'o s 
competició	k u m p ə t i s i 'o	 k u m p ə t i s i 'o 
repudiada	r ə p u ð i 'a ð ə	 r ə p u ð i 'a ð ə 
palet	p ə l 'ɛ t	 p ə l 'ɛ t 
Lliga	ʎ 'i ɣ ə	 ʎ 'i ɣ ə 
abdicaria	ə b d i k ə ɾ 'i ə	 ə b d i k ə ɾ 'i ə 
clip	k l 'i p	 k l 'i p 
rebregats	r ə β ɾ ə ɣ 'a t s	 r ə β ɾ ə ɣ 'a t s 
assentament	ə s ə n t ə m 'e n	 ə s ə n t ə m 'e n 
morrut	m u r 'u t	 m u r 'u t 
combatré	k u m b ə t ɾ 'e	 k u m b ə t ɾ 'e 
frau	f ɾ 'a w	 f ɾ 'a w 
estirar	ə s t i ɾ 'a	 ə s t i ɾ 'a 
lleuger	ʎ ə w ʒ 'e	 ʎ ə w ʒ 'e 
reixeta	r ə ʃ 'ɛ t ə	 r ə ʃ 'ɛ t ə 
L'avi	l 'a β i	 l 'a β i 
votades	b u t 'a ð ə s	 b u t 'a ð ə s 
tancat	t ə ŋ k 'a t	 t ə ŋ k 'a t 
etnologia	ə d n u l u ʒ 'i ə	 ə d n u l u ʒ 'i ə 
Montserrat	m u n s ə r 'a t	 m u n s ə r 'a t 
complement	k u m p l ə m 'e n	 k u m p l ə m 'e n 
civilitat	s i β i l i t 'a t	 s i β i l i t 'a t 
d'anècdotes	d ə n 'ɛ g d u t ə s	 d ə n 'ɛ g d u t ə s 
regata	r ə ɣ 'a t ə	 r ə ɣ 'a t ə 
espasmar	ə s p ə z m 'a	 ə s p ə z m 'a 
actes	'a k t ə s	 'a k t ə s 
boxats	b u k s 'a t s	 b u k s 'a t s 
jeguis	ʒ 'ɛ ɣ i s	 ʒ 'ɛ ɣ i s 
tantalitzat	t ə n t ə l i d z 'a t	 t ə n t ə l i d z 'a t 
posseït	p u s ə 'i t	 p u s ə 'i t 
socialitzar	s u s i ə l i d z 'a	 s u s i ə l i d z 'a 
alterat	ə l t ə ɾ 'a t	 ə l t ə ɾ 'a t 
demanades	d ə m ə n 'a ð ə s	 d ə m ə n 'a ð ə s 
contaràs	k u n t ə ɾ 'a s	 k u n t ə ɾ 'a s 
dimeritzat	d i m ə ɾ i d z 'a t	 d i m ə ɾ i d z 'a t 
preparar-me	p ɾ ə p ə ɾ 'a r m ə	 p ɾ ə p ə ɾ 'a r m ə 
frustrada	f ɾ u s t ɾ 'a ð ə	 f ɾ u s t ɾ 'a ð ə 
enterraria	ə n t ə r ə ɾ 'i ə	 ə n t ə r ə ɾ 'i ə 
lògiques	l 'ɔ ʒ i k ə s	 l 'ɔ ʒ i k ə s 
embalatge	ə m b ə l 'a d ʒ ə	 ə m b ə l 'a d ʒ ə 
sumaris	s u m 'a ɾ i s	 s u m 'a ɾ i s 
colònies	k u l 'ɔ n i ə s	 k u l 'ɔ n i ə s 
tribulat	t ɾ i β u l 'a t	 t ɾ i β u l 'a t 
compràvem	k u m p ɾ 'a β ə m	 k u m p ɾ 'a β ə m 
immortalitzat	i m m u r t ə l i d z 'a t	 i m m u r t ə l i d z 'a t 
elemental	ə l ə m ə n t 'a l	 ə l ə m ə n t 'a l 
sistèmiques	s i s t 'ɛ m i k ə s	 s i s t 'ɛ m i k ə s 
credibilitat	k ɾ ə ð i β i l i t 'a t	 k ɾ ə ð i β i l i t 'a t 
apartades	ə p ə r t 'a ð ə s	 ə p ə r t 'a ð ə s 
treballador	t ɾ ə β ə ʎ ə ð 'o	 t ɾ ə β ə ʎ ə ð 'o 
enrossit	ə n r u s 'i t	 ə n r u s 'i t 
l'ocasió	l u k ə z i 'o	 l u k ə z i 'o 
flascó	f l ə s k 'o	 f l ə s k 'o 
lactari	l ə k t 'a ɾ i	 l ə k t 'a ɾ i 
quinze	k 'i n z ə	 k 'i n z ə 
Escullen	ə s k 'u ʎ ə n	 ə s k 'u ʎ ə n 
encongir	ə ŋ k u n ʒ 'i	 ə ŋ k u n ʒ 'i 
despeses	d ə s p 'ɛ z ə s	 d ə s p 'ɛ z ə s 
plantats	p l ə n t 'a t s	 p l ə n t 'a t s 
escandinaus	ə s k ə n d i n 'a w s	 ə s k ə n d i n 'a w s 
evolucionar	ə β u l u s i u n 'a	 ə β u l u s i u n 'a 
sodomia	s u ð u m 'i ə	 s u ð u m 'i ə 
píxide	p 'i k s i ð ə	 p 'i k s i ð ə 
aviastre	ə β i 'a s t ɾ ə	 ə β i 'a s t ɾ ə 
Jaén	ʒ ə 'e n	 ʒ ə 'e n 
impartit	i m p ə r t 'i t	 i m p ə r t 'i t 
afectades	ə f ə k t 'a ð ə s	 ə f ə k t 'a ð ə s 
lleure	ʎ 'ɛ w ɾ ə	 ʎ 'ɛ w ɾ ə 
assemblat	ə s ə m b l 'a t	 ə s ə m b l 'a t 
baixada	b ə ʃ 'a ð ə	 b ə ʃ 'a ð ə 
Francesc	f ɾ ə n s 'ɛ s k	 f ɾ ə n s 'ɛ s k 
mullada	m u ʎ 'a ð ə	 m u ʎ 'a ð ə 
senyalada	s ə ɲ ə l 'a ð ə	 s ə ɲ ə l 'a ð ə 
albir	ə l β 'i	 ə l β 'i 
durada	d u ɾ 'a ð ə	 d u ɾ 'a ð ə 
impacient	i m p ə s i 'e n	 i m p ə s i 'e n 
cossos	k 'ɔ s u s	 k 'ɔ s u s 
ebenisteria	ə β ə n i s t ə ɾ 'i ə	 ə β ə n i s t ə ɾ 'i ə 
ligular	l i ɣ u l 'a	 l i ɣ u l 'a 
l'alçada	l ə l s 'a ð ə	 l ə l s 'a ð ə 
brossi	b ɾ 'ɔ s i	 b ɾ 'ɔ s i 
comuniquí	k u m u n i k 'i	 k u m u n i k 'i 
greixós	g ɾ ə ʃ 'o s	 g ɾ ə ʃ 'o s 
andorrans	ə n d u r 'a n s	 ə n d u r 'a n s 
marabú	m ə ɾ ə β 'u	 m ə ɾ ə β 'u 
encarrilar	ə ŋ k ə r i l 'a	 ə ŋ k ə r i l 'a 
visibilitat	b i z i β i l i t 'a t	 b i z i β i l i t 'a t 
respiració	r ə s p i ɾ ə s i 'o	 r ə s p i ɾ ə s i 'o 
nombrosos	n u m b ɾ 'o z u s	 n u m b ɾ 'o z u s 
impedí	i m p ə ð 'i	 i m p ə ð 'i 
d'admiració	d ə d m i ɾ ə s i 'o	 d ə d m i ɾ ə s i 'o 
arrapant	ə r ə p 'a n	 ə r ə p 'a n 
l'òpera	l 'ɔ p ə ɾ ə	 l 'ɔ p ə ɾ ə 
hipocorística	i p u k u ɾ 'i s t i k ə	 i p u k u ɾ 'i s t i k ə 
Estic	ə s t 'i k	 ə s t 'i k 
esfondrament	ə s f u n d ɾ ə m 'e n	 ə s f u n d ɾ ə m 'e n 
pixa	p 'i ʃ ə	 p 'i ʃ ə 
extrapolat	ə k s t ɾ ə p u l 'a t	 ə k s t ɾ ə p u l 'a t 
manades	m ə n 'a ð ə s	 m ə n 'a ð ə s 
lloc	ʎ 'ɔ k	 ʎ 'ɔ k 
empresarial	ə m p ɾ ə z ə ɾ i 'a l	 ə m p ɾ ə z ə ɾ i 'a l 
orientat	u ɾ i ə n t 'a t	 u ɾ i ə n t 'a t 
conreada	k u n r e 'a ð ə	 k u n r e 'a ð ə 
rodolades	r u ð u l 'a ð ə s	 r u ð u l 'a ð ə s 
fàrmac	f 'a r m ə k	 f 'a r m ə k 
untet	u n t 'ɛ t	 u n t 'ɛ t 
commoure	k u m m 'ɔ w ɾ ə	 k u m m 'ɔ w ɾ ə 
trametre	t ɾ ə m 'ɛ t ɾ ə	 t ɾ ə m 'ɛ t ɾ ə 
asteques	ə s t 'ɛ k ə s	 ə s t 'ɛ k ə s 
simplificats	s i m p l i f i k 'a t s	 s i m p l i f i k 'a t s 
aquaris	ə k w 'a ɾ i s	 ə k w 'a ɾ i s 
faltada	f ə l t 'a ð ə	 f ə l t 'a ð ə 
atrèsia	ə t ɾ 'ɛ z i ə	 ə t ɾ 'ɛ z i ə 
opacitat	u p ə s i t 'a t	 u p ə s i t 'a t 
trampolí	t ɾ ə m p u l 'i	 t ɾ ə m p u l 'i 
pleguis	p l 'ɛ ɣ i s	 p l 'ɛ ɣ i s 
permesa	p ə r m 'ɛ z ə	 p ə r m 'ɛ z ə 
rebombori	r ə β u m b 'ɔ ɾ i	 r ə β u m b 'ɔ ɾ i 
Llíria	ʎ 'i ɾ i ə	 ʎ 'i ɾ i ə 
reivindicada	r ə i β i n d i k 'a ð ə	 r ə i β i n d i k 'a ð ə 
predominada	p ɾ ə ð u m i n 'a ð ə	 p ɾ ə ð u m i n 'a ð ə 
ambientats	ə m b i ə n t 'a t s	 ə m b i ə n t 'a t s 
arna	'a r n ə	 'a r n ə 
apuntar-se	ə p u n t 'a r s ə	 ə p u n t 'a r s ə 
Unitat	u n i t 'a t	 u n i t 'a t 
emasculades	ə m ə s k u l 'a ð ə s	 ə m ə s k u l 'a ð ə s 
foia	f 'ɔ j ə	 f 'ɔ j ə 
antropològiques	ə n t ɾ u p u l 'ɔ ʒ i k ə s	 ə n t ɾ u p u l 'ɔ ʒ i k ə s 
zombi	z 'ɔ m b i	 z 'ɔ m b i 
calculo	k ə l k 'u l u	 k ə l k 'u l u 
elamites	ə l ə m 'i t ə s	 ə l ə m 'i t ə s 
caixeta	k ə ʃ 'ɛ t ə	 k ə ʃ 'ɛ t ə 
contacta	k u n t 'a k t ə	 k u n t 'a k t ə 
ros	r 'o s	 r 'o s 
compromesa	k u m p ɾ u m 'ɛ z ə	 k u m p ɾ u m 'ɛ z ə 
Anar	ə n 'a	 ə n 'a 
insultes	i n s 'u l t ə s	 i n s 'u l t ə s 
higiene	i ʒ i 'ɛ n ə	 i ʒ i 'ɛ n ə 
borinot	b u ɾ i n 'ɔ t	 b u ɾ i n 'ɔ t 
atomitzada	ə t u m i d z 'a ð ə	 ə t u m i d z 'a ð ə 
desxifrat	d ə ʃ i f ɾ 'a t	 d ə ʃ i f ɾ 'a t 
destines	d ə s t 'i n ə s	 d ə s t 'i n ə s 
suplantat	s u p l ə n t 'a t	 s u p l ə n t 'a t 
curació	k u ɾ ə s i 'o	 k u ɾ ə s i 'o 
profunditzades	p ɾ u f u n d i d z 'a ð ə s	 p ɾ u f u n d i d z 'a ð ə s 
anèmia	ə n 'ɛ m i ə	 ə n 'ɛ m i ə 
acidifiques	ə s i ð i f 'i k ə s	 ə s i ð i f 'i k ə s 
damasquines	d ə m ə s k 'i n ə s	 d ə m ə s k 'i n ə s 
afectarem	ə f ə k t ə ɾ 'ɛ m	 ə f ə k t ə ɾ 'ɛ m 
comentem	k u m ə n t 'ɛ m	 k u m ə n t 'ɛ m 
derruïda	d ə r u 'i ð ə	 d ə r u 'i ð ə 
promoció	p ɾ u m u s i 'o	 p ɾ u m u s i 'o 
simpatitzat	s i m p ə t i d z 'a t	 s i m p ə t i d z 'a t 
usable	u z 'a b b l ə	 u z 'a b b l ə 
obis	'ɔ β i s	 'ɔ β i s 
porxada	p u r ʃ 'a ð ə	 p u r ʃ 'a ð ə 
passar-se	p ə s 'a r s ə	 p ə s 'a r s ə 
agents	ə ʒ 'e n s	 ə ʒ 'e n s 
esputar	ə s p u t 'a	 ə s p u t 'a 
put	p 'u t	 p 'u t 
aplicacions	ə p l i k ə s i 'o n s	 ə p l i k ə s i 'o n s 
europi	ə w ɾ 'ɔ p i	 ə w ɾ 'ɔ p i 
amaga	ə m 'a ɣ ə	 ə m 'a ɣ ə 
arribi	ə r 'i β i	 ə r 'i β i 
sotgi	s 'ɔ d ʒ i	 s 'ɔ d ʒ i 
m'atreveixo	m ə t ɾ ə β 'ɛ ʃ u	 m ə t ɾ ə β 'ɛ ʃ u 
podies	p u ð 'i ə s	 p u ð 'i ə s 
fràncic	f ɾ 'a n s i k	 f ɾ 'a n s i k 
invencible	i m b ə n s 'i b b l ə	 i m b ə n s 'i b b l ə 
benedicció	b ə n ə ð i k s i 'o	 b ə n ə ð i k s i 'o 
agitant	ə ʒ i t 'a n	 ə ʒ i t 'a n 
prohibit	p ɾ u i β 'i t	 p ɾ u i β 'i t 
llibretes	ʎ i β ɾ 'ɛ t ə s	 ʎ i β ɾ 'ɛ t ə s 
nina	n 'i n ə	 n 'i n ə 
plutòniques	p l u t 'ɔ n i k ə s	 p l u t 'ɔ n i k ə s 
reposapeus	r ə p u z ə p 'ɛ w s	 r ə p u z ə p 'ɛ w s 
erudites	ə ɾ u ð 'i t ə s	 ə ɾ u ð 'i t ə s 
bisectrius	b i z ə k t ɾ 'i w s	 b i z ə k t ɾ 'i w s 
agràs	ə ɣ ɾ 'a s	 ə ɣ ɾ 'a s 
desencadenar	d ə z ə ŋ k ə ð ə n 'a	 d ə z ə ŋ k ə ð ə n 'a 
cobri	k 'ɔ β ɾ i	 k 'ɔ β ɾ i 
precolombí	p ɾ ə k u l u m b 'i	 p ɾ ə k u l u m b 'i 
copulats	k u p u l 'a t s	 k u p u l 'a t s 
Sols	s 'ɔ l s	 s 'ɔ l s 
desistida	d ə z i s t 'i ð ə	 d ə z i s t 'i ð ə 
nata	n 'a t ə	 n 'a t ə 
totalitzar	t u t ə l i d z 'a	 t u t ə l i d z 'a 
bòriques	b 'ɔ ɾ i k ə s	 b 'ɔ ɾ i k ə s 
cedida	s ə ð 'i ð ə	 s ə ð 'i ð ə 
sepulcral	s ə p u l k ɾ 'a l	 s ə p u l k ɾ 'a l 
catalanismes	k ə t ə l ə n 'i z m ə s	 k ə t ə l ə n 'i z m ə s 
arrova	ə r 'ɔ β ə	 ə r 'ɔ β ə 
rebolcada	r ə β u l k 'a ð ə	 r ə β u l k 'a ð ə 
rotlles	r 'ɔ ʎ ʎ ə s	 r 'ɔ ʎ ʎ ə s 
alts	'a l s	 'a l s 
Escriptori	ə s k ɾ i p t 'ɔ ɾ i	 ə s k ɾ i p t 'ɔ ɾ i 
finiria	f i n i ɾ 'i ə	 f i n i ɾ 'i ə 
abaixarem	ə β ə ʃ ə ɾ 'ɛ m	 ə β ə ʃ ə ɾ 'ɛ m 
procurem	p ɾ u k u ɾ 'ɛ m	 p ɾ u k u ɾ 'ɛ m 
renovar	r ə n u β 'a	 r ə n u β 'a 
melodia	m ə l u ð 'i ə	 m ə l u ð 'i ə 
racional	r ə s i u n 'a l	 r ə s i u n 'a l 
Ara	'a ɾ ə	 'a ɾ ə 
controvèrsia	k u n t ɾ u β 'ɛ r s i ə	 k u n t ɾ u β 'ɛ r s i ə 
àpat	'a p ə t	 'a p ə t 
terminis	t ə r m 'i n i s	 t ə r m 'i n i s 
flotada	f l u t 'a ð ə	 f l u t 'a ð ə 
descontentat	d ə s k u n t ə n t 'a t	 d ə s k u n t ə n t 'a t 
abaixaran	ə β ə ʃ ə ɾ 'a n	 ə β ə ʃ ə ɾ 'a n 
filagarsa	f i l ə ɣ 'a r s ə	 f i l ə ɣ 'a r s ə 
recital	r ə s i t 'a l	 r ə s i t 'a l 
oblidar	u β l i ð 'a	 u β l i ð 'a 
jovial	ʒ u β i 'a l	 ʒ u β i 'a l 
italianes	i t ə l i 'a n ə s	 i t ə l i 'a n ə s 
esparrall	ə s p ə r 'a ʎ	 ə s p ə r 'a ʎ 
esmolar	ə z m u l 'a	 ə z m u l 'a 
crien	k ɾ 'i ə n	 k ɾ 'i ə n 
conquerit	k u ŋ k ə ɾ 'i t	 k u ŋ k ə ɾ 'i t 
professorat	p ɾ u f ə s u ɾ 'a t	 p ɾ u f ə s u ɾ 'a t 
saló	s ə l 'o	 s ə l 'o 
ajudarem	ə ʒ u ð ə ɾ 'ɛ m	 ə ʒ u ð ə ɾ 'ɛ m 
procuréssim	p ɾ u k u ɾ 'e s i m	 p ɾ u k u ɾ 'e s i m 
comiat	k u m i 'a t	 k u m i 'a t 
retiraria	r ə t i ɾ ə ɾ 'i ə	 r ə t i ɾ ə ɾ 'i ə 
fleuma	f l 'ɛ w m ə	 f l 'ɛ w m ə 
ambigu	ə m b 'i ɣ u	 ə m b 'i ɣ u 
escarabats	ə s k ə ɾ ə β 'a t s	 ə s k ə ɾ ə β 'a t s 
mediana	m ə ð i 'a n ə	 m ə ð i 'a n ə 
identificat	i ð ə n t i f i k 'a t	 i ð ə n t i f i k 'a t 
frígida	f ɾ 'i ʒ i ð ə	 f ɾ 'i ʒ i ð ə 
solter	s u l t 'e	 s u l t 'e 
alarmat	ə l ə r m 'a t	 ə l ə r m 'a t 
compàs	k u m p 'a s	 k u m p 'a s 
cornis	k 'ɔ r n i s	 k 'ɔ r n i s 
monopirè	m u n u p i ɾ 'ɛ	 m u n u p i ɾ 'ɛ 
dotació	d u t ə s i 'o	 d u t ə s i 'o 
ovni	'ɔ b n i	 'ɔ b n i 
esgrima	ə z ɣ ɾ 'i m ə	 ə z ɣ ɾ 'i m ə 
cenyida	s ə ɲ 'i ð ə	 s ə ɲ 'i ð ə 
adoptaria	ə ð u p t ə ɾ 'i ə	 ə ð u p t ə ɾ 'i ə 
fase	f 'a z ə	 f 'a z ə 
subjugats	s u b ʒ u ɣ 'a t s	 s u b ʒ u ɣ 'a t s 
artesanes	ə r t ə z 'a n ə s	 ə r t ə z 'a n ə s 
festaire	f ə s t 'a j ɾ ə	 f ə s t 'a j ɾ ə 
taxonomia	t ə k s u n u m 'i ə	 t ə k s u n u m 'i ə 
dedicar	d ə ð i k 'a	 d ə ð i k 'a 
impossibilitar	i m p u s i β i l i t 'a	 i m p u s i β i l i t 'a 
castrades	k ə s t ɾ 'a ð ə s	 k ə s t ɾ 'a ð ə s 
ennuegà	ə n n u ə ɣ 'a	 ə n n u ə ɣ 'a 
patentades	p ə t ə n t 'a ð ə s	 p ə t ə n t 'a ð ə s 
pecà	p ə k 'a	 p ə k 'a 
esgavellar	ə z ɣ ə β ə ʎ 'a	 ə z ɣ ə β ə ʎ 'a 
Vallespinosa	b ə ʎ ə s p i n 'o z ə	 b ə ʎ ə s p i n 'o z ə 
ratllar	r ə ʎ ʎ 'a	 r ə ʎ ʎ 'a 
druida	d ɾ 'u j ð ə	 d ɾ 'u j ð ə 
ubicades	u β i k 'a ð ə s	 u β i k 'a ð ə s 
Amic	ə m 'i k	 ə m 'i k 
subnana	s u b n 'a n ə	 s u b n 'a n ə 
l'onzè	l u n z 'ɛ	 l u n z 'ɛ 
prematurs	p ɾ ə m ə t 'u r s	 p ɾ ə m ə t 'u r s 
cabró	k ə β ɾ 'o	 k ə β ɾ 'o 
generació	ʒ ə n ə ɾ ə s i 'o	 ʒ ə n ə ɾ ə s i 'o 
reïxes	r ə 'i ʃ ə s	 r ə 'i ʃ ə s 
munyit	m u ɲ 'i t	 m u ɲ 'i t 
quadrar-me	k w ə ð ɾ 'a r m ə	 k w ə ð ɾ 'a r m ə 
nicotina	n i k u t 'i n ə	 n i k u t 'i n ə 
definir	d ə f i n 'i	 d ə f i n 'i 
incoherent	i ŋ k u ə ɾ 'e n	 i ŋ k u ə ɾ 'e n 
penetrant	p ə n ə t ɾ 'a n	 p ə n ə t ɾ 'a n 
apoderats	ə p u ð ə ɾ 'a t s	 ə p u ð ə ɾ 'a t s 
superjò	s u p ə r ʒ 'ɔ	 s u p ə r ʒ 'ɔ 
obstruïdes	u p s t ɾ u 'i ð ə s	 u p s t ɾ u 'i ð ə s 
rogenques	r u ʒ 'ɛ ŋ k ə s	 r u ʒ 'ɛ ŋ k ə s 
bresquilles	b ɾ ə s k 'i ʎ ə s	 b ɾ ə s k 'i ʎ ə s 
sumat	s u m 'a t	 s u m 'a t 
liquidat	l i k i ð 'a t	 l i k i ð 'a t 
regulat	r ə ɣ u l 'a t	 r ə ɣ u l 'a t 
inscripció	i n s k ɾ i p s i 'o	 i n s k ɾ i p s i 'o 
mestre	m 'ɛ s t ɾ ə	 m 'ɛ s t ɾ ə 
opiata	u p i 'a t ə	 u p i 'a t ə 
siguem	s i ɣ 'ɛ m	 s i ɣ 'ɛ m 
incompatibilitats	i ŋ k u m p ə t i β i l i t 'a t s	 i ŋ k u m p ə t i β i l i t 'a t s 
escoltat	ə s k u l t 'a t	 ə s k u l t 'a t 
habitada	ə β i t 'a ð ə	 ə β i t 'a ð ə 
bresquilla	b ɾ ə s k 'i ʎ ə	 b ɾ ə s k 'i ʎ ə 
drogada	d ɾ u ɣ 'a ð ə	 d ɾ u ɣ 'a ð ə 
epidemiològica	ə p i ð ə m i u l 'ɔ ʒ i k ə	 ə p i ð ə m i u l 'ɔ ʒ i k ə 
constituir	k u n s t i t u 'i	 k u n s t i t u 'i 
estimuladors	ə s t i m u l ə ð 'o s	 ə s t i m u l ə ð 'o s 
l'assaltant	l ə s ə l t 'a n	 l ə s ə l t 'a n 
lògics	l 'ɔ ʒ i k s	 l 'ɔ ʒ i k s 
programacions	p ɾ u ɣ ɾ ə m ə s i 'o n s	 p ɾ u ɣ ɾ ə m ə s i 'o n s 
nimbe	n 'i m b ə	 n 'i m b ə 
l'Islam	l i z l 'a m	 l i z l 'a m 
amansit	ə m ə n s 'i t	 ə m ə n s 'i t 
Herodes	ə ɾ 'ɔ ð ə s	 ə ɾ 'ɔ ð ə s 
vienés	b i ə n 'e s	 b i ə n 'e s 
toscanes	t u s k 'a n ə s	 t u s k 'a n ə s 
nul	n 'u l	 n 'u l 
cementiris	s ə m ə n t 'i ɾ i s	 s ə m ə n t 'i ɾ i s 
faldons	f ə l d 'o n s	 f ə l d 'o n s 
foragitada	f u ɾ ə ʒ i t 'a ð ə	 f u ɾ ə ʒ i t 'a ð ə 
coves	k 'ɔ β ə s	 k 'ɔ β ə s 
pretensiosos	p ɾ ə t ə n s i 'o z u s	 p ɾ ə t ə n s i 'o z u s 
Dionís	d i u n 'i s	 d i u n 'i s 
efectuat	ə f ə k t u 'a t	 ə f ə k t u 'a t 
perelló	p ə ɾ ə ʎ 'o	 p ə ɾ ə ʎ 'o 
fenils	f ə n 'i l s	 f ə n 'i l s 
anivellat	ə n i β ə ʎ 'a t	 ə n i β ə ʎ 'a t 
fallar	f ə ʎ 'a	 f ə ʎ 'a 
anèmics	ə n 'ɛ m i k s	 ə n 'ɛ m i k s 
deïficar	d ə i f i k 'a	 d ə i f i k 'a 
veixiga	b ə ʃ 'i ɣ ə	 b ə ʃ 'i ɣ ə 
verificats	b ə ɾ i f i k 'a t s	 b ə ɾ i f i k 'a t s 
d'Onyar	d u ɲ 'a	 d u ɲ 'a 
asimptomàtiques	ə z i m t u m 'a t i k ə s	 ə z i m t u m 'a t i k ə s 
escòria	ə s k 'ɔ ɾ i ə	 ə s k 'ɔ ɾ i ə 
sexen	s 'ɛ k s ə n	 s 'ɛ k s ə n 
movedís	m u β ə ð 'i s	 m u β ə ð 'i s 
Internet	i n t ə r n 'ɛ t	 i n t ə r n 'ɛ t 
Sàsser	s 'a s ə	 s 'a s ə 
platea	p l ə t 'e ə	 p l ə t 'e ə 
natiu	n ə t 'i w	 n ə t 'i w 
conquerides	k u ŋ k ə ɾ 'i ð ə s	 k u ŋ k ə ɾ 'i ð ə s 
pic	p 'i k	 p 'i k 
itinerant	i t i n ə ɾ 'a n	 i t i n ə ɾ 'a n 
anhel	ə n 'ɛ l	 ə n 'ɛ l 
estona	ə s t 'o n ə	 ə s t 'o n ə 
fètida	f 'ɛ t i ð ə	 f 'ɛ t i ð ə 
oratjós	u ɾ ə d ʒ 'o s	 u ɾ ə d ʒ 'o s 
dinàmics	d i n 'a m i k s	 d i n 'a m i k s 
figuratives	f i ɣ u ɾ ə t 'i β ə s	 f i ɣ u ɾ ə t 'i β ə s 
interrogació	i n t ə r u ɣ ə s i 'o	 i n t ə r u ɣ ə s i 'o 
esternuda	ə s t ə r n 'u ð ə	 ə s t ə r n 'u ð ə 
regalés	r ə ɣ ə l 'e s	 r ə ɣ ə l 'e s 
casella	k ə z 'e ʎ ə	 k ə z 'e ʎ ə 
boscana	b u s k 'a n ə	 b u s k 'a n ə 
timpà	t i m p 'a	 t i m p 'a 
teia	t 'ɛ j ə	 t 'ɛ j ə 
minerals	m i n ə ɾ 'a l s	 m i n ə ɾ 'a l s 
Gènesi	ʒ 'ɛ n ə z i	 ʒ 'ɛ n ə z i 
santificables	s ə n t i f i k 'a b b l ə s	 s ə n t i f i k 'a b b l ə s 
arabitzat	ə ɾ ə β i d z 'a t	 ə ɾ ə β i d z 'a t 
biòlegs	b i 'ɔ l ə k s	 b i 'ɔ l ə k s 
exposar-ho	ə k s p u z 'a ɾ u	 ə k s p u z 'a ɾ u 
bloquejats	b l u k ə ʒ 'a t s	 b l u k ə ʒ 'a t s 
soprano	s u p ɾ 'a n u	 s u p ɾ 'a n u 
prelació	p ɾ ə l ə s i 'o	 p ɾ ə l ə s i 'o 
malva	m 'a l β ə	 m 'a l β ə 
broma	b ɾ 'o m ə	 b ɾ 'o m ə 
ajornat	ə ʒ u r n 'a t	 ə ʒ u r n 'a t 
marcades	m ə r k 'a ð ə s	 m ə r k 'a ð ə s 
picava	p i k 'a β ə	 p i k 'a β ə 
Dóna	d 'o n ə	 d 'o n ə 
adjurat	ə d ʒ u ɾ 'a t	 ə d ʒ u ɾ 'a t 
cosmologia	k u z m u l u ʒ 'i ə	 k u z m u l u ʒ 'i ə 
escreix	ə s k ɾ 'e ʃ	 ə s k ɾ 'e ʃ 
protegides	p ɾ u t ə ʒ 'i ð ə s	 p ɾ u t ə ʒ 'i ð ə s 
joguinejar	ʒ u ɣ i n ə ʒ 'a	 ʒ u ɣ i n ə ʒ 'a 
eliminarà	ə l i m i n ə ɾ 'a	 ə l i m i n ə ɾ 'a 
valguda	b ə l ɣ 'u ð ə	 b ə l ɣ 'u ð ə 
aconsellades	ə k u n s ə ʎ 'a ð ə s	 ə k u n s ə ʎ 'a ð ə s 
Analitzaran	ə n ə l i d z ə ɾ 'a n	 ə n ə l i d z ə ɾ 'a n 
m'agradaria	m ə ɣ ɾ ə ð ə ɾ 'i ə	 m ə ɣ ɾ ə ð ə ɾ 'i ə 
egípcies	ə ʒ 'i p s i ə s	 ə ʒ 'i p s i ə s 
tellina	t ə ʎ 'i n ə	 t ə ʎ 'i n ə 
alternador	ə l t ə r n ə ð 'o	 ə l t ə r n ə ð 'o 
descalços	d ə s k 'a l s u s	 d ə s k 'a l s u s 
d'adoració	d ə ð u ɾ ə s i 'o	 d ə ð u ɾ ə s i 'o 
lasanya	l ə z 'a ɲ ə	 l ə z 'a ɲ ə 
lampista	l ə m p 'i s t ə	 l ə m p 'i s t ə 
l'aixeta	l ə ʃ 'ɛ t ə	 l ə ʃ 'ɛ t ə 
protegir-nos	p ɾ u t ə ʒ 'i r n u s	 p ɾ u t ə ʒ 'i r n u s 
acèrrim	ə s 'ɛ r i m	 ə s 'ɛ r i m 
D'Almeria	d ə l m ə ɾ 'i ə	 d ə l m ə ɾ 'i ə 
hesitació	ə z i t ə s i 'o	 ə z i t ə s i 'o 
perles	p 'ɛ r l ə s	 p 'ɛ r l ə s 
ànet	'a n ə t	 'a n ə t 
dodecagonal	d u ð ə k ə ɣ u n 'a l	 d u ð ə k ə ɣ u n 'a l 
escopinar	ə s k u p i n 'a	 ə s k u p i n 'a 
necessito	n ə s ə s 'i t u	 n ə s ə s 'i t u 
teorema	t ə u ɾ 'ɛ m ə	 t ə u ɾ 'ɛ m ə 
masculins	m ə s k u l 'i n s	 m ə s k u l 'i n s 
endogàmia	ə n d u ɣ 'a m i ə	 ə n d u ɣ 'a m i ə 
tènue	t 'ɛ n u ə	 t 'ɛ n u ə 
dataràs	d ə t ə ɾ 'a s	 d ə t ə ɾ 'a s 
descobridors	d ə s k u β ɾ i ð 'o s	 d ə s k u β ɾ i ð 'o s 
abandonades	ə β ə n d u n 'a ð ə s	 ə β ə n d u n 'a ð ə s 
pinsà	p i n s 'a	 p i n s 'a 
legalitat	l ə ɣ ə l i t 'a t	 l ə ɣ ə l i t 'a t 
carinat	k ə ɾ i n 'a t	 k ə ɾ i n 'a t 
lúdics	l 'u ð i k s	 l 'u ð i k s 
solidària	s u l i ð 'a ɾ i ə	 s u l i ð 'a ɾ i ə 
metropolitana	m ə t ɾ u p u l i t 'a n ə	 m ə t ɾ u p u l i t 'a n ə 
dibuixats	d i β u ʃ 'a t s	 d i β u ʃ 'a t s 
deguts	d ə ɣ 'u t s	 d ə ɣ 'u t s 
laboratoris	l ə β u ɾ ə t 'ɔ ɾ i s	 l ə β u ɾ ə t 'ɔ ɾ i s 
mastitis	m ə s t 'i t i s	 m ə s t 'i t i s 
cavo	k 'a β u	 k 'a β u 
avançades	ə β ə n s 'a ð ə s	 ə β ə n s 'a ð ə s 
lleteresa	ʎ ə t ə ɾ 'ɛ z ə	 ʎ ə t ə ɾ 'ɛ z ə 
batalló	b ə t ə ʎ 'o	 b ə t ə ʎ 'o 
atzabeja	ə d z ə β 'ɛ ʒ ə	 ə d z ə β 'ɛ ʒ ə 
reescrits	r e ə s k ɾ 'i t s	 r e ə s k ɾ 'i t s 
fotògraf	f u t 'ɔ ɣ ɾ ə f	 f u t 'ɔ ɣ ɾ ə f 
esfilagarsades	ə s f i l ə ɣ ə r s 'a ð ə s	 ə s f i l ə ɣ ə r s 'a ð ə s 
anatomia	ə n ə t u m 'i ə	 ə n ə t u m 'i ə 
indigestió	i n d i ʒ ə s t i 'o	 i n d i ʒ ə s t i 'o 
Empassant	ə m p ə s 'a n	 ə m p ə s 'a n 
Tal	t 'a l	 t 'a l 
renovació	r ə n u β ə s i 'o	 r ə n u β ə s i 'o 
d'entrenar	d ə n t ɾ ə n 'a	 d ə n t ɾ ə n 'a 
pobres	p 'ɔ β ɾ ə s	 p 'ɔ β ɾ ə s 
recelós	r ə s ə l 'o s	 r ə s ə l 'o s 
destruïts	d ə s t ɾ u 'i t s	 d ə s t ɾ u 'i t s 
tolerància	t u l ə ɾ 'a n s i ə	 t u l ə ɾ 'a n s i ə 
piga	p 'i ɣ ə	 p 'i ɣ ə 
trivialitzar	t ɾ i β i ə l i d z 'a	 t ɾ i β i ə l i d z 'a 
indiscriminada	i n d i s k ɾ i m i n 'a ð ə	 i n d i s k ɾ i m i n 'a ð ə 
polèmica	p u l 'ɛ m i k ə	 p u l 'ɛ m i k ə 
figurar	f i ɣ u ɾ 'a	 f i ɣ u ɾ 'a 
marcòlic	m ə r k 'ɔ l i k	 m ə r k 'ɔ l i k 
cantina	k ə n t 'i n ə	 k ə n t 'i n ə 
escurçar	ə s k u r s 'a	 ə s k u r s 'a 
elaborades	ə l ə β u ɾ 'a ð ə s	 ə l ə β u ɾ 'a ð ə s 
torçuda	t u r s 'u ð ə	 t u r s 'u ð ə 
desesperar	d ə z ə s p ə ɾ 'a	 d ə z ə s p ə ɾ 'a 
raqueta	r ə k 'ɛ t ə	 r ə k 'ɛ t ə 
ferides	f ə ɾ 'i ð ə s	 f ə ɾ 'i ð ə s 
divan	d i β 'a n	 d i β 'a n 
impulsivitat	i m p u l s i β i t 'a t	 i m p u l s i β i t 'a t 
broto	b ɾ 'ɔ t u	 b ɾ 'ɔ t u 
Social	s u s i 'a l	 s u s i 'a l 
caçat	k ə s 'a t	 k ə s 'a t 
romàs	r u m 'a s	 r u m 'a s 
intermèdies	i n t ə r m 'ɛ ð i ə s	 i n t ə r m 'ɛ ð i ə s 
excusades	ə k s k u z 'a ð ə s	 ə k s k u z 'a ð ə s 
entenedora	ə n t ə n ə ð 'o ɾ ə	 ə n t ə n ə ð 'o ɾ ə 
alemanya	ə l ə m 'a ɲ ə	 ə l ə m 'a ɲ ə 
fagocitari	f ə ɣ u s i t 'a ɾ i	 f ə ɣ u s i t 'a ɾ i 
sobralles	s u β ɾ 'a ʎ ə s	 s u β ɾ 'a ʎ ə s 
casta	k 'a s t ə	 k 'a s t ə 
dòlar	d 'ɔ l ə r	 d 'ɔ l ə r 
brioixos	b ɾ i 'ɔ ʃ u s	 b ɾ i 'ɔ ʃ u s 
premin	p ɾ 'ɛ m i n	 p ɾ 'ɛ m i n 
tacar	t ə k 'a	 t ə k 'a 
oït	u 'i t	 u 'i t 
sublimar	s u β l i m 'a	 s u β l i m 'a 
coneixem	k u n ə ʃ 'ɛ m	 k u n ə ʃ 'ɛ m 
escoltant	ə s k u l t 'a n	 ə s k u l t 'a n 
agroalimentari	ə ɣ ɾ u ə l i m ə n t 'a ɾ i	 ə ɣ ɾ u ə l i m ə n t 'a ɾ i 
conselleries	k u n s ə ʎ ə ɾ 'i ə s	 k u n s ə ʎ ə ɾ 'i ə s 
lisosòmics	l i z u z 'ɔ m i k s	 l i z u z 'ɔ m i k s 
titubada	t i t u β 'a ð ə	 t i t u β 'a ð ə 
blastomada	b l ə s t u m 'a ð ə	 b l ə s t u m 'a ð ə 
d'esquí	d ə s k 'i	 d ə s k 'i 
mocador	m u k ə ð 'o	 m u k ə ð 'o 
comunitats	k u m u n i t 'a t s	 k u m u n i t 'a t s 
habitades	ə β i t 'a ð ə s	 ə β i t 'a ð ə s 
operar	u p ə ɾ 'a	 u p ə ɾ 'a 
cossar	k u s 'a	 k u s 'a 
escenògraf	ə s ə n 'ɔ ɣ ɾ ə f	 ə s ə n 'ɔ ɣ ɾ ə f 
materialisme	m ə t ə ɾ i ə l 'i z m ə	 m ə t ə ɾ i ə l 'i z m ə 
Nota	n 'ɔ t ə	 n 'ɔ t ə 
detonats	d ə t u n 'a t s	 d ə t u n 'a t s 
quan	k w 'a n	 k w 'a n 
forta	f 'ɔ r t ə	 f 'ɔ r t ə 
habito	ə β 'i t u	 ə β 'i t u 
rosegó	r u z ə ɣ 'o	 r u z ə ɣ 'o 
afiliació	ə f i l i ə s i 'o	 ə f i l i ə s i 'o 
inspirar	i n s p i ɾ 'a	 i n s p i ɾ 'a 
diner	d i n 'e	 d i n 'e 
combustible	k u m b u s t 'i b b l ə	 k u m b u s t 'i b b l ə 
multiplicativa	m u l t i p l i k ə t 'i β ə	 m u l t i p l i k ə t 'i β ə 
paleocènica	p ə l ə u s 'ɛ n i k ə	 p ə l ə u s 'ɛ n i k ə 
impunitat	i m p u n i t 'a t	 i m p u n i t 'a t 
l'u	l 'u	 l 'u 
realitats	r e ə l i t 'a t s	 r e ə l i t 'a t s 
comunicaries	k u m u n i k ə ɾ 'i ə s	 k u m u n i k ə ɾ 'i ə s 
marxis	m 'a r ʃ i s	 m 'a r ʃ i s 
mancomunitat	m ə ŋ k u m u n i t 'a t	 m ə ŋ k u m u n i t 'a t 
palatí	p ə l ə t 'i	 p ə l ə t 'i 
prestacions	p ɾ ə s t ə s i 'o n s	 p ɾ ə s t ə s i 'o n s 
doctorada	d u k t u ɾ 'a ð ə	 d u k t u ɾ 'a ð ə 
molestar	m u l ə s t 'a	 m u l ə s t 'a 
contigu	k u n t 'i ɣ u	 k u n t 'i ɣ u 
borlar	b u r l 'a	 b u r l 'a 
imparcials	i m p ə r s i 'a l s	 i m p ə r s i 'a l s 
pari	p 'a ɾ i	 p 'a ɾ i 
arrendar	ə r ə n d 'a	 ə r ə n d 'a 
localitat	l u k ə l i t 'a t	 l u k ə l i t 'a t 
hospitalari	u s p i t ə l 'a ɾ i	 u s p i t ə l 'a ɾ i 
melmelada	m ə l m ə l 'a ð ə	 m ə l m ə l 'a ð ə 
diluvià	d i l u β i 'a	 d i l u β i 'a 
ampla	'a m p l ə	 'a m p l ə 
parmesà	p ə r m ə z 'a	 p ə r m ə z 'a 
l'antonomàsia	l ə n t u n u m 'a z i ə	 l ə n t u n u m 'a z i ə 
simulació	s i m u l ə s i 'o	 s i m u l ə s i 'o 
esperant	ə s p ə ɾ 'a n	 ə s p ə ɾ 'a n 
mirat	m i ɾ 'a t	 m i ɾ 'a t 
somrís	s u m r 'i s	 s u m r 'i s 
Cupido	k u p 'i ð u	 k u p 'i ð u 
néts	n 'e t s	 n 'e t s 
pantògraf	p ə n t 'ɔ ɣ ɾ ə f	 p ə n t 'ɔ ɣ ɾ ə f 
rebuda	r ə β 'u ð ə	 r ə β 'u ð ə 
tenies	t ə n 'i ə s	 t ə n 'i ə s 
ajudava	ə ʒ u ð 'a β ə	 ə ʒ u ð 'a β ə 
revolucionària	r ə β u l u s i u n 'a ɾ i ə	 r ə β u l u s i u n 'a ɾ i ə 
botons	b u t 'o n s	 b u t 'o n s 
granger	g ɾ ə n ʒ 'e	 g ɾ ə n ʒ 'e 
extinta	ə k s t 'i n t ə	 ə k s t 'i n t ə 
Març	m 'a r s	 m 'a r s 
locomotora	l u k u m u t 'o ɾ ə	 l u k u m u t 'o ɾ ə 
clapat	k l ə p 'a t	 k l ə p 'a t 
llavi	ʎ 'a β i	 ʎ 'a β i 
excepcionalitats	ə k s ə p s i u n ə l i t 'a t s	 ə k s ə p s i u n ə l i t 'a t s 
fútil	f 'u t i l	 f 'u t i l 
continuar	k u n t i n u 'a	 k u n t i n u 'a 
petita	p ə t 'i t ə	 p ə t 'i t ə 
devorades	d ə β u ɾ 'a ð ə s	 d ə β u ɾ 'a ð ə s 
doblegats	d u b b l ə ɣ 'a t s	 d u b b l ə ɣ 'a t s 
traumatitzats	t ɾ ə w m ə t i d z 'a t s	 t ɾ ə w m ə t i d z 'a t s 
l'esmorzar	l ə z m u r z 'a	 l ə z m u r z 'a 
alienacions	ə l i ə n ə s i 'o n s	 ə l i ə n ə s i 'o n s 
beles	b 'ɛ l ə s	 b 'ɛ l ə s 
frases	f ɾ 'a z ə s	 f ɾ 'a z ə s 
convencionalisme	k u m b ə n s i u n ə l 'i z m ə	 k u m b ə n s i u n ə l 'i z m ə 
desídia	d ə z 'i ð i ə	 d ə z 'i ð i ə 
Crònica	k ɾ 'ɔ n i k ə	 k ɾ 'ɔ n i k ə 
marreu	m ə r 'ɛ w	 m ə r 'ɛ w 
tenebrós	t ə n ə β ɾ 'o s	 t ə n ə β ɾ 'o s 
impulsiva	i m p u l s 'i β ə	 i m p u l s 'i β ə 
pescaire	p ə s k 'a j ɾ ə	 p ə s k 'a j ɾ ə 
sumo	s 'u m u	 s 'u m u 
encarregar	ə ŋ k ə r ə ɣ 'a	 ə ŋ k ə r ə ɣ 'a 
Cadascun	k ə ð ə s k 'u n	 k ə ð ə s k 'u n 
sirena	s i ɾ 'ɛ n ə	 s i ɾ 'ɛ n ə 
Identificar	i ð ə n t i f i k 'a	 i ð ə n t i f i k 'a 
obscuritat	u p s k u ɾ i t 'a t	 u p s k u ɾ i t 'a t 
contracte	k u n t ɾ 'a k t ə	 k u n t ɾ 'a k t ə 
Mataresies	m ə t ə ɾ ə z 'i ə s	 m ə t ə ɾ ə z 'i ə s 
capficada	k ə p f i k 'a ð ə	 k ə p f i k 'a ð ə 
fusionat	f u z i u n 'a t	 f u z i u n 'a t 
delitable	d ə l i t 'a b b l ə	 d ə l i t 'a b b l ə 
mesura	m ə z 'u ɾ ə	 m ə z 'u ɾ ə 
frego	f ɾ 'ɛ ɣ u	 f ɾ 'ɛ ɣ u 
aglomerada	ə ɣ l u m ə ɾ 'a ð ə	 ə ɣ l u m ə ɾ 'a ð ə 
sorren	s 'ɔ r ə n	 s 'ɔ r ə n 
abaixes	ə β 'a ʃ ə s	 ə β 'a ʃ ə s 
foradats	f u ɾ ə ð 'a t s	 f u ɾ ə ð 'a t s 
inesperat	i n ə s p ə ɾ 'a t	 i n ə s p ə ɾ 'a t 
lubrificà	l u β ɾ i f i k 'a	 l u β ɾ i f i k 'a 
anaves	ə n 'a β ə s	 ə n 'a β ə s 
ferma	f 'ɛ r m ə	 f 'ɛ r m ə 
rodanxes	r u ð 'a n ʃ ə s	 r u ð 'a n ʃ ə s 
forçosa	f u r s 'o z ə	 f u r s 'o z ə 
nosaltres	n u z 'a l t ɾ ə s	 n u z 'a l t ɾ ə s 
pèl	p 'ɛ l	 p 'ɛ l 
Saludo	s ə l 'u ð u	 s ə l 'u ð u 
visqués	b i s k 'e s	 b i s k 'e s 
meridians	m ə ɾ i ð i 'a n s	 m ə ɾ i ð i 'a n s 
deposicionals	d ə p u z i s i u n 'a l s	 d ə p u z i s i u n 'a l s 
terranova	t ə r ə n 'ɔ β ə	 t ə r ə n 'ɔ β ə 
després	d ə s p ɾ 'e s	 d ə s p ɾ 'e s 
fresa	f ɾ 'ɛ z ə	 f ɾ 'ɛ z ə 
humanitzades	u m ə n i d z 'a ð ə s	 u m ə n i d z 'a ð ə s 
regulava	r ə ɣ u l 'a β ə	 r ə ɣ u l 'a β ə 
assabentant	ə s ə β ə n t 'a n	 ə s ə β ə n t 'a n 
troba	t ɾ 'ɔ β ə	 t ɾ 'ɔ β ə 
loteria	l u t ə ɾ 'i ə	 l u t ə ɾ 'i ə 
alineat	ə l i n e 'a t	 ə l i n e 'a t 
Kuwait	k u β 'a j t	 k u β 'a j t 
enriquit	ə n r i k 'i t	 ə n r i k 'i t 
nedades	n ə ð 'a ð ə s	 n ə ð 'a ð ə s 
espurnejat	ə s p u r n ə ʒ 'a t	 ə s p u r n ə ʒ 'a t 
nitrificat	n i t ɾ i f i k 'a t	 n i t ɾ i f i k 'a t 
tortellatge	t u r t ə ʎ 'a d ʒ ə	 t u r t ə ʎ 'a d ʒ ə 
ressenya	r ə s 'ɛ ɲ ə	 r ə s 'ɛ ɲ ə 
arada	ə ɾ 'a ð ə	 ə ɾ 'a ð ə 
borrut	b u r 'u t	 b u r 'u t 
escorxar	ə s k u r ʃ 'a	 ə s k u r ʃ 'a 
pestanya	p ə s t 'a ɲ ə	 p ə s t 'a ɲ ə 
Discapacitat	d i s k ə p ə s i t 'a t	 d i s k ə p ə s i t 'a t 
tirava	t i ɾ 'a β ə	 t i ɾ 'a β ə 
vetust	b ə t 'u s t	 b ə t 'u s t 
toqui	t 'ɔ k i	 t 'ɔ k i 
pliocènics	p l i u s 'ɛ n i k s	 p l i u s 'ɛ n i k s 
apareixerà	ə p ə ɾ ə ʃ ə ɾ 'a	 ə p ə ɾ ə ʃ ə ɾ 'a 
enturió	ə n t u ɾ i 'o	 ə n t u ɾ i 'o 
s'allotja	s ə ʎ 'ɔ d ʒ ə	 s ə ʎ 'ɔ d ʒ ə 
alat	ə l 'a t	 ə l 'a t 
alumini	ə l u m 'i n i	 ə l u m 'i n i 
flamant	f l ə m 'a n	 f l ə m 'a n 
bellugadissa	b ə ʎ u ɣ ə ð 'i s ə	 b ə ʎ u ɣ ə ð 'i s ə 
conspiració	k u n s p i ɾ ə s i 'o	 k u n s p i ɾ ə s i 'o 
desplegament	d ə s p l ə ɣ ə m 'e n	 d ə s p l ə ɣ ə m 'e n 
nítid	n 'i t i t	 n 'i t i t 
escandalitzats	ə s k ə n d ə l i d z 'a t s	 ə s k ə n d ə l i d z 'a t s 
coincidència	k u i n s i ð 'ɛ n s i ə	 k u i n s i ð 'ɛ n s i ə 
clonats	k l u n 'a t s	 k l u n 'a t s 
citació	s i t ə s i 'o	 s i t ə s i 'o 
cantant	k ə n t 'a n	 k ə n t 'a n 
virus	b 'i ɾ u s	 b 'i ɾ u s 
despatxar	d ə s p ə t ʃ 'a	 d ə s p ə t ʃ 'a 
regals	r ə ɣ 'a l s	 r ə ɣ 'a l s 
nepalés	n ə p ə l 'e s	 n ə p ə l 'e s 
injeccions	i n ʒ ə k s i 'o n s	 i n ʒ ə k s i 'o n s 
delme	d 'ɛ l m ə	 d 'ɛ l m ə 
mani	m 'a n i	 m 'a n i 
sisos	s 'i z u s	 s 'i z u s 
Finança	f i n 'a n s ə	 f i n 'a n s ə 
perímetre	p ə ɾ 'i m ə t ɾ ə	 p ə ɾ 'i m ə t ɾ ə 
desproporcionats	d ə s p ɾ u p u r s i u n 'a t s	 d ə s p ɾ u p u r s i u n 'a t s 
prelatici	p ɾ ə l ə t 'i s i	 p ɾ ə l ə t 'i s i 
milè	m i l 'ɛ	 m i l 'ɛ 
ulleres	u ʎ 'e ɾ ə s	 u ʎ 'e ɾ ə s 
alliberades	ə ʎ i β ə ɾ 'a ð ə s	 ə ʎ i β ə ɾ 'a ð ə s 
cessats	s ə s 'a t s	 s ə s 'a t s 
atorrollar	ə t u r u ʎ 'a	 ə t u r u ʎ 'a 
respiro	r ə s p 'i ɾ u	 r ə s p 'i ɾ u 
clericat	k l ə ɾ i k 'a t	 k l ə ɾ i k 'a t 
llançadores	ʎ ə n s ə ð 'o ɾ ə s	 ʎ ə n s ə ð 'o ɾ ə s 
industrialitzades	i n d u s t ɾ i ə l i d z 'a ð ə s	 i n d u s t ɾ i ə l i d z 'a ð ə s 
maleïts	m ə l ə 'i t s	 m ə l ə 'i t s 
mamut	m ə m 'u t	 m ə m 'u t 
afrontarà	ə f ɾ u n t ə ɾ 'a	 ə f ɾ u n t ə ɾ 'a 
parròquia	p ə r 'ɔ k i ə	 p ə r 'ɔ k i ə 
llumí	ʎ u m 'i	 ʎ u m 'i 
ammonit	ə m m u n 'i t	 ə m m u n 'i t 
radicalitzades	r ə ð i k ə l i d z 'a ð ə s	 r ə ð i k ə l i d z 'a ð ə s 
inquietat	i ŋ k i ə t 'a t	 i ŋ k i ə t 'a t 
autenticats	ə w t ə n t i k 'a t s	 ə w t ə n t i k 'a t s 
ocasionar	u k ə z i u n 'a	 u k ə z i u n 'a 
saquejadors	s ə k ə ʒ ə ð 'o s	 s ə k ə ʒ ə ð 'o s 
brindà	b ɾ i n d 'a	 b ɾ i n d 'a 
company	k u m p 'a ɲ	 k u m p 'a ɲ 
amblats	ə m b l 'a t s	 ə m b l 'a t s 
incomodat	i ŋ k u m u ð 'a t	 i ŋ k u m u ð 'a t 
llimbs	ʎ 'i m s	 ʎ 'i m s 
cilindre	s i l 'i n d ɾ ə	 s i l 'i n d ɾ ə 
octau	u k t 'a w	 u k t 'a w 
filòsof	f i l 'ɔ z u f	 f i l 'ɔ z u f 
calcificar	k ə l s i f i k 'a	 k ə l s i f i k 'a 
mistificar	m i s t i f i k 'a	 m i s t i f i k 'a 
cogitar	k u ʒ i t 'a	 k u ʒ i t 'a 
caricatura	k ə ɾ i k ə t 'u ɾ ə	 k ə ɾ i k ə t 'u ɾ ə 
renovades	r ə n u β 'a ð ə s	 r ə n u β 'a ð ə s 
crítiques	k ɾ 'i t i k ə s	 k ɾ 'i t i k ə s 
defensats	d ə f ə n s 'a t s	 d ə f ə n s 'a t s 
peritatges	p ə ɾ i t 'a d ʒ ə s	 p ə ɾ i t 'a d ʒ ə s 
periscòpics	p ə ɾ i s k 'ɔ p i k s	 p ə ɾ i s k 'ɔ p i k s 
ecològiques	ə k u l 'ɔ ʒ i k ə s	 ə k u l 'ɔ ʒ i k ə s 
internauta	i n t ə r n 'a w t ə	 i n t ə r n 'a w t ə 
s'arribi	s ə r 'i β i	 s ə r 'i β i 
desvetllament	d ə z β ə ʎ ʎ ə m 'e n	 d ə z β ə ʎ ʎ ə m 'e n 
bigàmies	b i ɣ 'a m i ə s	 b i ɣ 'a m i ə s 
progènie	p ɾ u ʒ 'ɛ n i ə	 p ɾ u ʒ 'ɛ n i ə 
gratuïts	g ɾ ə t u 'i t s	 g ɾ ə t u 'i t s 
testejar	t ə s t ə ʒ 'a	 t ə s t ə ʒ 'a 
gerra	ʒ 'ɛ r ə	 ʒ 'ɛ r ə 
funeral	f u n ə ɾ 'a l	 f u n ə ɾ 'a l 
enclusa	ə ŋ k l 'u z ə	 ə ŋ k l 'u z ə 
cellut	s ə ʎ 'u t	 s ə ʎ 'u t 
adobats	ə ð u β 'a t s	 ə ð u β 'a t s 
intubada	i n t u β 'a ð ə	 i n t u β 'a ð ə 
pleguin	p l 'ɛ ɣ i n	 p l 'ɛ ɣ i n 
surf	s 'u r f	 s 'u r f 
fullaraca	f u ʎ ə ɾ 'a k ə	 f u ʎ ə ɾ 'a k ə 
convencions	k u m b ə n s i 'o n s	 k u m b ə n s i 'o n s 
tòfones	t 'ɔ f u n ə s	 t 'ɔ f u n ə s 
modelada	m u ð ə l 'a ð ə	 m u ð ə l 'a ð ə 
llampegar	ʎ ə m p ə ɣ 'a	 ʎ ə m p ə ɣ 'a 
soltis	s 'ɔ l t i s	 s 'ɔ l t i s 
productores	p ɾ u ð u k t 'o ɾ ə s	 p ɾ u ð u k t 'o ɾ ə s 
Països	p ə 'i z u s	 p ə 'i z u s 
hibernar	i β ə r n 'a	 i β ə r n 'a 
escultor	ə s k u l t 'o	 ə s k u l t 'o 
contemplacions	k u n t ə m p l ə s i 'o n s	 k u n t ə m p l ə s i 'o n s 
fogassa	f u ɣ 'a s ə	 f u ɣ 'a s ə 
murtó	m u r t 'o	 m u r t 'o 
D'Indonèsia	d i n d u n 'ɛ z i ə	 d i n d u n 'ɛ z i ə 
desterrades	d ə s t ə r 'a ð ə s	 d ə s t ə r 'a ð ə s 
casaràs	k ə z ə ɾ 'a s	 k ə z ə ɾ 'a s 
d'Aran	d ə ɾ 'a n	 d ə ɾ 'a n 
aigües	'a j ɣ w ə s	 'a j ɣ w ə s 
telefonats	t ə l ə f u n 'a t s	 t ə l ə f u n 'a t s 
colen	k 'ɔ l ə n	 k 'ɔ l ə n 
allunyant-se	ə ʎ u ɲ 'a n s ə	 ə ʎ u ɲ 'a n s ə 
numeraris	n u m ə ɾ 'a ɾ i s	 n u m ə ɾ 'a ɾ i s 
selva	s 'ɛ l β ə	 s 'ɛ l β ə 
reelegides	r e ə l ə ʒ 'i ð ə s	 r e ə l ə ʒ 'i ð ə s 
alliberament	ə ʎ i β ə ɾ ə m 'e n	 ə ʎ i β ə ɾ ə m 'e n 
ferits	f ə ɾ 'i t s	 f ə ɾ 'i t s 
moquis	m 'ɔ k i s	 m 'ɔ k i s 
triar	t ɾ i 'a	 t ɾ i 'a 
cribratges	k ɾ i β ɾ 'a d ʒ ə s	 k ɾ i β ɾ 'a d ʒ ə s 
tacó	t ə k 'o	 t ə k 'o 
dòrics	d 'ɔ ɾ i k s	 d 'ɔ ɾ i k s 
superava	s u p ə ɾ 'a β ə	 s u p ə ɾ 'a β ə 
pobles	p 'ɔ b b l ə s	 p 'ɔ b b l ə s 
catàstrofes	k ə t 'a s t ɾ u f ə s	 k ə t 'a s t ɾ u f ə s 
prèvia	p ɾ 'ɛ β i ə	 p ɾ 'ɛ β i ə 
clotet	k l u t 'ɛ t	 k l u t 'ɛ t 
possessions	p u s ə s i 'o n s	 p u s ə s i 'o n s 
subestima	s u p ə s t 'i m ə	 s u p ə s t 'i m ə 
S'agita	s ə ʒ 'i t ə	 s ə ʒ 'i t ə 
oncològic	u ŋ k u l 'ɔ ʒ i k	 u ŋ k u l 'ɔ ʒ i k 
esdeveniment	ə z ð ə β ə n i m 'e n	 ə z ð ə β ə n i m 'e n 
tolerable	t u l ə ɾ 'a b b l ə	 t u l ə ɾ 'a b b l ə 
marrans	m ə r 'a n s	 m ə r 'a n s 
carpetada	k ə r p ə t 'a ð ə	 k ə r p ə t 'a ð ə 
mesclat	m ə s k l 'a t	 m ə s k l 'a t 
faringe	f ə ɾ 'i n ʒ ə	 f ə ɾ 'i n ʒ ə 
immobilitzades	i m m u β i l i d z 'a ð ə s	 i m m u β i l i d z 'a ð ə s 
colpejada	k u l p ə ʒ 'a ð ə	 k u l p ə ʒ 'a ð ə 
cúmul	k 'u m u l	 k 'u m u l 
meningitis	m ə n i n ʒ 'i t i s	 m ə n i n ʒ 'i t i s 
androgèniques	ə n d ɾ u ʒ 'ɛ n i k ə s	 ə n d ɾ u ʒ 'ɛ n i k ə s 
contextualitzat	k u n t ə k s t u ə l i d z 'a t	 k u n t ə k s t u ə l i d z 'a t 
solto	s 'ɔ l t u	 s 'ɔ l t u 
afilem	ə f i l 'ɛ m	 ə f i l 'ɛ m 
obligat	u β l i ɣ 'a t	 u β l i ɣ 'a t 
milana	m i l 'a n ə	 m i l 'a n ə 
renegar	r ə n ə ɣ 'a	 r ə n ə ɣ 'a 
conseller	k u n s ə ʎ 'e	 k u n s ə ʎ 'e 
Metropolità	m ə t ɾ u p u l i t 'a	 m ə t ɾ u p u l i t 'a 
desinterès	d ə z i n t ə ɾ 'ɛ s	 d ə z i n t ə ɾ 'ɛ s 
acabava	ə k ə β 'a β ə	 ə k ə β 'a β ə 
peces	p 'e s ə s	 p 'e s ə s 
pegades	p ə ɣ 'a ð ə s	 p ə ɣ 'a ð ə s 
aptituds	ə p t i t 'u t s	 ə p t i t 'u t s 
sultà	s u l t 'a	 s u l t 'a 
espora	ə s p 'o ɾ ə	 ə s p 'o ɾ ə 
netejar-me	n ə t ə ʒ 'a r m ə	 n ə t ə ʒ 'a r m ə 
macròcits	m ə k ɾ 'ɔ s i t s	 m ə k ɾ 'ɔ s i t s 
taula	t 'a w l ə	 t 'a w l ə 
esbudellades	ə z β u ð ə ʎ 'a ð ə s	 ə z β u ð ə ʎ 'a ð ə s 
llevador	ʎ ə β ə ð 'o	 ʎ ə β ə ð 'o 
valorats	b ə l u ɾ 'a t s	 b ə l u ɾ 'a t s 
d'ull	d 'u ʎ	 d 'u ʎ 
indòmita	i n d 'ɔ m i t ə	 i n d 'ɔ m i t ə 
còpies	k 'ɔ p i ə s	 k 'ɔ p i ə s 
insisteixi	i n s i s t 'ɛ ʃ i	 i n s i s t 'ɛ ʃ i 
xerrant	ʃ ə r 'a n	 ʃ ə r 'a n 
seleccionem	s ə l ə k s i u n 'ɛ m	 s ə l ə k s i u n 'ɛ m 
devorats	d ə β u ɾ 'a t s	 d ə β u ɾ 'a t s 
abiològic	ə β i u l 'ɔ ʒ i k	 ə β i u l 'ɔ ʒ i k 
vinculada	b i ŋ k u l 'a ð ə	 b i ŋ k u l 'a ð ə 
escornada	ə s k u r n 'a ð ə	 ə s k u r n 'a ð ə 
construït	k u n s t ɾ u 'i t	 k u n s t ɾ u 'i t 
convidares	k u m b i ð 'a ɾ ə s	 k u m b i ð 'a ɾ ə s 
abrucès	ə β ɾ u s 'ɛ s	 ə β ɾ u s 'ɛ s 
generals	ʒ ə n ə ɾ 'a l s	 ʒ ə n ə ɾ 'a l s 
disculpada	d i s k u l p 'a ð ə	 d i s k u l p 'a ð ə 
viarany	b i ə ɾ 'a ɲ	 b i ə ɾ 'a ɲ 
límits	l 'i m i t s	 l 'i m i t s 
vestigi	b ə s t 'i ʒ i	 b ə s t 'i ʒ i 
envestir	ə m b ə s t 'i	 ə m b ə s t 'i 
berenada	b ə ɾ ə n 'a ð ə	 b ə ɾ ə n 'a ð ə 
doctoral	d u k t u ɾ 'a l	 d u k t u ɾ 'a l 
participació	p ə r t i s i p ə s i 'o	 p ə r t i s i p ə s i 'o 
collides	k u ʎ 'i ð ə s	 k u ʎ 'i ð ə s 
adiu	ə ð 'i w	 ə ð 'i w 
demanen	d ə m 'a n ə n	 d ə m 'a n ə n 
agonitzada	ə ɣ u n i d z 'a ð ə	 ə ɣ u n i d z 'a ð ə 
roina	r 'ɔ j n ə	 r 'ɔ j n ə 
predecessora	p ɾ ə ð ə s ə s 'o ɾ ə	 p ɾ ə ð ə s ə s 'o ɾ ə 
omissió	u m i s i 'o	 u m i s i 'o 
múria	m 'u ɾ i ə	 m 'u ɾ i ə 
lletres	ʎ 'ɛ t ɾ ə s	 ʎ 'ɛ t ɾ ə s 
Pensava	p ə n s 'a β ə	 p ə n s 'a β ə 
buscades	b u s k 'a ð ə s	 b u s k 'a ð ə s 
embotornar	ə m b u t u r n 'a	 ə m b u t u r n 'a 
recitatiu	r ə s i t ə t 'i w	 r ə s i t ə t 'i w 
mental	m ə n t 'a l	 m ə n t 'a l 
reduït	r ə ð u 'i t	 r ə ð u 'i t 
assolellat	ə s u l ə ʎ 'a t	 ə s u l ə ʎ 'a t 
temporal	t ə m p u ɾ 'a l	 t ə m p u ɾ 'a l 
completa	k u m p l 'ɛ t ə	 k u m p l 'ɛ t ə 
crida	k ɾ 'i ð ə	 k ɾ 'i ð ə 
colon	k u l 'o n	 k u l 'o n 
descontenta	d ə s k u n t 'e n t ə	 d ə s k u n t 'e n t ə 
destituïts	d ə s t i t u 'i t s	 d ə s t i t u 'i t s 
polpar	p u l p 'a	 p u l p 'a 
sensible	s ə n s 'i b b l ə	 s ə n s 'i b b l ə 
curtes	k 'u r t ə s	 k 'u r t ə s 
planejada	p l ə n ə ʒ 'a ð ə	 p l ə n ə ʒ 'a ð ə 
barreja	b ə r 'ɛ ʒ ə	 b ə r 'ɛ ʒ ə 
actuat	ə k t u 'a t	 ə k t u 'a t 
entronitzat	ə n t ɾ u n i d z 'a t	 ə n t ɾ u n i d z 'a t 
revisats	r ə β i z 'a t s	 r ə β i z 'a t s 
prioritat	p ɾ i u ɾ i t 'a t	 p ɾ i u ɾ i t 'a t 
medites	m ə ð 'i t ə s	 m ə ð 'i t ə s 
rail	r 'a j l	 r 'a j l 
circulatori	s i r k u l ə t 'ɔ ɾ i	 s i r k u l ə t 'ɔ ɾ i 
orada	u ɾ 'a ð ə	 u ɾ 'a ð ə 
afegit	ə f ə ʒ 'i t	 ə f ə ʒ 'i t 
temptada	t ə m t 'a ð ə	 t ə m t 'a ð ə 
obès	u β 'ɛ s	 u β 'ɛ s 
ventilares	b ə n t i l 'a ɾ ə s	 b ə n t i l 'a ɾ ə s 
protònic	p ɾ u t 'ɔ n i k	 p ɾ u t 'ɔ n i k 
augurar	ə w ɣ u ɾ 'a	 ə w ɣ u ɾ 'a 
apatia	ə p ə t 'i ə	 ə p ə t 'i ə 
esclafant-les	ə s k l ə f 'a n l ə s	 ə s k l ə f 'a n l ə s 
assaborida	ə s ə β u ɾ 'i ð ə	 ə s ə β u ɾ 'i ð ə 
ovalats	u β ə l 'a t s	 u β ə l 'a t s 
devorada	d ə β u ɾ 'a ð ə	 d ə β u ɾ 'a ð ə 
calta	k 'a l t ə	 k 'a l t ə 
topògraf	t u p 'ɔ ɣ ɾ ə f	 t u p 'ɔ ɣ ɾ ə f 
paradoxa	p ə ɾ ə ð 'ɔ k s ə	 p ə ɾ ə ð 'ɔ k s ə 
durar	d u ɾ 'a	 d u ɾ 'a 
onclo	'ɔ ŋ k l u	 'ɔ ŋ k l u 
sentenciada	s ə n t ə n s i 'a ð ə	 s ə n t ə n s i 'a ð ə 
regalar	r ə ɣ ə l 'a	 r ə ɣ ə l 'a 
amistós	ə m i s t 'o s	 ə m i s t 'o s 
intensificació	i n t ə n s i f i k ə s i 'o	 i n t ə n s i f i k ə s i 'o 
expressió	ə k s p ɾ ə s i 'o	 ə k s p ɾ ə s i 'o 
obstaculitzada	u p s t ə k u l i d z 'a ð ə	 u p s t ə k u l i d z 'a ð ə 
dopes	d 'ɔ p ə s	 d 'ɔ p ə s 
mitjançar	m i d ʒ ə n s 'a	 m i d ʒ ə n s 'a 
sintetitzadors	s i n t ə t i d z ə ð 'o s	 s i n t ə t i d z ə ð 'o s 
cònsol	k 'ɔ n s u l	 k 'ɔ n s u l 
acceptable	ə k s ə p t 'a b b l ə	 ə k s ə p t 'a b b l ə 
rabí	r ə β 'i	 r ə β 'i 
subestimaria	s u p ə s t i m ə ɾ 'i ə	 s u p ə s t i m ə ɾ 'i ə 
comensal	k u m ə n s 'a l	 k u m ə n s 'a l 
vostè	b u s t 'ɛ	 b u s t 'ɛ 
criminològica	k ɾ i m i n u l 'ɔ ʒ i k ə	 k ɾ i m i n u l 'ɔ ʒ i k ə 
índies	'i n d i ə s	 'i n d i ə s 
sues	s 'u ə s	 s 'u ə s 
adiria	ə ð i ɾ 'i ə	 ə ð i ɾ 'i ə 
riallera	r i ə ʎ 'e ɾ ə	 r i ə ʎ 'e ɾ ə 
buròcrata	b u ɾ 'ɔ k ɾ ə t ə	 b u ɾ 'ɔ k ɾ ə t ə 
calar	k ə l 'a	 k ə l 'a 
catàleg	k ə t 'a l ə k	 k ə t 'a l ə k 
refrigerat	r ə f ɾ i ʒ ə ɾ 'a t	 r ə f ɾ i ʒ ə ɾ 'a t 
materialitzades	m ə t ə ɾ i ə l i d z 'a ð ə s	 m ə t ə ɾ i ə l i d z 'a ð ə s 
protegir-me	p ɾ u t ə ʒ 'i r m ə	 p ɾ u t ə ʒ 'i r m ə 
cavar	k ə β 'a	 k ə β 'a 
ampliar	ə m p l i 'a	 ə m p l i 'a 
pastes	p 'a s t ə s	 p 'a s t ə s 
empobrides	ə m p u β ɾ 'i ð ə s	 ə m p u β ɾ 'i ð ə s 
prostra	p ɾ 'ɔ s t ɾ ə	 p ɾ 'ɔ s t ɾ ə 
reemplaçat	r e ə m p l ə s 'a t	 r e ə m p l ə s 'a t 
mirandès	m i ɾ ə n d 'ɛ s	 m i ɾ ə n d 'ɛ s 
docte	d 'ɔ k t ə	 d 'ɔ k t ə 
mecanitzades	m ə k ə n i d z 'a ð ə s	 m ə k ə n i d z 'a ð ə s 
catalitzades	k ə t ə l i d z 'a ð ə s	 k ə t ə l i d z 'a ð ə s 
vindicats	b i n d i k 'a t s	 b i n d i k 'a t s 
aparentar	ə p ə ɾ ə n t 'a	 ə p ə ɾ ə n t 'a 
humiliant	u m i l i 'a n	 u m i l i 'a n 
dossos	d 'ɔ s u s	 d 'ɔ s u s 
pregó	p ɾ ə ɣ 'o	 p ɾ ə ɣ 'o 
apostrofar	ə p u s t ɾ u f 'a	 ə p u s t ɾ u f 'a 
desavantatge	d ə z ə β ə n t 'a d ʒ ə	 d ə z ə β ə n t 'a d ʒ ə 
predicació	p ɾ ə ð i k ə s i 'o	 p ɾ ə ð i k ə s i 'o 
recrear	r ə k ɾ e 'a	 r ə k ɾ e 'a 
catarro	k ə t 'a r u	 k ə t 'a r u 
venjades	b ə n ʒ 'a ð ə s	 b ə n ʒ 'a ð ə s 
vigèsim	b i ʒ 'ɛ z i m	 b i ʒ 'ɛ z i m 
jugar	ʒ u ɣ 'a	 ʒ u ɣ 'a 
rendibles	r ə n d 'i b b l ə s	 r ə n d 'i b b l ə s 
necessitar	n ə s ə s i t 'a	 n ə s ə s i t 'a 
astroquímica	ə s t ɾ u k 'i m i k ə	 ə s t ɾ u k 'i m i k ə 
ubicats	u β i k 'a t s	 u β i k 'a t s 
acariciaria	ə k ə ɾ i s i ə ɾ 'i ə	 ə k ə ɾ i s i ə ɾ 'i ə 
sincer	s i n s 'e	 s i n s 'e 
l'estudi	l ə s t 'u ð i	 l ə s t 'u ð i 
alfanumèriques	ə l f ə n u m 'ɛ ɾ i k ə s	 ə l f ə n u m 'ɛ ɾ i k ə s 
digestives	d i ʒ ə s t 'i β ə s	 d i ʒ ə s t 'i β ə s 
empatx	ə m p 'a t ʃ	 ə m p 'a t ʃ 
mentir	m ə n t 'i	 m ə n t 'i 
estàtics	ə s t 'a t i k s	 ə s t 'a t i k s 
espatllat	ə s p ə ʎ ʎ 'a t	 ə s p ə ʎ ʎ 'a t 
càrrec	k 'a r ə k	 k 'a r ə k 
Besòs	b ə z 'ɔ s	 b ə z 'ɔ s 
pretès	p ɾ ə t 'ɛ s	 p ɾ ə t 'ɛ s 
Tres	t ɾ 'ɛ s	 t ɾ 'ɛ s 
llenega	ʎ ə n 'ɛ ɣ ə	 ʎ ə n 'ɛ ɣ ə 
encoratjador	ə ŋ k u ɾ ə d ʒ ə ð 'o	 ə ŋ k u ɾ ə d ʒ ə ð 'o 
l'extinció	l ə k s t i n s i 'o	 l ə k s t i n s i 'o 
rovellons	r u β ə ʎ 'o n s	 r u β ə ʎ 'o n s 
astúcia	ə s t 'u s i ə	 ə s t 'u s i ə 
Marisa	m ə ɾ 'i z ə	 m ə ɾ 'i z ə 
apujada	ə p u ʒ 'a ð ə	 ə p u ʒ 'a ð ə 
negués	n ə ɣ 'e s	 n ə ɣ 'e s 
Suïssa	s u 'i s ə	 s u 'i s ə 
agradant	ə ɣ ɾ ə ð 'a n	 ə ɣ ɾ ə ð 'a n 
remunerar	r ə m u n ə ɾ 'a	 r ə m u n ə ɾ 'a 
posteritat	p u s t ə ɾ i t 'a t	 p u s t ə ɾ i t 'a t 
n'adona	n ə ð 'o n ə	 n ə ð 'o n ə 
serrada	s ə r 'a ð ə	 s ə r 'a ð ə 
Grup	g ɾ 'u p	 g ɾ 'u p 
traurà	t ɾ ə w ɾ 'a	 t ɾ ə w ɾ 'a 
mostrar	m u s t ɾ 'a	 m u s t ɾ 'a 
setzè	s ə d z 'ɛ	 s ə d z 'ɛ 
insurgida	i n s u r ʒ 'i ð ə	 i n s u r ʒ 'i ð ə 
pilotejar	p i l u t ə ʒ 'a	 p i l u t ə ʒ 'a 
perjudicar	p ə r ʒ u ð i k 'a	 p ə r ʒ u ð i k 'a 
usuaris	u z u 'a ɾ i s	 u z u 'a ɾ i s 
marit	m ə ɾ 'i t	 m ə ɾ 'i t 
follo	f 'ɔ ʎ u	 f 'ɔ ʎ u 
aplec	ə p l 'ɛ k	 ə p l 'ɛ k 
fuetejats	f u ə t ə ʒ 'a t s	 f u ə t ə ʒ 'a t s 
dedico	d ə ð 'i k u	 d ə ð 'i k u 
Sergi	s 'ɛ r ʒ i	 s 'ɛ r ʒ i 
monoplataforma	m u n u p l ə t ə f 'ɔ r m ə	 m u n u p l ə t ə f 'ɔ r m ə 
reformador	r ə f u r m ə ð 'o	 r ə f u r m ə ð 'o 
lingüístic	l i ŋ g w 'i s t i k	 l i ŋ g w 'i s t i k 
almegó	ə l m ə ɣ 'o	 ə l m ə ɣ 'o 
clissada	k l i s 'a ð ə	 k l i s 'a ð ə 
encantares	ə ŋ k ə n t 'a ɾ ə s	 ə ŋ k ə n t 'a ɾ ə s 
reaccions	r e ə k s i 'o n s	 r e ə k s i 'o n s 
pequinés	p ə k i n 'e s	 p ə k i n 'e s 
exceptuada	ə k s ə p t u 'a ð ə	 ə k s ə p t u 'a ð ə 
pirè	p i ɾ 'ɛ	 p i ɾ 'ɛ 
torquis	t 'ɔ r k i s	 t 'ɔ r k i s 
fascinat	f ə s i n 'a t	 f ə s i n 'a t 
inculte	i ŋ k 'u l t ə	 i ŋ k 'u l t ə 
volgut	b u l ɣ 'u t	 b u l ɣ 'u t 
aglà	ə ɣ l 'a	 ə ɣ l 'a 
molinat	m u l i n 'a t	 m u l i n 'a t 
agrari	ə ɣ ɾ 'a ɾ i	 ə ɣ ɾ 'a ɾ i 
centralitats	s ə n t ɾ ə l i t 'a t s	 s ə n t ɾ ə l i t 'a t s 
benèfic	b ə n 'ɛ f i k	 b ə n 'ɛ f i k 
alimentacions	ə l i m ə n t ə s i 'o n s	 ə l i m ə n t ə s i 'o n s 
esperava	ə s p ə ɾ 'a β ə	 ə s p ə ɾ 'a β ə 
descarregada	d ə s k ə r ə ɣ 'a ð ə	 d ə s k ə r ə ɣ 'a ð ə 
Zaire	z 'a j ɾ ə	 z 'a j ɾ ə 
fenomènic	f ə n u m 'ɛ n i k	 f ə n u m 'ɛ n i k 
bocarrut	b u k ə r 'u t	 b u k ə r 'u t 
Frejús	f ɾ ə ʒ 'u s	 f ɾ ə ʒ 'u s 
falsificada	f ə l s i f i k 'a ð ə	 f ə l s i f i k 'a ð ə 
bronquials	b ɾ u ŋ k i 'a l s	 b ɾ u ŋ k i 'a l s 
motives	m u t 'i β ə s	 m u t 'i β ə s 
descansant	d ə s k ə n s 'a n	 d ə s k ə n s 'a n 
cèntrica	s 'ɛ n t ɾ i k ə	 s 'ɛ n t ɾ i k ə 
carn	k 'a r n	 k 'a r n 
ruda	r 'u ð ə	 r 'u ð ə 
clàxon	k l 'a k s u n	 k l 'a k s u n 
abisme	ə β 'i z m ə	 ə β 'i z m ə 
prepuci	p ɾ ə p 'u s i	 p ɾ ə p 'u s i 
enamorats	ə n ə m u ɾ 'a t s	 ə n ə m u ɾ 'a t s 
tàcits	t 'a s i t s	 t 'a s i t s 
comptabilitzats	k u m t ə β i l i d z 'a t s	 k u m t ə β i l i d z 'a t s 
perspectiva	p ə r s p ə k t 'i β ə	 p ə r s p ə k t 'i β ə 
llegíem	ʎ ə ʒ 'i ə m	 ʎ ə ʒ 'i ə m 
promulgat	p ɾ u m u l ɣ 'a t	 p ɾ u m u l ɣ 'a t 
errar	ə r 'a	 ə r 'a 
megalomàrtir	m ə ɣ ə l u m 'a r t i	 m ə ɣ ə l u m 'a r t i 
anàvem	ə n 'a β ə m	 ə n 'a β ə m 
alimentat	ə l i m ə n t 'a t	 ə l i m ə n t 'a t 
l'empresa	l ə m p ɾ 'ɛ z ə	 l ə m p ɾ 'ɛ z ə 
embogits	ə m b u ʒ 'i t s	 ə m b u ʒ 'i t s 
Davant	d ə β 'a n	 d ə β 'a n 
entrecuix	ə n t ɾ ə k 'u ʃ	 ə n t ɾ ə k 'u ʃ 
continuar-hi	k u n t i n u 'a ɾ i	 k u n t i n u 'a ɾ i 
callat	k ə ʎ 'a t	 k ə ʎ 'a t 
