A	'ə	ə
aalenià	ə ə l ə n i 'a	ə e l ə n i 'a
aaleniana	ə ə l ə n i 'a n ə	ə e l ə n i 'a n ə
aalenianes	ə ə l ə n i 'a n ə s	ə e l ə n i 'a n ə s
aalenians	ə ə l ə n i 'a n s	ə e l ə n i 'a n s
accadi	ə k k 'a ð i	ə t s 'a ð i
açò	ə s 'o	a s 'o
aconseguits	ə k o n s ə ɣ 'i t s	ə k o n s ə ɣ 'i s
actuats	ə t t u 'a t s	ə t t u 'a s
adesiara	ə ð ə z i 'a ɾ ə	a ð ə z i 'a ɾ ə
adscripció	ə s k ɾ i t s i 'o	ə t s k ɾ i t s i 'o
adscrites	ə  t s k ɾ 'i t ə s	ə t s k ɾ 'i t ə s
afaitar	ə f ə j t 'a	ə f ə i t 'a
afaitat	ə f ə j t 'a t	ə f ə i t 'a t
afaitats	ə f ə j t 'a t s	ə f ə i t 'a t s
afectuoses	ə f ə t t u 'o z ə s	ə f ə t t u 'o s ə s
Afganistan	ə v ɣ ə n i s t 'a n	ə f ɣ ə n i s t 'a n
agafamosquits	ə ɣ ə f ə m o s k 'i t s	ə ɣ ə f ə m o s k 'i s
agraïts	ə ɣ ɾ ə 'i t s	ə ɣ ɾ ə 'i s
agúen	ə ɣ 'u ə n	ə ɣ ə n
agúes	ə ɣ 'u ə s	ə ɣ ə s
aidada	ə j ð 'a ð ə	ə i ð 'a ð ə
aidades	ə j ð 'a ð ə s	ə i ð 'a ð ə s
aidant	ə j ð 'a n t	ə i ð 'a n t
aidar	ə j ð 'a	ə i ð 'a
aidat	ə j ð 'a t	ə i ð 'a t
aidats	ə j ð 'a t s	ə i ð 'a t s
Aina	'a j n ə	'a i n ə
albeca	ə l β 'e k ə	ə l β 'ə k ə
àlber	'a l β ə	'a l β e 
alçament	ə l s ə m 'e n t	a l s ə m 'e n t
alcohol	ə l k o 'o l	ə l k o 'a l
aleatori	ə l e ə t 'o ɾ i	ə l ə ə t 'o ɾ i
alegre	ə l 'e ɣ ɾ ə	ə l 'ə ɣ ɾ ə
algebraic	ə l ʒ ə β ɾ 'a j k	ə l ʒ ə β ɾ 'a i k
aliment	ə l i m 'e n t	a l i m 'e n t
alineada	ə l i n e 'a ð ə	ə l i n ə 'a ð ə
alineament	ə l i n e ə m 'e n t	ə l i n ə ə m 'e n t
alinear	ə l i n e 'a	ə l i n ə 'a
alineat	ə l i n e 'a t	ə l i n ə 'a t
alineats	ə l i n e 'a t s	ə l i n ə 'a s
almirallessa	ə l m i ɾ ə ʎ 'ə s ə	ə l m i ɾ ə ʎ 'e s ə
Altai	ə l t 'a j	ə l t 'a i
altaic	ə l t 'a j k	ə l t 'a i k
altrament	ə l t ɾ ə m 'e n t	a l t ɾ ə m 'e n t
amainada	ə m ə j n 'a ð ə	ə m ə i n 'a ð ə
amainades	ə m ə j n 'a ð ə s	ə m ə i n 'a ð ə s
amainant	ə m ə j n 'a n t	ə m ə i n 'a n t
amainar	ə m ə j n 'a	ə m ə i n 'a
amainat	ə m ə j n 'a t	ə m ə i n 'a t
amainats	ə m ə j n 'a t s	ə m ə i n 'a t s
amants	ə m 'a n s	ə m 'a n t s
amarg	ə m 'a ɾ k	ə m 'a ɾ ə
ambigu	ə m b 'i ɣ u	ə m b 'i ɣ
ambigú	ə m b i ɣ 'u	ə m b 'i tʃ
amistoses	ə m i s t 'o z ə s	ə m i s t 'o s ə s
anàrquica	ə n 'a ɾ k i k ə	ə n ə ɾ k 'i k ə
anàrquics	ə n 'a ɾ k i t s	ə n ə ɾ k 'i t s
àngels	'a n ʒ ə l s	a n ʒ 'e l s
Àngels	'a n ʒ ə l s	a n ʒ 'e l s
Ànglia	'a ŋ g l i ə	a ŋ g l 'i ə
angoixa	ə ŋ g 'o ʃ ə	ə ŋ g o 'i ʃ ə
angoixada	ə ŋ g o ʃ 'a ð ə	ə ŋ g o i ʃ 'a ð ə
angoixades	ə ŋ g o ʃ 'a ð ə s	ə ŋ g o i ʃ 'a ð ə s
angoixant	ə ŋ g o ʃ 'a n t	ə ŋ g o i ʃ 'a n t
angoixar	ə ŋ g o ʃ 'a	ə ŋ g o i ʃ 'a
angoixat	ə ŋ g o ʃ 'a t	ə ŋ g o i ʃ 'a t
angoixats	ə ŋ g o ʃ 'a t s	ə ŋ g o i ʃ 'a t s
anguila	ə ŋ g 'i l ə	ə ŋ g u 'i l ə
anoienc	ə n o j 'ə ŋ k	ə n o i 'ə ŋ k
anorèxia	ə n o ɾ 'e t s i ə	ə n o ɾ 'ə t s i ə
antiquada	ə n t i k w 'a ð ə	ə n t i k 'a ð ə
antiquades	ə n t i k w 'a ð ə s	ə n t i k 'a ð ə s
antiquats	ə n t i k w 'a t s	ə n t i k 'a t s
aparell	ə p ə ɾ 'ə ʎ	ə p ə ɾ 'e ʎ
apòstols	ə p 'o s t o l s	ə p o s t 'o l s
apòstrofs	ə p 'o s t ɾ o f s	ə p o s t ɾ 'o s
aprehendre	ə p ɾ ə 'e n d ɾ ə	ə p ɾ ə o n d ɾ ə
aquari	ə k w 'a ɾ i	ə k 'a ɾ i
aquaris	ə k w 'a ɾ i s	ə k 'a ɾ i s
aquàrium	ə k w 'a ɾ i w m	ə k 'a ɾ i w m
aquell	ə k 'ə ʎ	ə k 'e ʎ
aqueus	ə k 'e w s	ə k ə 'u s
aqüicultura	ə k w i k u l t 'u ɾ ə	ə k i k u l t 'u ɾ ə
arborètum	ə ɾ β o ɾ 'e t u m	ə ɾ β o ɾ ə t 'u m
arcaic	ə ɾ k 'a j k	ə ɾ k 'a i k
arcaics	ə ɾ k 'a j t s	ə ɾ k 'a i t s
arcaiques	ə ɾ k 'a j k ə s	ə ɾ k 'a i k ə s
areng	ə ɾ 'ə ŋ k	ə ɾ 'e ŋ k
àrguens	'a ɾ ɣ ə n s	a ɾ ɣ 'e n s
arguïts	ə ɾ ɣ u 'i t s	ə ɾ ɣ u 'i s
argument	ə ɾ ɣ u m 'e n t	a ɾ ɣ u m 'e n t
armament	ə ɾ m ə m 'e n t	a ɾ m ə m 'e n t
arqueà	ə ɾ k e 'a	ə ɾ k ə 'a
arxiduquessa	ə ɾ ʃ i ð u k 'ə s ə	ə ɾ ʃ i ð u k 'e s ə
asimètric	ə s i m 'e t ɾ i k	ə z i m 'e t ɾ i k
asímptota	ə z 'i m t o t ə	ə z i m t 'o t ə
asseure	ə s 'ə w ɾ ə	ə s 'e w ɾ ə
assignada	ə s i n n 'a ð ə	ə s i ə n 'a ð ə
assignades	ə s i n n 'a ð ə s	ə s i ə n 'a ð ə s
assignant	ə s i n n 'a n t	ə s i ə n 'a n t
assignar	ə s i n n 'a	ə s i ə n 'a
assignat	ə s i n n 'a t	ə s i ə n 'a t
assignats	ə s i n n 'a t s	ə s i ə n 'a t s
astènia	ə s t 'è n i ə	ə s t 'e n i ə
astènic	ə s t 'è n i k	ə s t 'e n i k
astronauta	ə s t ɾ o n 'a w t ə	ə s t ɾ o n ə 'u t ə
astronautes	ə s t ɾ o n 'a w t ə s	ə s t ɾ o n ə 'u t ə s
atendre	ə t 'e n d ɾ ə	ə t 'ə n d ɾ ə
atènyer	ə t 'ə ɲ ə	ə t ə ɲ 'e 
atles	'a l l ə s	'a b b l ə s
Atles	'a l l ə s	'a b b l ə s
atraient	ə t ɾ ə j 'e n t	ə t ɾ ə i 'e n t
atreure	ə t ɾ 'ə w ɾ ə	ə t ɾ 'e w ɾ ə
atribuïts	ə t ɾ i β u 'i t s	ə t ɾ i β u 'i s
aurèola	ə w ɾ 'e o l ə	ə w ɾ ə 'o l ə
Àustria	'a w s t ɾ i ə	a w s t ɾ 'i ə
autòmats	ə w t 'o m ə t s	ə w t o m 'a t s
autoretrat	ə w t o r ə t ɾ 'a t	ə w t o ɾ ə t ɾ 'a t
autoretrats	ə w t o r ə t ɾ 'a t s	ə w t o ɾ ə t ɾ 'a t s
autosuficiència	ə w t o s u f i s i 'e n s i ə	ə w t o z u f i s i 'e n s i ə
autosuficient	ə w t o s u f i s i 'e n t	ə w t o z u f i s i 'e n t
avantbraç	ə v ə m b ɾ 'a s	ə v ə n t ə ɾ 'a s
avantpassat	ə v ə m p ə s 'a t	ə v ə n t p ə s 'a t
avantpassats	ə v ə m p ə s 'a t s	ə v ə n t p ə s 'a t s
Azerbaidjan	ə z ə ɾ β ə j dʒ 'a n	ə z ə ɾ β ə i dʒ 'a n
babaues	b ə β 'a w ə s	b ə β 'a ə s
bai	b 'a j	b 'a i
bàrbar	b 'a ɾ β ə	b ə ɾ β 'a
batimètric	b ə t i m 'e t ɾ i k	b ə t i m 'ə t ɾ i k
beata	b e 'a t ə	ə e 'a t ə
beates	b e 'a t ə s	ə e 'a t ə s
becllarg	b ə k ʎ 'a ɾ k	b ə k ʎ 'a ɾ ə
beneïts	b ə n ə 'i t s	b ə n ə 'i s
berberetxo	b ə ɾ β ə ɾ 'e tʃ o	b ə ɾ β ə ɾ 'ə tʃ o
beure	b 'ə w ɾ ə	b 'e w ɾ ə
biogènesi	b i o ʒ 'e n ə z i	b i o ʒ 'ə n ə z i
bisexual	b i s ə t s u 'a l	b i z ə t s u 'a l
bisexualitat	b i s ə t s u ə l i t 'a t	b i z ə t s u ə l i t 'a t
bisexuals	b i s ə t s u 'a l s	b i z ə t s u 'a l s
bitlles	b 'i l l ə s	b 'i ʎ ʎ ə s
Blancaneus	b l ə ŋ k ə n 'e w s	b l ə ŋ k ə n ə 'u s
blens	b l 'ə n s	b l 'e n s
boirina	b o j ɾ 'i n ə	b o i ɾ 'i n ə
bolenga	b o l 'ə ŋ g ə	b o l 'e ŋ g ə
boletaire	b o l ə t 'a j ɾ ə	b o l ə t 'a i ɾ ə
bonzessa	b o n z 'ə s ə	b o n z 'e s ə
brànquia	b ɾ 'a ŋ k i ə	b ɾ ə ŋ k 'i ə
brànquies	b ɾ 'a ŋ k i ə s	b ɾ ə ŋ k 'i ə s
bressin	b ɾ 'ə s i n	b ɾ 'e s i n
brètol	b ɾ 'e t o l	b ɾ 'ə t o l
brètola	b ɾ 'e t o l ə	b ɾ 'ə t o l ə
brètoles	b ɾ 'e t o l ə s	b ɾ 'ə t o l ə s
brètols	b ɾ 'e t o ls	b ɾ 'ə t o l s
bretxa	b ɾ 'e tʃ ə	b ɾ 'ə tʃ ə
búbal	b 'u β ə l	b u β 'a l
búfal	b 'u f ə l	b u f 'a l
búfals	b 'u f ə l s	b u f 'a l s
buidada	b u j ð 'a ð ə	b u i ð 'a ð ə
buidades	b u j ð 'a ð ə s	b u i ð 'a ð ə s
buidar	b u j ð 'a	b u i ð 'a
buidatge	b u j ð 'a dʒ ə	b u i ð 'a dʒ ə
buidor	b u j ð 'o	b u i ð 'o
búlgara	b 'u l ɣ ə ɾ ə	b u l ɣ 'a ɾ ə
calamarsada	k ə l ə m ə ɾ s 'a ð ə	k ə l ə m ə s 'a ð ə
calamarsades	k ə l ə m ə ɾ s 'a ð ə s	k ə l ə m ə s 'a ð ə s
calàndria	k ə l 'a n d ɾ i ə	k ə l ə n d ɾ 'i ə
caler	k ə l 'ə	k ə l 'e
calorimètric	k ə l o ɾ i m 'e t ɾ i k	k ə l o ɾ i m 'ə t ɾ i k
calorimètrica	k ə l o ɾ i m 'e t ɾ i k ə	k ə l o ɾ i m 'ə t ɾ i k ə
calorimètrics	k ə l o ɾ i m 'e t ɾ i t s	k ə l o ɾ i m 'ə t ɾ i t s
calorimètriques	k ə l o ɾ i m 'e t ɾ i k ə s	k ə l o ɾ i m 'ə t ɾ i k ə s
canela	k ə n 'e l ə	k ə n 'ə l ə
caneles	k ə n 'e l ə s	k ə n 'ə l ə s
caníbals	k ə n 'i β ə l s	k ə n i β 'a l s
capsa	k 'a t s ə	k 'a s ə
càrcer	k 'a ɾ s ə	k 'a ɾ s e 
cardaire	k ə ɾ ð 'a j ɾ ə	k ə ɾ ð 'a i ɾ ə
cars	k 'a s	k 'a ɾ s
cartílag	k ə ɾ t 'i l ə k	k ə ɾ t 'i l ə tʃ
cartilaginoses	k ə ɾ t i l ə ʒ i n 'o z ə s	k ə ɾ t i l ə ʒ i n 'o s ə s
casernari	k ə z ə ɾ n 'a ɾ i	 k e z ə ɾ n 'a ɾ i
casernària	k ə z ə ɾ n 'a ɾ i ə	 k e z ə ɾ n 'a ɾ i ə
Caterina	k ə t ə ɾ 'i n ə	 k e t ə ɾ 'i n ə
cavernícola	k ə v ə ɾ n 'i k o l ə	 k e v ə ɾ n 'i k o l ə
cèdula	s 'e ð u l ə	s 'ə ð u l ə
cèdules	s 'e ð u l ə s	s 'ə ð u l ə s
cegues	s 'ə ɣ ə s	s 'e ɣ ə s
Ceilan	s ə j l 'a n	s ə i l 'a n
cella	s 'ə ʎ ə	s 'e ʎ ə
celles	s 'ə ʎ ə s	s 'e ʎ ə s
cens	s 'ə n s	s 'e n s
centren	s 'e n t ɾ ə n	s 'ə n t ɾ ə n
centres	s 'e n t ɾ ə s	s 'ə n t ɾ ə s
cèntrica	s 'e n t ɾ i k ə	s ə n t ɾ 'i k ə
cèntriques	s 'e n t ɾ i k ə s	s 'ə n t ɾ i k ə s
centro	s 'e n t ɾ o	s 'ə n t ɾ o
cèrcols	s 'e ɾ k o l s	s ə ɾ k 'o l s
cessen	s 'e s ə n	s 'ə s ə n
ciberespai	s i β ə ɾ ə s p 'a j	s i β ə ɾ ə s p 'a i
ciberespais	s i β ə ɾ ə s p 'a j s	s i β ə ɾ ə s p 'a i s
cilíndrica	s i l 'i n d ɾ i k ə	s i l i n d ɾ 'i k ə
circumcisió	s i ɾ k u n s i z i 'o	s i ɾ k u t s i z i 'o
Cirenaica	s i ɾ ə n 'a j k ə	s i ɾ ə n 'a i k ə
ciutadà	s i w t ə ð 'a	s i w t 'a ð 'a
clavicèmbal	k l ə v i s 'e m b ə l	k l ə v i s 'ə m b ə l
cofoi	k o f 'o j	k o f 'o i
colesteatoma	k o l ə s t e ə t 'o m ə	k o l ə s t ə ə t 'o m ə
colesteatomes	k o l ə s t e ə t 'o m ə s	k o l ə s t ə ə t 'o m ə s
comandaments	k o m ə n d ə m 'e n s	k o m ə n d ə m 'e n t s
comboi	k o m b 'o j	k o m b 'o i
còmplices	k 'o m p l i s ə s	k o m p l 'i s ə s
compten	k 'o m t ə n	k 'o m i t ə n
comtat	k o n t 'a t	k o ə t 'a t
comtats	k o n t 'a t s	k o ə t 'a t s
conduïts	k o n d u 'i t s	k o n d u 'i s
cònjuge	k 'o n ʒ u ʒ ə	k o n ʒ 'u ʒ ə
conquesta	k o ŋ k 'e s t ə	k o ŋ k 'ə s t ə
consciència	k o n t s i 'e n s i ə	k o n s i 'e n s i ə
conscient	k o n t s i 'e n t	k o n s i 'e n t
consell	k o n s 'ə ʎ	k o n s 'e ʎ
consens	k o n s 'ə n s	k o n s 'e n s
consignar	k o n s i n n 'a	k o n s i ə n 'a
cònsols	k 'o n s o l s	k o n s 'o l s
contigu	k o n t 'i ɣ u	k o n t 'i ɣ
contingents	k o n t i n ʒ 'e n s	k o n t i ŋ g 'e n s
contreure	k o n t ɾ 'ə w ɾ ə	k o n t ɾ 'e w ɾ ə
contribuïts	k o n t ɾ i β u 'i t s	k o n t ɾ i β u 'i s
coquessa	k o k 'ə s ə	k o k 'e s ə
coratjosa	k o ɾ ə dʒ 'o z ə	k o ɾ ə dʒ 'o s ə
coreans	k o ɾ e 'a n s	k o ɾ ə 'a n s
córner	k 'o ɾ n ə	k o ɾ n 'e 
corroïts	k o r o 'i t s	k o r o 'i s
corroure	k o r 'o w ɾ ə	k o r o 'u ɾ ə
Cortsaví	k o ɾ t s ə v 'i	k o ɾ s 'a v 'i
costoses	k o s t 'o z ə s	k o s t 'o s ə s
cotxe	k 'o tʃ o	k 'o tʃ ə
courenc	k o w ɾ 'ə ŋ k	k o u ɾ 'ə ŋ k
creador	k ɾ e ə ð 'o	k ɾ ə ə ð 'o
creatiu	k ɾ e ə t 'i w	k ɾ ə ə t 'i w
creatius	k ɾ e ə t 'i w s	k ɾ ə ə t 'i w s
creativa	k ɾ e ə t 'i v ə	k ɾ ə ə t 'i v ə
creatives	k ɾ e ə t 'i v ə s	k ɾ ə ə t 'i v ə s
creient	k ɾ ə j 'e n t	k ɾ ə i 'e n t
creixen	k ɾ 'e ʃ ə n	k ɾ 'ə ʃ ə n
créixer	k ɾ 'e ʃ ə	k ɾ ə ʃ 'e 
crema	k ɾ 'e m ə	k ɾ 'ə m ə
cremen	k ɾ 'e m ə n	k ɾ 'ə m ə n
cremes	k ɾ 'e m ə s	k ɾ 'ə m ə s
creure	k ɾ 'ə w ɾ ə	k ɾ 'e w ɾ ə
cuidada	k u j ð 'a ð ə	k u i ð 'a ð ə
cuidades	k u j ð 'a ð ə s	k u i ð 'a ð ə s
cuidar	k u j ð 'a	k u i ð 'a
cuidares	k u j ð 'a ɾ ə s	k u i ð 'a ɾ ə s
cuidava	k u j ð 'a v ə	k u i ð 'a v ə
cuinada	k u j n 'a ð ə	k u i n 'a ð ə
cuinades	k u j n 'a ð ə s	k u i n 'a ð ə s
cuinar	k u j n 'a	k u i n 'a
cuiner	k u j n 'e	k u i n 'e
cuitada	k u j t 'a ð ə	k u i t 'a ð ə
cuitades	k u j t 'a ð ə s	k u i t 'a ð ə s
cuitar	k u j t 'a	k u i t 'a
cursada	k u ɾ s 'a ð ə	k u ə s 'a ð ə
cursades	k u ɾ s 'a ð ə s	k u ə s 'a ð ə s
daina	d 'a j n ə	d 'a i n ə
dansaire	d ə n s 'a j ɾ ə	d ə n s 'a i ɾ ə
dansaires	d ə n s 'a j ɾ ə s	d ə n s 'a i ɾ ə s
de	d 'ə	d ə
dècada	d 'e k ə ð ə	d ə k 'a ð ə
dècade	d 'e k ə ð ə	d ə k 'a ð ə
dècima	d 'e s i m ə	d ə s i m ə
decréixer	d ə k ɾ 'e ʃ ə	d ə k ɾ ə ʃ 'e 
deduïts	d ə ð u 'i t s	d ə ð u 'i s
deguin	d 'ə ɣ i n	d 'e ɣ i n
deguis	d 'ə ɣ i s	d 'e ɣ i s
deis	d 'ə j s	d 'ə i s
deixeble	d ə ʃ 'e b b l ə	d ə ʃ 'ə b b l ə
delinquits	d ə l i ŋ k 'i t s	d ə l i ŋ k 'i s
dempeus	d ə m p 'e w s	d ə m p ə 'u s
Dénia	d 'e n i ə	d ə n 'i ə
dens	d 'ə n s	d 'e n s
derruïts	d ə r u 'i t s	d ə r u 'i s
desatendre	d ə z ə t 'e n d ɾ ə	d ə z ə t 'ə n d ɾ ə
desembeinar	d ə z ə m b ə j n 'a	d ə z ə m b ə i n 'a
desembre	d ə z 'e m b ɾ ə	d ə z 'ə m b ɾ ə
desesma	d ə z 'ə z m ə	d ə s 'ə z m ə
desfet	d ə s f 'e t	d ə s f 'ə t
desfeta	d ə s f 'e t ə	d ə s f 'ə t ə
desguàs	d ə z ɣ w 'a s	d ə z ɣ 'a s
desig	d ə z 'i tʃ	d ə z 'i ə
designada	d ə z i n n 'a ð ə	d ə z i ə n 'a ð ə
designades	d ə z i n n 'a ð ə s	d ə z i ə n 'a ð ə s
designar	d ə z i n n 'a	d ə z i ə n 'a
designat	d ə z i n n 'a t	d ə z i ə n 'a t
designats	d ə z i n n 'a t s	d ə z i ə n 'a t s
desigs	d ə z 'i tʃ s	d ə z 'i n s
desmai	d ə z m 'a j	d ə z m 'a i
deso	d 'e z o	d 'ə z o
desobeïts	d ə z o β ə 'i t s	d ə z o β ə 'i s
destituïts	d ə s t i t u 'i t s	d ə s t i t u 'i s
destra	d 'e s t ɾ ə	d 'ə s t ɾ ə
destres	d 'e s t ɾ ə s	d 'ə s t ɾ ə s
destruïts	d ə s t ɾ u 'i t s	d ə s t ɾ u 'i s
deure	d 'ə w ɾ ə	d 'e w ɾ ə
diamants	d i ə m 'a n s	d i ə m 'a n t s
dièsel	d i 'ə z ə l	d i 'ə s ə l
difoses	d i f 'o z ə s	d i f 'o s ə s
dijous	d i ʒ 'o w s	d i ʒ o 'u s
dionisíac	d i o n i z 'i ə k	d i o n i s 'i ə k
dírham	d 'i ɾ ə m	d i ɾ 'a m
dismenorrea	d i z m ə n o r 'e ə	d i z m ə n 'o r 'e ə
distendre	d i s t 'e n d ɾ ə	d i s t 'ə n d ɾ ə
distingida	d i s t i n ʒ 'i ð ə	d i s t i ŋ g 'i ð ə
distingir	d i s t i n ʒ 'i	d i s t i ŋ g 'i
distingit	d i s t i n ʒ 'i t	d i s t i ŋ g 'i t
distingits	d i s t i n ʒ 'i t s	d i s t i ŋ g 'i t s
distreta	d i s t ɾ 'e t ə	d i s t ɾ 'ə t ə
distreure	d i s t ɾ 'ə w ɾ ə	d i s t ɾ 'e w ɾ ə
distribuïts	d i s t ɾ i β u 'i t s	d i s t ɾ i β u 'i s
dividend	d i v i ð 'e n t	d i v i ð 'ə n t
Djibouti	dʒ i β 'o w t i	d ʒ i β o 'u t i
dodecàedre	d o ð ə k 'a ə ð ɾ ə	d o ð ə t s ə ð ɾ ə
dòlar	d 'o l ə	d o l 'a
dolçaina	d o l s 'a j n ə	d o l s 'a i n ə
doler	d o l 'ə	d o l 'e
domtà	d o n t 'a	d o m 'a
dreces	d ɾ 'ə s ə s	d ɾ 'e s ə s
Ebre	'e β ɾ ə	'ə β ɾ ə
ebri	'e β ɾ i	'ə β ɾ i
eclipsa	ə k l 'i t s ə	ə k l 'i s ə
ecosistema	ə k o s i s t 'e m ə	ə k o z i s t 'ə m ə
Eduard	ə ð u 'a ɾ t	ə ð u 'a ɾ ə
efectuats	ə f ə t t u 'a t s	ə f ə t t u 'a s
ègida	'ə ʒ i ð ə	'e ʒ i ð ə
ego	'e ɣ o	'ə ɣ o
Eivissa	ə j v 'i s ə	ə i v 'i s ə
eixe	'e ʃ ə	'ə ʃ ə
ele	'e l ə	'ə l ə
elèctric	ə l 'ə t t ɾ i k	ə l 'e t t ɾ i k
elèctrica	ə l 'ə t t ɾ i k ə	ə l ə t t ɾ 'i k ə
elèctrics	ə l 'ə t t ɾ i t s	ə l ə t t ɾ 'i t s
elèctriques	ə l 'ə t t ɾ i k ə s	ə l 'e t t ɾ i k ə s
elèctrode	ə l 'ə t t ɾ o ð ə	ə l 'e t t ɾ o ð ə
eles	'e l ə s	'ə l ə s
Eloi	ə l 'o j	ə l 'o i
eloqüent	ə l o k w 'e n t	ə l o ə w 'e n t
elusiu	ə l u z 'i w	e l u z 'i w
elusius	ə l u z 'i w s	e l u z 'i w s
elusiva	ə l u z 'i v ə	e l u z 'i v ə
elusives	ə l u z 'i v ə s	e l u z 'i v ə s
elxans	ə l ʃ 'a n s	ə ʃ 'a n s
em	'ə m	ə m
emblema	ə m b l 'e m ə	ə m b l 'ə m ə
emboirar	ə m b o j ɾ 'a	ə m b o i ɾ 'a
emfisema	ə m f i z 'e m ə	ə m f i z 'ə m ə
empaitar	ə m p ə j t 'a	ə m p ə i t 'a
empènyer	ə m p 'ə ɲ ə	ə m p ə ɲ 'e 
empiema	ə m p i 'e m ə	ə m p i 'ə m ə
empleat	ə m p l e 'a t	ə m p l ə 'a t
empra	'e m p ɾ ə	'ə m p ɾ ə
empren	'e m p ɾ ə n	'ə m p ɾ ə n
ena	'e n ə	'ə n ə
encendre	ə n s 'e n d ɾ ə	ə n s 'ə n d ɾ ə
ene	'e n ə	'ə n ə
enlairament	ə n l ə j ɾ ə m 'e n t	ə n l ə i ɾ ə m 'e n t
enlletgir	ə n ʎ ə dʒ 'i	ə n ʎ ə tʃ 'i
enmig	ə m m 'i tʃ	ə n m 'i k
enquesta	ə ŋ k 'e s t ə	ə ŋ k 'ə s t ə
ensems	ə n s 'e n s	ə n s 'ə n s
entelèquia	ə n t e l 'ə k i ə	ə n t ə l 'e k i ə
entendre	ə n t 'e n d ɾ ə	ə n t 'ə n d ɾ ə
entren	'e n t ɾ ə n	'ə n t ɾ ə n
entres	'e n t ɾ ə s	'ə n t ɾ ə s
entro	'e n t ɾ o	'ə n t ɾ o
epicens	ə p i s 'ə n s	ə p i s 'e n s
epifonema	ə p i f o n 'e m ə	ə p i f o n 'ə m ə
èpsilon	'ə t s i l o n	e t s i l 'o n
eqüestre	ə k w 'e s t ɾ ə	ə k w 'ə s t ɾ ə
equivaler	ə k i v ə l 'ə	ə k i v ə l 'e
erèctil	ə ɾ 'ə t t i l	ə ɾ 'e t t i l
escaguitxar	ə s k ə ɣ i tʃ 'a	ə s k ə ɣ i t ə 'a
escairar	ə s k ə j ɾ 'a	ə s k ə i ɾ 'a
escairat	ə s k ə j ɾ 'a t	ə s k ə i ɾ 'a t
escairats	ə s k ə j ɾ 'a t s	ə s k ə i ɾ 'a t s
escalens	ə s k ə l 'ə n s	ə s k ə l 'e n s
escàner	ə s k 'a n ə	ə s k 'a n e 
escarabeu	ə s k ə ɾ ə β 'e w	ə s k ə ɾ ə β 'ə w
escèptic	ə t s 'ə t t i k	ə t s 'e t t i k
escèptica	ə t s 'ə t t i k ə	ə t s 'e t t i k ə
escèptics	ə t s 'ə t t i t s	ə t s 'e t t i t s
escèptiques	ə t s 'ə t t i k ə s	ə t s 'e t t i k ə s
escletxa	ə s k l 'e tʃ ə	ə s k l 'ə tʃ ə
escombriaire	ə s k o m b ɾ i 'a j ɾ ə	ə s k o m b ɾ i ə 'i ɾ ə
esfilagarsada	ə s f i l ə ɣ ə ɾ s 'a ð ə	ə s f i l ə ɣ ə s 'a ð ə
esfilagarsades	ə s f i l ə ɣ ə ɾ s 'a ð ə s	ə s f i l ə ɣ ə s 'a ð ə s
esfilagarsar	ə s f i l ə ɣ ə ɾ s 'a	ə s f i l ə ɣ ə s 'a
esglai	ə z ɣ l 'a j	ə z ə l 'a i
esgüellar	ə z g w ə ʎ 'a	ə z ɣ e ə ʎ 'a
esguerro	ə z ɣ 'e r o	ə z ɣ u 'e r o
esment	ə z m 'e n t	e z m 'e n t
esmorteïts	ə z m o ɾ t ə 'i t s	ə z m o ɾ t ə 'i s
espagueti	ə s p ə ɣ 'e t i	ə s p ə ɣ u 'e t i
espai	ə s p 'a j	ə s p 'a i
espais	ə s p 'a j s	ə s p 'a i s
espècia	ə s p 'ə s i ə	ə s p 'e s i ə
espècie	ə s p 'ə s i ə	ə s p 'e s i ə
espècimen	ə s p 'ə s i m ə n	ə s p 'e s i m ə n
espinavessa	ə s p i n ə v 'ə s ə	ə s p i n ə v 'e s ə
esplai	ə s p l 'a j	ə s p l 'a i
esplèndid	ə s p l 'ə n d i t	ə s p l 'e n d i t
esplèndida	ə s p l 'ə n d i ð ə	ə s p l 'e n d i ð ə
esplèndides	ə s p l 'ə n d i ð ə s	ə s p l 'e n d i ð ə s
esplèndids	ə s p l 'ə n d i t s	ə s p l 'e n d i t s
espondilodiscitis	ə s p o n d i l o ð i t s 'i t i s	ə s p o n d i l o ð 'i z s 'i t i s
esprémer	ə s p ɾ 'e m ə	ə s p ɾ ə m 'e 
esquetx	ə s k 'e tʃ	ə s k 'ə tʃ
essa	'ə s ə	'e s ə
esser	ə s 'ə	ə s 'e
esta	'e s t ə	'ə s t ə
estai	ə s t 'a j	ə s t 'a i
estendre	ə s t 'e n d ɾ ə	ə s t 'ə n d ɾ ə
estèpic	ə s t 'ə p i k	ə s t 'e p i k
estèpica	ə s t 'ə p i k ə	ə s t 'e p i k ə
estèpics	ə s t 'ə p i t s	ə s t 'e p i t s
estèpiques	ə s t 'ə p i k ə s	ə s t 'e p i k ə s
estiuats	ə s t i w 'a t s	ə s t i w 'a s
estoig	ə s t 'o tʃ	ə s t o 'i ə
estómac	ə s t 'o m ə k	ə s t o m 'a k
estranger	ə s t ɾ ə n ʒ 'e	ə s t ɾ ə ŋ g 'e
estratagema	ə s t ɾ ə t ə ʒ 'e m ə	ə s t ɾ ə t ə ʒ 'ə m ə
estrateg	ə s t ɾ ə t 'e k	ə s t ɾ ə t 'ə ʒ
estrènyer	ə s t ɾ 'ə ɲ ə	ə s t ɾ ə ɲ 'e 
ètnia	'e n n i ə	'ə n n i ə
eucaliptus	ə w k ə l 'i t t u s	ə w k ə l i t t 'u s
exceptuats	ə t s ə t t u 'a t s	ə t s ə t t u 'a s
Èxode	'e t s o ð ə	'ə t s o ð ə
èxode	'e t s o ð ə	'ə t s o ð ə
Fàbregas	f 'a β ɾ ə ɣ ə s	f ə β ɾ ə ɣ 'a s
fauna	f 'a w n ə	f ə 'u n ə
faune	f 'a w n ə	f ə 'u n ə
febre	f 'e β ɾ ə	f 'ə β ɾ ə
febres	f 'e β ɾ ə s	f 'ə β ɾ ə s
feinada	f ə j n 'a ð ə	f ə i n 'a ð ə
feinejar	f ə j n ə ʒ 'a	 f e i n ə ʒ 'a
feiner	f ə j n 'e	f ə i n 'e
fen	f 'e n	f 'ə n
fens	f 'ə n s	f 'e n s
Fes	f 'e s	f 'ə s
festa	f 'e s t ə	f 'ə s t ə
festaire	f ə s t 'a j ɾ ə	f ə s t 'a i ɾ ə
festes	f 'e s t ə s	f 'ə s t ə s
feta	f 'e t ə	f 'ə t ə
fetes	f 'e t ə s	f 'ə t ə s
fetge	f 'e dʒ ə	f 'ə dʒ ə
feyen	f 'ə j ə n	f ɲ ə n
fímbria	f 'i m b ɾ i ə	f i m b ɾ 'i ə
finestra	f i n 'e s t ɾ ə	f i n 'ə s t ɾ ə
flairar	f l ə j ɾ 'a	f l ə i ɾ 'a
flairat	f l ə j ɾ 'a t	f l ə i ɾ 'a t
flairats	f l ə j ɾ 'a t s	f l ə i ɾ 'a t s
fleca	f l 'e k ə	f l 'ə k ə
fletxa	f l 'e tʃ ə	f l 'ə tʃ ə
fletxes	f l 'e tʃ ə s	f l 'ə tʃ ə s
fonema	f o n 'e m ə	f o n 'ə m ə
formatget	f o ɾ m ə dʒ 'ə t	f o ɾ m ə tʃ 'ə t
fotovoltaiques	f o t o v o l t 'a j k ə s	f o t o v o l t 'a i k ə s
franctirador	f ɾ ə ŋ t t i ɾ ə ð 'o	f ɾ ə n s t i ɾ ə ð 'o
frecs	f ɾ 'e t s	f ɾ 'ə t s
fregapeus	f ɾ ə ɣ ə p 'e w s	f ɾ ə ɣ ə p ə 'u s
frenen	f ɾ 'e n ə n	f ɾ 'ə n ə n
frens	f ɾ 'ə n s	f ɾ 'e n s
fresi	f ɾ 'e z i	f ɾ 'ə z i
fresis	f ɾ 'e z i s	f ɾ 'ə z i s
fressin	f ɾ 'ə s i n	f ɾ 'e s i n
fúmer	f 'u m ə	f u m 'e 
gaia	g 'a j ə	g 'a i ə
gaiata	g ə j 'a t ə	g ə i 'a t ə
gaiato	g ə j 'a t o	g ə i 'a t o
gaies	g 'a j ə s	g 'a i ə s
gaire	g 'a j ɾ ə	g 'a i ɾ ə
gaires	g 'a j ɾ ə s	g 'a i ɾ ə s
gaita	g 'a j t ə	g 'a i t ə
gaiter	g ə j t 'e	g ə i t 'e
galindaina	g ə l i n d 'a j n ə	g ə l i n d 'a i n ə
galindaines	g ə l i n d 'a j n ə s	g ə l i n d 'a i n ə s
garriguenc	g ə r i ɣ 'ə ŋ k	g ə r i ɣ u 'e ŋ k
gasoil	g ə z 'o j l	g ə z o 'i l
gemma	ʒ 'e m m ə	ʒ 'ə m m ə
Gemma	ʒ 'e m m ə	ʒ 'ə m m ə
gemmes	ʒ 'e m m ə s	ʒ 'ə m m ə s
gènere	ʒ 'e n ə ɾ ə	ʒ 'ə n ə ɾ ə
Gènesi	ʒ 'e n ə z i	ʒ 'ə n ə z i
gènesi	ʒ 'e n ə z i	ʒ 'ə n ə z i
genísser	ʒ ə n 'i s ə	ʒ ə n i s 'e 
gespa	ʒ 'e s p ə	ʒ 'ə s p ə
gest	ʒ 'e s t	ʒ 'ə s t
gesta	ʒ 'e s t ə	ʒ 'ə s t ə
gesten	ʒ 'ə s t ə n	ʒ 'e s t ə n
gesto	ʒ 'ə s t o	ʒ 'e s t o
gimcana	ʒ i ŋ k 'a n ə	ʒ i m k 'a n ə
ginebra	ʒ i n 'e β ɾ ə	ʒ i n 'ə β ɾ ə
Ginebra	ʒ i n 'e β ɾ ə	ʒ i n 'ə β ɾ ə
ginesta	ʒ i n 'e s t ə	ʒ i n 'ə s t ə
girientorn	ʒ i ɾ i ə n t 'o n	ʒ i ɾ i ə n t 'o ɾ n
goècia	g o 'e s i ə	g o t s i ə
gorg	g 'o ɾ k	g 'o ɾ ə
grandiosa	g ɾ ə n d i 'o z ə	g ɾ ə n d i 'o s ə
gratuïts	g ɾ ə t u 'i t s	g ɾ ə t u 'i s
gregues	g ɾ 'ə ɣ ə s	g ɾ 'e ɣ ə s
guaiaba	g w ə j 'a β ə	g w ə i 'a β ə
guaita	g w 'a j t ə	g w ə 'i t ə
guaità	g w ə j t 'a	g w ə i t 'a
guaitar	g w ə j t 'a	g w ə i t 'a
guaitat	g w ə j t 'a t	g w ə i t 'a t
guaito	g w 'a j t o	g w 'a i t o
guatla	g w 'a l l ə	g w 'a t l ə
guèiser	g 'e j z ə	g 'ə i z ə
guerra	g 'e r ə	g w 'e r ə
guerxa	g 'e ɾ ʃ ə	g w 'e ɾ ʃ ə
guerxo	g 'e ɾ ʃ o	g w 'e ɾ ʃ o
guia	g 'i ə	g w 'i ə
guilla	g 'i ʎ ə	g w 'i ʎ ə
guinda	g 'i n d ə	g w 'i n d ə
guio	g 'i o	g w 'i o
guitza	g 'i d z ə	g w 'i d z ə
Gujarat	g u ʒ ə ɾ 'a t	g w ʒ ə ɾ 'a t
gujarati	g u ʒ ə ɾ 'a t i	g w ʒ ə ɾ 'a t i
gustatiu	g u s t ə t 'i w	g w s t ə t 'i w
gustatori	g u s t ə t 'o ɾ i	g w s t ə t 'o ɾ i
hàbitat	'a β i t ə t	a β i t 'a t
hàbitats	'a β i t ə t s	a β i t 'a t s
Hades	'a ð ə s	i 'a ð ə s
haguda	ə ɣ 'u ð ə	a ɣ 'u ð ə
hagudes	ə ɣ 'u ð ə s	a ɣ 'u ð ə s
hagut	ə ɣ 'u t	a ɣ 'u t
haguts	ə ɣ 'u t s	a ɣ 'u t s
Haia	'a j ə	a 'i ə
Hainan	ə j n 'a n	ə i n 'a n
Hainaut	ə j n 'a w t	ə i n ə 'u t
haver	ə v 'ə	ə v 'e
hebraic	ə β ɾ 'a j k	ə β ɾ 'a i k
Hècate	'e k ə t ə	e k 'a t ə
helicotrema	ə l i k o t ɾ 'e m ə	ə l i k o t ɾ 'ə m ə
Hèrcules	'e ɾ k u l ə s	ə ɾ k u l ə s
heroi	ə ɾ 'o j	ə ɾ 'o i
heroic	ə ɾ 'o j k	ə ɾ o 'i k
hèrptil	'e ɾ t t i l	e ɾ t t 'i l
heura	'e w ɾ ə	ə 'u ɾ ə
heure	'ə w ɾ ə	ə 'u ɾ ə
heus	'e w s	e 'u s
híbrid	'i β ɾ i t	ə β ɾ i t
hidroelèctrica	i ð ɾ o ə l 'e t t ɾ i k ə	i ð ɾ o ə l ə t t ɾ 'i k ə
hidroelèctrics	i ð ɾ o ə l 'e t t ɾ i t s	i ð ɾ o ə l ə t t ɾ 'i t s
hieràtic	j ə ɾ 'a t i k	i ə ɾ 'a t i k
hieràtics	j ə ɾ 'a t i t s	i ə ɾ 'a t i t s
higiene	i ʒ i 'e n ə	i ʒ i 'ə n ə
hipèrbaton	i p 'e ɾ β ə t o n	i p ə ɾ β ə t 'o n
hiperespai	i p ə ɾ ə s p 'a j	i p ə ɾ ə s p 'a i
hiperespais	i p ə ɾ ə s p 'a j s	i p ə ɾ ə s p 'a i s
home	'o m o	'o m ə
homes	'o m ə s	ə m ə s
hora	'o ɾ ə	ə ɾ ə
hores	'o ɾ ə s	ə ɾ ə s
hort	'o ɾ t	ə ɾ t
horta	'o ɾ t ə	ə ɾ t ə
hortènsia	o ɾ t 'e n s i ə	o ɾ t 'ə n s i ə
i	'i	i
iaia	j 'a j ə	i 'a j ə
iaies	j 'a j ə s	i 'a j ə s
iaio	j 'a j o	i 'a i o
iarda	j 'a ɾ ð ə	i 'a ɾ ð ə
idealisme	i ð e ə l 'i z m ə	i ð ə ə l 'i z m ə
idealista	i ð e ə l 'i s t ə	i ð ə ə l 'i s t ə
iemenita	j ə m ə n 'i t ə	i ə m ə n 'i t ə
immens	i m m 'ə n s	i m m 'e n s
imparell	i m p ə ɾ 'ə ʎ	i m p ə ɾ 'e ʎ
impermeable	i m p ə ɾ m e 'a b b l ə	i m p ə ɾ ə e 'a b b l ə
impermeables	i m p ə ɾ m e 'a b b l ə s	i m p ə ɾ ə e 'a b b l ə s
ímpetu	'i m p ə t u	i m p 'ə t 'u
indignada	i n d i n n 'a ð ə	i n d i ə n 'a ð ə
indignades	i n d i n n 'a ð ə s	i n d i ə n 'a ð ə s
indignar	i n d i n n 'a	i n d i ə n 'a
indistingible	i n d i s t i n ʒ 'i b b l ə	i n d i s t i ŋ g 'i b b l ə
indústria	i n d 'u s t ɾ i ə	i n d u s t ɾ 'i ə
ingent	i n ʒ 'e n t	i ŋ g 'e n t
ininterromput	i n i n t ə r o m p 'u t	i n i n t ə r 'o m p 'u t
insubstancial	i n s u p s t ə n s i 'a l	i n s u t s t ə n s i 'a l
intens	i n t 'ə n s	i n t 'e n s
intèrpret	i n t 'e ɾ p ɾ ə t	i n t ə ɾ p ɾ 'ə t
introduïts	i n t ɾ o ð u 'i t s	i n t ɾ o ð u 'i s
iònica	j 'o n i k ə	i 'o n i k ə
irremeiable	i r ə m ə j 'a b b l ə	i r ə m ə i 'a b b l ə
isòbar	i z 'o β ə	i z o β 'a
Ístria	'i s t ɾ i ə	i s t ɾ 'i ə
Iugoslàvia	j u ɣ o z l 'a v i ə	i w ɣ o z l 'a v i ə
jamai	ʒ ə m 'a j	ʒ ə m 'a i
jaquits	ʒ ə k 'i t s	ʒ ə k 'i s
jazz	ʒ 'a s	ʒ 'a z ə
jersei	ʒ ə ɾ s 'ə j	ʒ ə ɾ s 'ə i
Jesús	ʒ ə z 'u s	ʒ ə s 'u s
jeure	ʒ 'ə w ɾ ə	ʒ 'e w ɾ ə
joiós	ʒ o j 'o s	ʒ o i 'o s
jou	ʒ 'o w	ʒ 'o
jóvens	ʒ 'o v ə n s	ʒ o v 'e n s
juntaire	ʒ u n t 'a j ɾ ə	ʒ u n t 'a i ɾ ə
júnyer	ʒ 'u ɲ ə	ʒ u ɲ 'e 
kàiser	k 'a j z ə	k 'a i z ə
Kuwait	k u β 'a j t	k u β 'a i t
la	l 'ə	l ə
laiques	l 'a j k ə s	l 'a i k ə s
làser	l 'a z ə	l 'a z e 
lepra	l 'e p ɾ ə	l 'ə p ɾ ə
les	l 'ə s	l ə s
lèxica	l 'e t s i k ə	l 'ə t s i k ə
lèxiques	l 'e t s i k ə s	l 'ə t s i k ə s
líber	l 'i β ə	l 'i β e 
líder	l 'i ð ə	l 'i ð e 
linear	l i n e 'a	l i n ə 'a
liquar	l i k w 'a	l i k 'a
liquidàmbar	l i k i ð 'a m b ə	l i k i ð ə m b 'a
llarg	ʎ 'a ɾ k	ʎ 'a ɾ ə
llauna	ʎ 'a w n ə	ʎ ə 'u n ə
llebre	ʎ 'e β ɾ ə	ʎ 'ə β ɾ ə
llega	ʎ 'e ɣ ə	ʎ 'ə ɣ ə
Lleida	ʎ 'e j ð ə	ʎ 'ə j ð ə
lleixa	ʎ 'e ʃ ə	ʎ 'ə ʃ ə
llenci	ʎ 'e n s i	ʎ 'ə n s i
llencin	ʎ 'e n s i n	ʎ 'ə n s i n
llencis	ʎ 'e n s i s	ʎ 'ə n s i s
llenya	ʎ 'e ɲ ə	ʎ 'ə ɲ ə
llepa	ʎ 'e p ə	ʎ 'ə p ə
llepen	ʎ 'e p ə n	ʎ 'ə p ə n
llesta	ʎ 'e s t ə	ʎ 'ə s t ə
llestes	ʎ 'e s t ə s	ʎ 'ə s t ə s
llestos	ʎ 'e s t o s	ʎ 'ə s t o s
lletges	ʎ 'e dʒ ə s	ʎ 'ə dʒ ə s
lletja	ʎ 'e dʒ ə	ʎ 'ə dʒ ə
lletjos	ʎ 'e dʒ o s	ʎ 'ə dʒ o s
lletsó	ʎ ə t s 'o	ʎ ə s 'o
lleva	ʎ 'e v ə	ʎ 'ə v ə
lleves	ʎ 'e v ə s	ʎ 'ə v ə s
llevo	ʎ 'e v o	ʎ 'ə v o
Llorach	ʎ o ɾ 'a k	ʎ o ɾ 'a k ə
lluitada	ʎ u j t 'a ð ə	ʎ u i t 'a ð ə
lluitades	ʎ u j t 'a ð ə s	ʎ u i t 'a ð ə s
lluitant	ʎ u j t 'a n t	ʎ u i t 'a n t
lluitar	ʎ u j t 'a	ʎ u i t 'a
lòbuls	l 'o β u l s	l o β 'u l s
loquaces	l o k w 'a s ə s	l o k 'a s ə s
luxe	l 'u t s ə	l 'u ʃ ə
ma	m 'ə	m ə
madeixa	m ə ð 'e ʃ ə	m ə ð 'ə ʃ ə
Mahoma	m ə 'o m ə	m ə o m ə
mainada	m ə j n 'a ð ə	m ə i n 'a ð ə
malai	m ə l 'a j	m ə l 'a i
malais	m ə l 'a j s	m ə l 'a i s
Malàisia	m ə l 'a j z i ə	m ə l 'a i z i ə
Malawi	m ə l 'a β i	m ə l 'a i
maleïts	m ə l ə 'i t s	m ə l ə 'i s
maliciosa	m ə l i s i 'o z ə	m ə l i s i 'o s ə
malicioses	m ə l i s i 'o z ə s	m ə l i s i 'o s ə s
maliciosos	m ə l i s i 'o z o s	m ə l i s i 'o s o s
mallerenga	m ə ʎ ə ɾ 'ə ŋ g ə	m ə ʎ ə ɾ 'e ŋ g ə
malvendre	m ə l v 'e n d ɾ ə	m ə l v 'ə n d ɾ ə
malveure	m ə l v 'ə w ɾ ə	m ə l v 'e w ɾ ə
manifest	m ə n i f 'e s t	m ə n i f 'ə s t
manlleuta	m ə n ʎ 'e w t ə	m ə n ʎ ə 'u t ə
manxiula	m ə n ʃ 'i w l ə	m ə n ʃ 'i u l ə
màrqueting	m 'a ɾ k ə t i ŋ k	m ə ɾ k ə t 'i ŋ k
màser	m 'a z ə	m 'a z e 
mastegaparaules	m ə s t ə ɣ ə p ə ɾ 'a w l ə s	m ə s t ə ɣ ə p ə ɾ ə 'u l ə s
mastegatatxes	m ə s t ə ɣ ə t 'a tʃ ə s	m ə s t ə ɣ ə t 'a t ə s
matusser	m ə t u s 'e	m ə t 'u s 'e
me	m 'ə	m ə
meandre	m e 'a n d ɾ ə	ə e 'a n d ɾ ə
meitat	m ə j t 'a t	m ə i t 'a t
melangia	m ə l ə n ʒ 'i ə	m ə l ə ŋ g 'i ə
membre	m 'e m b ɾ ə	m 'ə m b ɾ ə
membres	m 'e m b ɾ ə s	m 'ə m b ɾ ə s
menja	m 'e n ʒ ə	m 'ə n ʒ ə
menjo	m 'e n ʒ o	m 'ə n ʒ o
mènsula	m 'e n s u l ə	m 'ə n s u l ə
mènsules	m 'e n s u l ə s	m 'ə n s u l ə s
metge	m 'e dʒ ə	m 'ə dʒ ə
metges	m 'e dʒ ə s	m 'ə dʒ ə s
mètode	m 'e t o ð ə	m 'ə t o ð ə
metxa	m 'e tʃ ə	m 'ə tʃ ə
meua	m 'e w ə	m 'ə w ə
meus	m 'e w s	m 'ə w s
meva	m 'e v ə	m 'ə v ə
meves	m 'e v ə s	m 'ə v ə s
migcampista	m i k k ə m p 'i s t ə	m i ŋ k ə m p 'i s t ə
miositis	m i o z 'i t i s	m i o s 'i t i s
misàndria	m i z 'a n d ɾ i ə	m i z ə n d ɾ 'i ə
Moisès	m o j z 'ə s	m o i s 'ə s
molts	m 'o l s	m 'o l t s
monàrquica	m o n 'a ɾ k i k ə	m o n ə ɾ k 'i k ə
monàrquics	m o n 'a ɾ k i t s	m o n ə ɾ k 'i t s
montrealès	m o n t ɾ e ə l 'ə s	m o n t ɾ ə ə l 'ə s
Montse	m 'o n s ə	m 'o n t s ə
Montseny	m o n s 'ə ɲ	m o n t s 'ə ɲ
monyeca	m o ɲ 'e k ə	m o ɲ 'ə k ə
mosaic	m o z 'a j k	m o z 'a i k
mossegaire	m o s ə ɣ 'a j ɾ ə	m o s ə ɣ ə 'i ɾ ə
motlura	m o ʎ ʎ 'u ɾ ə	m o l l 'u ɾ ə
mudèjar	m u ð 'e ʒ ə	m u ð ə ʒ 'a
múrgola	m 'u ɾ ɣ o l ə	m u ɾ ɣ 'o l ə
nàufrag	n 'a w f ɾ ə k	n ə w f ɾ 'a k
nauseabund	n ə w z e ə β 'u n t	n ə w z ə ə β 'u n t
nauseabunda	n ə w z e ə β 'u n d ə	n ə w z ə ə β 'u n d ə
nauseabundes	n ə w z e ə β 'u n d ə s	n ə w z ə ə β 'u n d ə s
nauseabunds	n ə w z e ə β 'u n s	n ə w z ə ə β 'u n s
nàxer	n 'a t s ə	n 'a t s e 
neda	n 'e ð ə	n 'ə ð ə
neden	n 'e ð ə n	n 'ə ð ə n
nedes	n 'e ð ə s	n 'ə ð ə s
nega	n 'e ɣ ə	n 'ə ɣ ə
néixer	n 'e ʃ ə	n ə ʃ 'e 
Nèmesi	n 'e m ə z i	n 'ə m ə z i
nens	n 'ə n s	n 'e n s
neulir	n ə w l 'i	n ə u l 'i
neva	n 'e v ə	n 'ə v ə
nicens	n i s 'ə n s	n i s 'e n s
noieta	n o j 'ə t ə	n o i 'ə t ə
noucentisme	n o w s ə n t 'i z m ə	n o u s ə n t 'i z m ə
nouguerola	n o w ɣ ə ɾ 'o l ə	n o u ɣ ə ɾ 'o l ə
novembre	n o v 'e m b ɾ ə	n o v 'ə m b ɾ ə
noya	n 'o j ə	n 'o ə
oasi	o 'a z i	o 'a s i
obeïts	o β ə 'i t s	o β ə 'i s
obliquar	o β l i k w 'a	o β l i k 'a
obstacle	o p s t 'a k l ə	o t s t 'a k l ə
obstinació	o p s t i n ə s i 'o	o t s t i n ə s i 'o
obstruïda	o p s t ɾ u 'i ð ə	o t s t ɾ u 'i ð ə
obstruïdes	o p s t ɾ u 'i ð ə s	o t s t ɾ u 'i ð ə s
ofego	o f 'ə ɣ o	o f 'e ɣ o
ofegues	o f 'ə ɣ ə s	o f 'e ɣ ə s
ofèn	o f 'ə n	o f 'e n
oidà	o j ð 'a	o i ð 'a
oïts	o 'i t s	o 'i s
oligàrquica	o l i ɣ 'a ɾ k i k ə	o l i ɣ ə ɾ k 'i k ə
oligàrquics	o l i ɣ 'a ɾ k i t s	o l i ɣ ə ɾ k 'i t s
orella	o ɾ 'ə ʎ ə	o ɾ 'e ʎ ə
orenga	o ɾ 'ə ŋ g ə	o ɾ 'e ŋ g ə
Òscar	'o s k ə	o s k 'a
òstria	'o s t ɾ i ə	o s t ɾ 'i ə
ou	'o w	'o
ovella	o v 'ə ʎ ə	o v 'e ʎ ə
ovelles	o v 'ə ʎ ə s	o v 'e ʎ ə s
paio	p 'a j o	p 'a i o
pairal	p ə j ɾ 'a l	p ə i ɾ 'a l
paisatge	p ə j z 'a dʒ ə	p ə i z 'a dʒ ə
païts	p ə 'i t s	p ə 'i s
Pakistan	p ə k i s t 'a n	p ə z i s t 'a n
pakistanès	p ə k i s t ə n 'ə s	p ə z i s t ə n 'ə s
pakistanesa	p ə k i s t ə n 'ə z ə	p ə z i s t ə n 'ə z ə
pakistaneses	p ə k i s t ə n 'ə z ə s	p ə z i s t ə n 'ə z ə s
pakistanesos	p ə k i s t ə n 'ə z o s	p ə z i s t ə n 'ə z o s
palaí	p ə l ə 'i	p ə l 'a
papagai	p ə p ə ɣ 'a j	p ə p ə ɣ 'a i
papiroflèxia	p ə p i ɾ o f l 'e t s i ə	p ə p i ɾ o f l 'ə t s i ə
paranoic	p ə ɾ ə n 'o j k	p ə ɾ ə n o 'i k
paraula	p ə ɾ 'a w l ə	p ə ɾ ə 'u l ə
parell	p ə ɾ 'ə ʎ	p ə ɾ 'e ʎ
parella	p ə ɾ 'ə ʎ ə	p ə ɾ 'e ʎ ə
parènquima	p ə ɾ 'ə ŋ k i m ə	p ə ɾ ə ŋ k 'i m ə
parer	p ə ɾ 'ə	p ə ɾ 'e
parisenc	p ə ɾ i z 'ə ŋ k	p ə ɾ i s 'ə ŋ k
parlotaire	p ə ɾ l o t 'a j ɾ ə	p ə ɾ l o t 'a i ɾ ə
pàrquing	p 'a ɾ k i ŋ k	p ə ɾ k 'i ŋ k
pasqüeta	p ə s k w 'ə t ə	p ə z ə w 'ə t ə
patogènesi	p ə t o ʒ 'e n ə z i	p ə t o ʒ 'ə n ə z i
peatge	p e 'a dʒ ə	p ə 'a dʒ ə
pedra	p 'e ð ɾ ə	p 'ə ð ɾ ə
pedres	p 'e ð ɾ ə s	p 'ə ð ɾ ə s
pego	p 'e ɣ o	p 'ə ɣ o
péixer	p 'e ʃ ə	p ə ʃ 'e 
peixos	p 'e ʃ o s	p 'ə ʃ o s
pèl	p 'ə l	p 'e l
penetra	p ə n 'e t ɾ ə	p ə n 'ə t ɾ ə
penja	p 'e n ʒ ə	p 'ə n ʒ ə
pens	p 'ə n s	p 'e n s
pèr	p 'e	p 'ə
pera	p 'ə ɾ ə	p 'e ɾ ə
peres	p 'ə ɾ ə s	p 'e ɾ ə s
perilloses	p ə ɾ i ʎ 'o z ə s	p ə ɾ i ʎ 'o s ə s
peritoneal	p ə ɾ i t o n e 'a l	p ə ɾ i t o n ə 'a l
peritoneals	p ə ɾ i t o n e 'a l s	p ə ɾ i t o n ə 'a l s
peritoneus	p ə ɾ i t o n 'e w s	p ə ɾ i t o n ə 'u s
permeable	p ə ɾ m e 'a b b l ə	p ə ɾ ə e 'a b b l ə
permeables	p ə ɾ m e 'a b b l ə s	p ə ɾ ə e 'a b b l ə s
perpetu	p ə ɾ p 'e t u	p ə ɾ p 'ə t u
perpetuats	p ə ɾ p ə t u 'a t s	p ə ɾ p ə t u 'a s
perseguits	p ə ɾ s ə ɣ 'i t s	p ə ɾ s ə ɣ 'i s
persignada	p ə ɾ s i n n 'a ð ə	p ə ɾ s i ə n 'a ð ə
persignades	p ə ɾ s i n n 'a ð ə s	p ə ɾ s i ə n 'a ð ə s
persignar	p ə ɾ s i n n 'a	p ə ɾ s i ə n 'a
persignat	p ə ɾ s i n n 'a t	p ə ɾ s i ə n 'a t
persignats	p ə ɾ s i n n 'a t s	p ə ɾ s i ə n 'a t s
persuasiu	p ə ɾ s u ə z 'i w	p ə ɾ s u ə s 'i w
pertànyer	p ə ɾ t 'a ɲ ə	p ə ɾ t 'a ɲ e 
pesa	p 'e z ə	p 'ə z ə
pesen	p 'e z ə n	p 'ə z ə n
peses	p 'e z ə s	p 'ə z ə s
pessebre	p ə s 'e β ɾ ə	p ə s 'ə β ɾ ə
petges	p 'e dʒ ə s	p 'ə dʒ ə s
petja	p 'e dʒ ə	p 'ə dʒ ə
pidgin	p 'i dʒ i n	p 'i ð ʒ i n
pigarg	p i ɣ 'a ɾ k	p i ɣ 'a ɾ ə
pigment	p i m m 'e n t	p i ə m 'e n t
pintaungles	p i n t 'a w ŋ g l ə s	p i n t 'a u ŋ g l ə s
Pitiüses	p i t i 'u z ə s	p i t i 'u s ə s
piulada	p i w l 'a ð ə	p i u l 'a ð ə
piular	p i w l 'a	p i u l 'a
pixades	p i ʃ 'a ð ə s	p i t s 'a ð ə s
plaer	p l ə 'ə	p l ə 'e
plàncton	p l 'a ŋ t t o n	p l ə n s t 'o n
plànyer	p l 'a ɲ ə	p l 'a ɲ e 
plegues	p l 'ə ɣ ə s	p l 'e ɣ ə s
plens	p l 'ə n s	p l 'e n s
pneumàtic	n ə w m 'a t i k	p n ə w m 'a t i k
pneumàtica	n ə w m 'a t i k ə	p n ə w m 'a t i k ə
pneumàtics	n ə w m 'a t i t s	p n ə w m 'a t i t s
pneumònia	n ə w m 'o n i ə	p n ə w m 'o n i ə
poesia	p o ə z 'i ə	p o ə s 'i ə
posseïts	p o s ə 'i t s	p o s ə 'i s
precursor	p ɾ ə k u ɾ s 'o	p ɾ ə k u s 'o
precursora	p ɾ ə k u ɾ s 'o ɾ ə	p ɾ ə k u s 'o ɾ ə
precursores	p ɾ ə k u ɾ s 'o ɾ ə s	p ɾ ə k u s 'o ɾ ə s
prega	p ɾ 'e ɣ ə	p ɾ 'ə ɣ ə
prego	p ɾ 'e ɣ o	p ɾ 'ə ɣ o
prémer	p ɾ 'e m ə	p ɾ ə m 'e 
premsa	p ɾ 'e n s ə	p ɾ 'ə m z ə
prens	p ɾ 'ə n s	p ɾ 'e n s
presta	p ɾ 'e s t ə	p ɾ 'ə s t ə
presten	p ɾ 'e s t ə n	p ɾ 'ə s t ə n
prestes	p ɾ 'e s t ə s	p ɾ 'ə s t ə s
presto	p ɾ 'e s t o	p ɾ 'ə s t o
presumpció	p ɾ ə z u m s i 'o	p ɾ ə z u m p s i 'o
pretendre	p ɾ ə t 'e n d ɾ ə	p ɾ ə t 'ə n d ɾ ə
prevenda	p ɾ ə v 'ə n d ə	p ɾ ə v 'e n d ə
preveure	p ɾ ə v 'ə w ɾ ə	p ɾ ə v 'e w ɾ ə
prínceps	p ɾ 'i n s ə t s	p ɾ i n s 'ə t s
problema	p ɾ o β l 'e m ə	p ɾ o β l 'ə m ə
produïts	p ɾ o ð u 'i t s	p ɾ o ð u 'i s
prohom	p ɾ o 'o m	p ɾ o 'a m
prolixa	p ɾ o l 'i ʃ ə	p ɾ o l 'i t s ə
prosseguits	p ɾ o s ə ɣ 'i t s	p ɾ o s ə ɣ 'i s
protesta	p ɾ o t 'e s t ə	p ɾ o t 'ə s t ə
proveïts	p ɾ o v ə 'i t s	p ɾ o v ə 'i s
pseudònim	s ə w ð 'o n i m	t s ə w ð 'o n i m
pseudòpode	s ə w ð 'o p o ð ə	t s ə w ð 'o p o ð ə
pugnada	p u n n 'a ð ə	p u ə n 'a ð ə
pugnades	p u n n 'a ð ə s	p u ə n 'a ð ə s
pugnar	p u n n 'a	p u ə n 'a
púlsar	p 'u l s ə	p u l s 'a
queixa	k 'e ʃ ə	k 'ə ʃ ə
queixo	k 'e ʃ o	k 'ə ʃ o
rabassaire	r ə β ə s 'a j ɾ ə	r ə β ə s 'a i ɾ ə
raima	r 'a j m ə	r 'a i m ə
re	r 'ə	r ə
reaparegut	r e ə p ə ɾ ə ɣ 'u t	r ə ə p ə ɾ ə ɣ 'u t
reapareguts	r e ə p ə ɾ ə ɣ 'u t s	r ə ə p ə ɾ ə ɣ 'u t s
reaparèixer	r e ə p ə ɾ 'ə ʃ ə	r ə ə p ə ɾ 'ə ʃ ə
reconstruïts	r ə k o n s t ɾ u 'i t s	r ə k o n s t ɾ u 'i s
rècord	r 'ə k o ɾ t	r 'e k o ɾ t
recreatiu	r ə k ɾ e ə t 'i w	r ə k ɾ ə ə t 'i w
redempció	r ə ð ə m s i 'o	r ə ð ə m p s i 'o
reduïts	r ə ð u 'i t s	r ə ð u 'i s
refet	r ə f 'e t	r ə f 'ə t
refeta	r ə f 'e t ə	r ə f 'ə t ə
refringir	r ə f ɾ i n ʒ 'i	r ə f ɾ i ŋ g 'i
règies	r 'ə ʒ i ə s	r 'e ʒ i ə s
règim	r 'ə ʒ i m	r 'e ʒ i m
regla	r 'e g g l ə	r 'ə g g l ə
regles	r 'e g g l ə s	r 'e ɣ l ə s
regna	r 'e n n ə	r 'ə n n ə
regne	r 'e n n ə	r 'ə n n ə
regnen	r 'e n n ə n	r 'ə n n ə n
regnes	r 'e n n ə s	r 'ə n n ə s
reialme	r ə j 'a l m ə	r ə i 'a l m ə
reiet	r ə j 'ə t	r ə i 'ə t
reietó	r ə j ə t 'o	r ə i ə t 'o
reiteració	r ə i t ə ɾ ə s i 'o	r ə j t ə ɾ ə s i 'o
reiterada	r ə i t ə ɾ 'a ð ə	r ə j t ə ɾ 'a ð ə
reiterades	r ə i t ə ɾ 'a ð ə s	r ə j t ə ɾ 'a ð ə s
reiterar	r ə i t ə ɾ 'a	r ə j t ə ɾ 'a
reiterat	r ə i t ə ɾ 'a t	r ə j t ə ɾ 'a t
reiterats	r ə i t ə ɾ 'a t s	r ə j t ə ɾ 'a t s
reixa	r 'e ʃ ə	r 'ə ʃ ə
reïxes	r ə 'i ʃ ə s	r ə 'i ə s
rella	r 'ə ʎ ə	r 'e ʎ ə
relles	r 'ə ʎ ə s	r 'e ʎ ə s
relleu	r ə ʎ 'e w	r ə ʎ 'ə w
remo	r 'e m o	r 'ə m o
rèmol	r 'e m o l	r 'ə m o l
renou	r ə n 'o w	r ə n 'o
reposapeus	r ə p o z ə p 'e w s	r ə p o z ə p ə 'u s
reproduïts	r ə p ɾ o ð u 'i t s	r ə p ɾ o ð u 'i s
resa	r 'e z ə	r 'ə z ə
resen	r 'e z ə n	r 'ə z ə n
resignar	r ə z i n n 'a	r ə z i ə n 'a
reso	r 'e z o	r 'ə z o
resseguits	r ə s ə ɣ 'i t s	r ə s ə ɣ 'i s
resta	r 'e s t ə	r 'ə s t ə
resten	r 'e s t ə n	r 'ə s t ə n
restes	r 'e s t ə s	r 'ə s t ə s
rètol	r 'e t o l	r 'ə t o l
retreure	r ə t ɾ 'ə w ɾ ə	r ə t ɾ 'e w ɾ ə
retroperitoneal	r ə t ɾ o p ə ɾ i t o n e 'a l	r ə t ɾ o p ə ɾ i t o n ə 'a l
retroperitoneals	r ə t ɾ o p ə ɾ i t o n e 'a l s	r ə t ɾ o p ə ɾ i t o n ə 'a l s
reusenc	r ə w z 'ə ŋ k	r ə w s 'ə ŋ k
reverend	r ə v ə ɾ 'e n t	r ə v ə ɾ 'ə n t
revetlla	r ə v 'e ʎ ʎ ə	r ə v 'ə ʎ ʎ ə
revetla	r ə v 'e l l ə	r ə v 'ə l l ə
reveure	r ə v 'ə w ɾ ə	r ə v 'e w ɾ ə
Ricosind	r i k o z 'i n t	r i k o z 'i n ə
rogenc	r o ʒ 'ə ŋ k	r o ʒ 'e ŋ k
rosegaaltars	r o z ə ɣ ə ə l t 'a s	r o z ə ɣ e ə l t 'a s
roure	r 'o w ɾ ə	r o 'u ɾ ə
roureda	r o w ɾ 'ə ð ə	r o u ɾ 'ə ð ə
rovell	r o v 'ə ʎ	r o v 'e ʎ
ruixats	r u ʃ 'a t s	r i ʃ 'a t s
sa	s 'ə	s ə
saber	s ə β 'ə	s ə β 'e
sainet	s ə j n 'ə t	s ə i n 'ə t
sarg	s 'a ɾ k	s 'a ɾ ə
sastressa	s ə s t ɾ 'ə s ə	s ə s t ɾ 'e s ə
seaborgi	s e ə β 'o ɾ ʒ i	s ə ə β 'o ɾ ʒ i
sega	s 'e ɣ ə	s 'ə ɣ ə
sègol	s 'e ɣ o l	s 'ə ɣ o l
Segre	s 'ə ɣ ɾ ə	s 'e ɣ ɾ ə
segrest	s ə ɣ ɾ 'e s t	s ə ɣ ɾ 'ə s t
segues	s 'ə ɣ ə s	s 'e ɣ ə s
seguits	s ə ɣ 'i t s	s ə ɣ 'i s
seient	s ə j 'e n t	s ə i 'e n t
seitó	s ə j t 'o	s ə i t 'o
sembra	s 'e m b ɾ ə	s 'ə m b ɾ ə
semestre	s ə m 'e s t ɾ ə	s ə m 'ə s t ɾ ə
sempre	s 'e m p ɾ ə	s 'ə m p ɾ ə
sénia	s 'e n i ə	s ə n 'i ə
sens	s 'ə n s	s 'e n s
sense	s 'e n s ə	s 'ə n s ə
sépia	s 'e p i ə	s ə p 'i ə
sequoia	s ə k w 'o j ə	s ə k 'o j ə
sèsam	s 'e z ə m	s 'ə z ə m
setembre	s ə t 'e m b ɾ ə	s ə t 'ə m b ɾ ə
setge	s 'e dʒ ə	s 'ə dʒ ə
setges	s 'e dʒ ə s	s 'ə dʒ ə s
seua	s 'e w ə	s 'ə w ə
seure	s 'ə w ɾ ə	s 'e w ɾ ə
seva	s 'e v ə	s 'ə v ə
sèver	s 'e v ə	s ə v 'e 
seves	s 'e v ə s	s 'ə v ə s
signada	s i n n 'a ð ə	s i ə n 'a ð ə
signades	s i n n 'a ð ə s	s i ə n 'a ð ə s
signar	s i n n 'a	s i ə n 'a
Silèsia	s i l 'e z i ə	s i l 'ə z i ə
síndria	s 'i n d ɾ i ə	s i n d ɾ 'i ə
síndrome	s 'i n d ɾ o m ə	s i n d ɾ 'o m ə
sisè	s i z 'ə	s i s 'ə
sistema	s i s t 'e m ə	s i s t 'ə m ə
solell	s o l 'ə ʎ	s o l 'e ʎ
sostreure	s o s t ɾ 'ə w ɾ ə	s o s t ɾ 'e w ɾ ə
sous	s 'o w s	s 'o s
subratllades	s u β ɾ ə l ʎ ʎ 'a ð ə s	s u β ɾ ə ʎ ʎ 'a ð ə s
subscriure	s u p s k ɾ 'i w ɾ ə	s u t s k ɾ 'i w ɾ ə
substància	s u p s t 'a n s i ə	s u t s t 'a n s i ə
substantiu	s u p s t ə n t 'i w	s u t s t ə n t 'i w
substantius	s u p s t ə n t 'i w s	s u t s t ə n t 'i w s
succeïts	s u t s ə 'i t s	s u t s ə 'i s
súcube	s 'u k u β ə	s u k 'u β ə
sucursal	s u k u ɾ s 'a l	s u k u ə s 'a l
sucursals	s u k u ɾ s 'a l s	s u k u ə s 'a l s
Suècia	s u 'ə s i ə	s u t s i ə
súper	s 'u p ə	s u p 'e 
Tailàndia	t ə j l 'a n d i ə	t ə i l 'a n d i ə
tàlveg	t 'a l v ə k	t 'a l v ə ɣ
tangent	t ə n ʒ 'e n t	t ə ŋ g 'e n t
taquimètric	t ə k i m 'e t ɾ i k	t ə k i m 'ə t ɾ i k
tàtar	t 'a t ə	t ə t 'a
tatuats	t ə t u 'a t s	t ə t u 'a s
telèfon	t ə l 'e f o n	t ə l 'ə f o n
telèfons	t ə l 'e f o n s	t ə l 'ə f o n s
telègraf	t ə l 'e ɣ ɾ ə f	t ə l 'ə ɣ ɾ ə f
tema	t 'e m ə	t 'ə m ə
temen	t 'e m ə n	t 'ə m ə n
témer	t 'e m ə	t ə m 'e 
temes	t 'e m ə s	t 'ə m ə s
temo	t 'e m o	t 'ə m o
tempesta	t ə m p 'e s t ə	t ə m p 'ə s t ə
templa	t 'e m p l ə	t 'ə m p l ə
temple	t 'e m p l ə	t 'ə m p l ə
temples	t 'e m p l ə s	t 'ə m p l ə s
tendenciosa	t ə n d ə n s i 'o z ə	t ə n d ə n s i 'o s ə
tendencioses	t ə n d ə n s i 'o z ə s	t ə n d ə n s i 'o s ə s
tendenciosos	t ə n d ə n s i 'o z o s	t ə n d ə n s i 'o s o s
tenebra	t ə n 'e β ɾ ə	t ə n 'ə β ɾ ə
tenebres	t ə n 'e β ɾ ə s	t ə n 'ə β ɾ ə s
tenen	t 'e n ə n	t 'ə n ə n
téntol	t 'e n t o l	t ə n t 'o l
termogènesi	t ə ɾ m o ʒ 'e n ə z i	t ə ɾ m o ʒ 'ə n ə z i
terrestre	t ə r 'e s t ɾ ə	t ə r 'ə s t ɾ ə
terrestres	t ə r 'e s t ɾ ə s	t ə r 'ə s t ɾ ə s
terrissaire	t ə r i s 'a j ɾ ə	t ə r i s 'a i ɾ ə
Teseu	t ə z 'e w	t ə s 'e w
tètan	t 'e t ə n	t 'ə t ə n
tètanus	t 'e t ə n u s	t ə t ə n 'u s
tètol	t 'e t o l	t 'ə t o l
teva	t 'e v ə	t 'ə v ə
teves	t 'e v ə s	t 'ə v ə s
torraina	t o r 'a j n ə	t o r 'a i n ə
traduïts	t ɾ ə ð u 'i t s	t ɾ ə ð u 'i s
traïts	t ɾ ə 'i t s	t ɾ ə 'i s
tràquea	t ɾ 'a k e ə	t ɾ 'a k ə ə
traqueal	t ɾ ə k e 'a l	t ɾ ə k ə 'a l
traqueals	t ɾ ə k e 'a l s	t ɾ ə k ə 'a l s
trèmol	t ɾ 'e m o l	t ɾ 'ə m o l
tremp	t ɾ 'e m p	t ɾ 'ə m p
Tremp	t ɾ 'e m p	t ɾ 'ə m p
trenqui	t ɾ 'e ŋ k i	t ɾ 'ə ŋ k i
trenquin	t ɾ 'e ŋ k i n	t ɾ 'ə ŋ k i n
trenquis	t ɾ 'e ŋ k i s	t ɾ 'ə ŋ k i s
trens	t ɾ 'ə n s	t ɾ 'e n s
trepa	t ɾ 'e p ə	t ɾ 'ə p ə
trepes	t ɾ 'e p ə s	t ɾ 'ə p ə s
trepig	t ɾ ə p 'i tʃ	t ɾ ə p 'i ə
tret	t ɾ 'e t	t ɾ 'ə t
treta	t ɾ 'e t ə	t ɾ 'ə t ə
tretes	t ɾ 'e t ə s	t ɾ 'ə t ə s
trets	t ɾ 'e t s	t ɾ 'ə t s
tretze	t ɾ 'e d z ə	t ɾ 'ə d z ə
treure	t ɾ 'ə w ɾ ə	t ɾ 'e w ɾ ə
treus	t ɾ 'e w s	t ɾ 'ə w s
treva	t ɾ 'e v ə	t ɾ 'ə v ə
Trèveris	t ɾ 'e v ə ɾ i s	t ɾ 'ə v ə ɾ i s
trimestre	t ɾ i m 'e s t ɾ ə	t ɾ i m 'ə s t ɾ ə
trinxeraire	t ɾ i n ʃ ə ɾ 'a j ɾ ə	t ɾ i n ʃ ə ɾ ə 'i ɾ ə
troià	t ɾ o j 'a	t ɾ o i 'a
tsar	t s 'a	ə z 'a
uigur	u j ɣ 'u	u tʃ 'u
ull	'u j	'u ʎ
ultimàtum	u l t i m 'a t u m	u l t i m ə t 'u m
vainilla	v ə j n 'i ʎ ə	v ə i n 'i ʎ ə
vainilles	v ə j n 'i ʎ ə s	v ə i n 'i ʎ ə s
València	v ə l 'e n s i ə	v ə l 'ə n s i ə
valer	v ə l 'ə	v ə l 'e
varius	v ə ɾ 'i w s	v ə ɾ i 'u s
ve	v 'e	v 'ə
venda	v 'ə n d ə	v 'e n d ə
vènet	v 'e  n ə t	v 'ə n ə t
vènia	v 'e  n i ə	v 'e n i ə
ventrell	v ə n t ɾ 'ə ʎ	v ə n t ɾ 'e ʎ
Venus	v 'e n u s	v 'ə n u s
vespa	v 'e s p ə	v 'ə s p ə
vespre	v 'e s p ɾ ə	v 'ə s p ɾ ə
vetlla	v 'e ʎ ʎ ə	v 'ə ʎ ʎ ə
vetla	v 'e l l ə	v 'ə l l ə
veure	v 'ə w ɾ ə	v 'e w ɾ ə
vicesecretari	v i s ə s ə k ɾ ə t 'a ɾ i	v i s ə z ə k ɾ ə t 'a ɾ i
vigència	v i ʒ 'e  n s i ə	v i ʒ 'e n s i ə
vigèsim	v i ʒ 'e  z i m	v i ʒ 'e z i m
violència	v i o l 'e  n s i ə	v i o l 'e n s i ə
vistaire	v i s t 'a j ɾ ə	v i s t 'a i ɾ ə
viuda	v 'i w ð ə	v i 'u ð ə
voivoda	v o j v 'o ð ə	v o i v 'o ð ə
voler	v o l 'ə	v o l 'e
volumètric	v o l u m 'e t ɾ i k	v o l u m 'ə t ɾ i k
vuitada	v u j t 'a ð ə	v u i t 'a ð ə
vuitanta	v u j t 'a n t ə	v u i t 'a n t ə
wiki	b 'i k i	ə 'i k i
wòlof	b 'o l o f	o 'o l o f
xai	ʃ 'a j	ʃ 'a i
Xangai	ʃ ə ŋ g 'a j	ʃ ə ŋ g 'a i
xangainès	ʃ ə ŋ g ə j n 'ə s	ʃ ə ŋ g ə i n 'ə s
xeic	ʃ 'e j k	ʃ 'ə j k
xíndria	ʃ 'i n d ɾ i ə	ʃ i n d ɾ 'i ə
xiular	ʃ i w l 'a	ʃ i u l 'a
xiulet	ʃ i w l 'ə t	ʃ i u l 'ə t
xou	ʃ 'o w	ʃ 'o
xous	ʃ 'o w s	ʃ o 'u s
Xúquer	ʃ 'u k ə	ʃ u k 'e 
zebra	z 'e β ɾ ə	z 'ə β ɾ ə
zeugma	z 'e w m m ə	z 'e u m m ə
de	d 'ə	d ə
que	k 'ə	k ə
la	l 'ə	l ə
i	'i	i
a	'ə	ə
el	'ə l	ə l
en	'ə n	ə n
les	l 'ə s	l ə s
els	'ə l s	'e l s
del	d 'ə l	d ə l
amb	'ə m	 e m b
al	'ə l	'a l
es	'ə s	ə s
El	'ə l	ə l
dels	d 'ə l s	d 'e l s
hi	'i	i
La	l 'ə	l ə
si	s 'i	s i
em	'ə m	ə m
li	l 'i	l i
seva	s 'e v ə	s 'ə v ə
ens	'ə n s	'e n s
Els	ə l s	'e l s
A	'ə	ə
als	ə l s	'a l s
En	'ə n	ə n
Si	s 'i	s i
sense	s 'e n s ə	s 'ə n s ə
ho	'o	o
res	r 'e s	r 'ə s
De	d 'ə	d ə
pel	p 'ə l	p 'e l
meva	m 'e v ə	m 'ə v ə
sempre	s 'e m p ɾ ə	s 'ə m p ɾ ə
I	'i	i
he	'e	'a
hem	'ə m	'e m
seves	s 'e v ə s	s 'ə v ə s
se	s 'ə	s ə
Les	l 'ə s	l ə s
sistema	s i s t 'e m ə	s i s t 'ə m ə
Em	'ə m	ə m
et	'ə t	ə t
Es	'ə s	ə s
mai	m 'a j	m 'a i
poder	p o ð 'ə	p o ð 'e
Al	'ə l	'a l
hores	'o ɾ ə s	ə ɾ ə s
Hi	'i	i
haver	ə v 'ə	ə v 'e
tenen	t 'e n ə n	t 'ə n ə n
Li	l 'i	l i
Amb	'ə m	 e m b
nens	n 'ə n s	n 'e n s
ben	b 'e n	b 'ə n
pels	p 'ə l s	p 'e l s
molts	m 'o l s	m 'o l t s
saber	s ə β 'ə	s ə β 'e
mig	m 'i tʃ	m 'i k
cotxe	k 'o tʃ o	k 'o tʃ ə
Ho	'o	o
mateixa	m ə t 'e ʃ ə	m ə t 'ə ʃ ə
mes	m 'e s	m 'ə s
Queden	k 'e ð ə n	k 'ə ð ə n
home	'o m o	'o m ə
ve	v 'e	v 'ə
trenta	t ɾ 'ə n t ə	t ɾ 'e n t ə
gaire	g 'a j ɾ ə	g 'a i ɾ ə
He	'e	'a
hora	'o ɾ ə	ə ɾ ə
problemes	p ɾ o β l 'e m ə s	p ɾ o β l 'ə m ə s
teva	t 'e v ə	t 'ə v ə
tretze	t ɾ 'e d z ə	t ɾ 'ə d z ə
tema	t 'e m ə	t 'ə m ə
queda	k 'e ð ə	k 'ə ð ə
noi	n 'o j	n 'o i
Ens	'ə n s	'e n s
llengua	ʎ 'e ŋ g w ə	ʎ 'ə ŋ g w ə
segle	s 'e g g l ə	s 'e ɣ l ə
hagut	ə ɣ 'u t	a ɣ 'u t
Que	k 'ə	k ə
Sempre	s 'e m p ɾ ə	s 'ə m p ɾ ə
meves	m 'e v ə s	m 'ə v ə s
telèfon	t ə l 'e f o n	t ə l 'ə f o n
llarg	ʎ 'a ɾ k	ʎ 'a ɾ ə
temes	t 'e m ə s	t 'ə m ə s
homes	'o m ə s	ə m ə s
centres	s 'e n t ɾ ə s	s 'ə n t ɾ ə s
Lleida	ʎ 'e j ð ə	ʎ 'ə j ð ə
tens	t 'ə n s	t 'e n s
trens	t ɾ 'ə n s	t ɾ 'e n s
fes	f 'e s	f 'ə s
vuitanta	v u j t 'a n t ə	v u i t 'a n t ə
queden	k 'e ð ə n	k 'ə ð ə n
peixos	p 'e ʃ o s	p 'ə ʃ o s
haig	'a tʃ	a 'i ə
etcètera	ə t s 'e t ə ɾ ə	ə t s 'ə t ə ɾ ə
dòlars	d 'o l ə s	d o l 'a s
me'n	m ə n	m 'ə n
Hem	'ə m	'e m
pedra	p 'e ð ɾ ə	p 'ə ð ɾ ə
paisatge	p ə j z 'a dʒ ə	p ə i z 'a dʒ ə
nois	n 'o j s	n 'o i s
mètode	m 'e t o ð ə	m 'ə t o ð ə
gens	ʒ 'ə n s	g 'e n s
espai	ə s p 'a j	ə s p 'a i
Montse	m 'o n s ə	m 'o n t s ə
me	m 'ə	m ə
mateixos	m ə t 'e ʃ o s	m ə t 'ə ʃ o s
Pel	p 'ə l	p 'e l
Et	'ə t	ə t
últims	'u l t i n s	u l t 'i n s
plens	p l 'ə n s	p l 'e n s
deixen	d 'e ʃ ə n	d 'ə ʃ ə n
Sense	s 'e n s ə	s 'ə n s ə
veuen	v 'ə w ə n	v 'e w ə n
processos	p ɾ o s 'e s o s	p ɾ o s 'ə s o s
problema	p ɾ o β l 'e m ə	p ɾ o β l 'ə m ə
pedres	p 'e ð ɾ ə s	p 'ə ð ɾ ə s
guerra	g 'e r ə	g w 'e r ə
desig	d ə z 'i tʃ	d ə z 'i ə
entendre	ə n t 'e n d ɾ ə	ə n t 'ə n d ɾ ə
Vielha	v i 'e l ə	v i ə l 'a
Mai	m 'a j	m 'a i
ves	v 'e s	v 'ə s
sistemes	s i s t 'e m ə s	s i s t 'ə m ə s
reals	r e 'a l s	r ə 'a l s
metges	m 'e dʒ ə s	m 'ə dʒ ə s
València	v ə l 'e n s i ə	v ə l 'ə n s i ə
i	'i	i
vespre	v 'e s p ɾ ə	v 'ə s p ɾ ə
quedo	k 'e ð o	k 'ə ð o
néixer	n 'e ʃ ə	n ə ʃ 'e 
meitat	m ə j t 'a t	m ə i t 'a t
gaires	g 'a j ɾ ə s	g 'a i ɾ ə s
equips	ə k 'i t s	ə k 'i s
consciència	k o n t s i 'e n s i ə	k o n s i 'e n s i ə
conscient	k o n t s i 'e n t	k o n s i 'e n t
Als	'ə l s	'a l s
ésser	'e s ə	e s 'e 
època	'e p o k ə	'ə p o k ə
A	'ə	ə
voler	v o l 'ə	v o l 'e
espais	ə s p 'a j s	ə s p 'a i s
èpoques	'e p o k ə s	'ə p o k ə s
teves	t 'e v ə s	t 'ə v ə s
deixo	d 'e ʃ o	d 'ə ʃ o
capsa	k 'a t s ə	k 'a s ə
segles	s 'e g g l ə s	s 'e ɣ l ə s
regles	r 'e g g l ə s	r 'e ɣ l ə s
pèl	p 'ə l	p 'e l
premsa	p ɾ 'e n s ə	p ɾ 'ə m z ə
metge	m 'e dʒ ə	m 'ə dʒ ə
lluitar	ʎ u j t 'a	ʎ u i t 'a
immens	i m m 'ə n s	i m m 'e n s
guia	g 'i ə	g w 'i ə
espècie	ə s p 'ə s i ə	ə s p 'e s i ə
elfs	'e l t s	'e l i s
créixer	k ɾ 'e ʃ ə	k ɾ ə ʃ 'e 
atendre	ə t 'e n d ɾ ə	ə t 'ə n d ɾ ə
Boi	b 'o j	b 'o i
vendes	v 'ə n d ə s	v 'e n d ə s
ull	'u j	'u ʎ
telèfons	t ə l 'e f o n s	t ə l 'ə f o n s
pèls	p 'ə l s	p 'e l s
m'hi	m i	m 'i
llest	ʎ 'e s t	ʎ 'ə s t
llengües	ʎ 'e ŋ g w ə s	ʎ 'ə ŋ g w ə s
enmig	ə m m 'i tʃ	ə n m 'i k
creador	k ɾ e ə ð 'o	k ɾ ə ə ð 'o
Tremp	t ɾ 'e m p	t ɾ 'ə m p
Pesa	p 'e z ə	p 'ə z ə
Molts	m 'o l s	m 'o l t s
Jesús	ʒ ə z 'u s	ʒ ə s 'u s
Fes	f 'e s	f 'ə s
éssers	'e s ə s	e s 'e s
èxits	'e t s i t s	ʃ i t s
En	'ə n	ə n
realitzen	r e ə l 'i d z ə n	r ə ə l 'i d z ə n
raig	r 'a tʃ	r ə 'i ə
peatges	p e 'a dʒ ə s	p ə 'a dʒ ə s
morts	m 'o ɾ s	m 'o ɾ t s
menja	m 'e n ʒ ə	m 'ə n ʒ ə
mateixes	m ə t 'e ʃ ə s	m ə t 'ə ʃ ə s
fruits	f ɾ 'u j t s	f ɾ u 'i t s
entren	'e n t ɾ ə n	'ə n t ɾ ə n
currículum	k u r 'i k u l u m	k u r i k u l 'u m
creat	k ɾ e 'a t	k ɾ ə 'a t
caigui	k 'a j ɣ i	k 'a i ɣ i
alcohol	ə l k o 'o l	ə l k o 'a l
èxit	'e t s i t	ʃ i t
situats	s i t u 'a t s	s i t u 'a s
sisè	s i z 'ə	s i s 'ə
poesia	p o ə z 'i ə	p o ə s 'i ə
plàncton	p l 'a ŋ t t o n	p l ə n s t 'o n
lo	l 'o	l o
jersei	ʒ ə ɾ s 'ə j	ʒ ə ɾ s 'ə i
intens	i n t 'ə n s	i n t 'e n s
herois	ə ɾ 'o j s	ə ɾ 'o i s
guies	g 'i ə s	g w 'i ə s
fetge	f 'e dʒ ə	f 'ə dʒ ə
esmorteïts	ə z m o ɾ t ə 'i t s	ə z m o ɾ t ə 'i s
encendre	ə n s 'e n d ɾ ə	ə n s 'ə n d ɾ ə
distingir	d i s t i n ʒ 'i	d i s t i ŋ g 'i
deuen	d 'ə w ə n	d 'e w ə n
descens	d ə t s 'ə n s	d ə t s 'e n s
argument	ə ɾ ɣ u m 'e n t	a ɾ ɣ u m 'e n t
aliment	ə l i m 'e n t	a l i m 'e n t
Seguint	s ə ɣ 'i n t	s ə ɣ u 'i n t
Res	r 'e s	r 'ə s
Huelva	u 'e l v ə	ə 'e l v ə
Horts	'o ɾ s	ə ɾ s
Deixo	d 'e ʃ o	d 'ə ʃ o
te	t 'ə	t ə
sencera	s ə n s 'ə ɾ ə	s ə n s 'e ɾ ə
seguint	s ə ɣ 'i n t	s ə ɣ u 'i n t
parer	p ə ɾ 'ə	p ə ɾ 'e
menjo	m 'e n ʒ o	m 'ə n ʒ o
mantenen	m ə n t 'e n ə n	m ə n t 'ə n ə n
lleixa	ʎ 'e ʃ ə	ʎ 'ə ʃ ə
goig	g 'o tʃ	g o 'i ə
estrangers	ə s t ɾ ə n ʒ 'e s	ə s t ɾ ə ŋ g 'e s
espècies	ə s p 'ə s i ə s	ə s p 'e s i ə s
empleats	ə m p l e 'a t s	ə m p l ə 'a s
celebra	s ə l 'e β ɾ ə	s ə l 'ə β ɾ ə
bàsquet	b 'a s k ə t	b ə s k 'ə t
bàndols	b 'a n d o l s	b ə n d 'o l s
bars	b 'a s	b 'a ɾ s
assignat	ə s i n n 'a t	ə s i ə n 'a t
Tens	t 'ə n s	t 'e n s
Pontevedra	p o n t ə v 'e ð ɾ ə	p o n t ə v 'ə ð ɾ ə
Pels	p 'ə l s	p 'e l s
Menjo	m 'e n ʒ o	m 'ə n ʒ o
Home	'o m o	'o m ə
subproductes	s u p p ɾ o ð 'u t t ə s	s u β p ɾ o ð 'u t t ə s
sopars	s o p 'a s	s o p 'a ɾ s
sistema	s i s t 'e m ə	s i s t 'ə m ə
signar	s i n n 'a	s i ə n 'a
sencer	s ə n s 'ə	s ə n s 'e
realitza	r e ə l 'i d z ə	r ə ə l 'i d z ə
pàrquing	p 'a ɾ k i ŋ k	p ə ɾ k 'i ŋ k
presses	p ɾ 'e s ə s	p ɾ 'ə s ə s
preciosa	p ɾ ə s i 'o z ə	p ɾ ə s i 'o s ə
penja	p 'e n ʒ ə	p 'ə n ʒ ə
oliosos	o l i 'o z o s	o l i 'o s o s
megues	m 'ə ɣ ə s	m 'e ɣ ə s
luxe	l 'u t s ə	l 'u ʃ ə
lluitava	ʎ u j t 'a v ə	ʎ u i t 'a v ə
lletja	ʎ 'e dʒ ə	ʎ 'ə dʒ ə
lleig	ʎ 'e tʃ	ʎ ə 'i ə
kafkianes	k ə f k i 'a n ə s	k ə f i i 'a n ə s
irreal	i r e 'a l	i r ə e 'a l
ideals	i ð e 'a l s	i ð ə 'a l s
gratuïts	g ɾ ə t u 'i t s	g ɾ ə t u 'i s
grandiosa	g ɾ ə n d i 'o z ə	g ɾ ə n d i 'o s ə
gespa	ʒ 'e s p ə	ʒ 'ə s p ə
gasoil	g ə z 'o j l	g ə z o 'i l
fem-ho	f 'e m o	f 'ə m o
escletxa	ə s k l 'e tʃ ə	ə s k l 'ə tʃ ə
elèctrics	ə l 'e t t ɾ i t s	ə l ə t t ɾ 'i t s
dècada	d 'e k ə ð ə	d ə k 'a ð ə
dotant-les	d o t 'a n l ə s	d o t 'a n t  l ə s
creixen	k ɾ 'e ʃ ə n	k ɾ 'ə ʃ ə n
conscients	k o n t s i 'e n s	k o n s i 'e n s
cegues	s 'ə ɣ ə s	s 'e ɣ ə s
aliens	ə l i 'ə n s	ə l i 'e n s
aleatoris	ə l e ə t 'o ɾ i s	ə l ə ə t 'o ɾ i s
aimara	ə j m 'a ɾ ə	ə i m 'a ɾ ə
agafant-me	ə ɣ ə f 'a m m ə	ə ɣ ə f 'a n t m ə
Tenen	t 'e n ə n	t 'ə n ə n
Regne	r 'e n n ə	r 'ə n n ə
Mig	m 'i tʃ	m 'i k
Me	m 'ə	m ə
Kuwait	k u β 'a j t	k u β 'a i t
Guia	g 'i ə	g w 'i ə
Guerra	g 'e r ə	g w 'e r ə
Entro	'e n t ɾ o	'ə n t ɾ o
Eivissa	ə j v 'i s ə	ə i v 'i s ə
Del	d 'ə l	d ə l
Consciència	k o n t s i 'e n s i ə	k o n s i 'e n s i ə
Hi	'i	i
De	d 'ə	d ə
vinguessis	v i ŋ g 'e s i s	v i ŋ g 'ə s i s
sentint-se	s ə n t 'i n s ə	s ə n t 'i n t s ə
sens	s 'ə n s	s 'e n s
seguien	s ə ɣ 'i ə n	s ə ɣ u 'i ə n
reiterada	r ə i t ə ɾ 'a ð ə	r ə j t ə ɾ 'a ð ə
oi	'o j	'o i
nèctar	n 'e t t ə	n ə t t 'a
nerviosisme	n ə ɾ v i o z 'i z m ə	n ə ɾ v i o s 'i z m ə
mirant-lo	m i ɾ 'a n l o	m i ɾ 'a n i l o
luxes	l 'u t s ə s	l 'u ʃ ə s
lleixes	ʎ 'e ʃ ə s	ʎ 'ə ʃ ə s
indústria	i n d 'u s t ɾ i ə	i n d u s t ɾ 'i ə
franctirador	f ɾ ə ŋ t t i ɾ ə ð 'o	f ɾ ə n s t i ɾ ə ð 'o
fongs	f 'o ŋ s	f 'o n s
fleca	f l 'e k ə	f l 'ə k ə
estratègies	ə s t ɾ ə t 'ə ʒ i ə s	ə s t ɾ ə t 'e ʒ i ə s
estranger	ə s t ɾ ə n ʒ 'e	ə s t ɾ ə ŋ g 'e
esglésies	ə z ɣ l 'e z i ə s	ə z ɣ l ə z 'i ə s
distendre	d i s t 'e n d ɾ ə	d i s t 'ə n d ɾ ə
desmai	d ə z m 'a j	d ə z m 'a i
cuidar	k u j ð 'a	k u i ð 'a
creuen	k ɾ 'ə w ə n	k ɾ 'e w ə n
concentren	k o n s 'e n t ɾ ə n	k o n s 'ə n t ɾ ə n
arruinats	ə r u j n 'a t s	ə r u i n 'a t s
alineats	ə l i n e 'a t s	ə l i n ə 'a s
Sistema	s i s t 'e m ə	s i s t 'ə m ə
Queda	k 'e ð ə	k 'ə ð ə
Ginebra	ʒ i n 'e β ɾ ə	ʒ i n 'ə β ɾ ə
ètniques	'e n n i k ə s	'ə n n i k ə s
ètnica	'e n n i k ə	'ə n n i k ə
ètnic	'e n n i k	'ə n n i k
àngels	'a n ʒ ə l s	a n ʒ 'e l s
que	k 'ə	k ə
Que	k 'ə	k ə
La	l 'ə	l ə
En	'ə n	ə n
xai	ʃ 'a j	ʃ 'a i
whiskys	b 'i s k i s	ə 'i s j n s
vuitens	v u j t 'ə n s	v u i t 'e n s
vuitena	v u j t 'ə n ə	v u i t 'ə n ə
virtuoses	v i ɾ t u 'o z ə s	v i ɾ t u 'o s ə s
vespres	v 'e s p ɾ ə s	v 'ə s p ɾ ə s
tsars	t s 'a s	ə z 'a s
treuen	t ɾ 'ə w ə n	t ɾ 'e w ə n
trepitgés	t ɾ ə p i dʒ 'e s	t ɾ ə p i tʃ 'e s
trepig	t ɾ ə p 'i tʃ	t ɾ ə p 'i ə
transmetent-me	t ɾ ə n z m ə t 'e m m ə	t ɾ ə n z m ə t 'e n t m ə
tinguent	t i ŋ g 'e n t	t i ŋ g w 'e n t
terrenys	t ə r 'ə j n s	t ə r 'ə n i s
terraqüi	t ə r 'a k w i	t ə r 'a i i
tenyint-lo	t ə ɲ 'i n l o	t ə ɲ 'i n t  l o
tediosa	t ə ð i 'o z ə	t ə ð i 'o s ə
te'm	t ə m	t 'ə m
te'l	t ə l	t 'e l
tangents	t ə n ʒ 'e n s	t ə ŋ g 'e n s
súpers	s 'u p ə s	s u p 'e s
succeïts	s u t s ə 'i t s	s u t s ə 'i s
successos	s u t s 'e s o s	s u t s 'ə s o s
subsidi	s u t s 'i ð i	s u ə s 'i ð i
sospesen	s o s p 'e z ə n	s o s p 'ə z ə n
sobressin	s o β ɾ 'ə s i n	s o β ɾ 'e s i n
silencioses	s i l ə n s i 'o z ə s	s i l ə n s i 'o s ə s
silenciosa	s i l ə n s i 'o z ə	s i l ə n s i 'o s ə
signat	s i n n 'a t	s i ə n 'a t
serens	s ə ɾ 'ə n s	s ə ɾ 'e n s
sequaços	s ə k w 'a s o s	s ə k 'a s o s
sentint-me	s ə n t 'i m m ə	s ə n t 'i n t m ə
sempre	s 'e m p ɾ ə	s 'ə m p ɾ ə
seitons	s ə j t 'o n s	s ə i t 'o n s
sapiens	s ə p i 'ə n s	s ə p i 'e n s
salpebra	s ə l p 'e β ɾ ə	s ə l p 'ə β ɾ ə
rètols	r 'e t o l s	r 'ə t o l s
rètol	r 'e t o l	r 'ə t o l
rodejant-ne	r o ð ə ʒ 'a n n ə	r o ð ə ʒ 'a n n n ə
resseguint	r ə s ə ɣ 'i n t	r ə s ə ɣ u 'i n t
resen	r 'e z ə n	r 'ə z ə n
res	r 'e s	r 'ə s
reproduint-la	r ə p ɾ o ð u 'i n l ə	r ə p ɾ o ð i i n l l ə
renecs	r ə n 'e t s	r ə n 'ə t s
religioses	r ə l i ʒ i 'o z ə s	r ə l i ʒ i 'o s ə s
regne	r 'e n n ə	r 'ə n n ə
regla	r 'e g g l ə	r 'ə g g l ə
reconeixent-ne	r ə k o n ə ʃ 'e n n ə	r ə k o n ə ʃ 'e n n n ə
realitzo	r e ə l 'i d z o	r ə ə l 'i d z o
realisme	r e ə l 'i z m ə	r ə ə l 'i z m ə
reafirmin	r e ə f 'i ɾ m i n	r ə ə f 'i ɾ m i n
rails	r 'a j l s	r 'a i l s
quedes	k 'e ð ə s	k 'ə ð ə s
preveuen	p ɾ ə v 'ə w ə n	p ɾ ə v 'e w ə n
pretendre	p ɾ ə t 'e n d ɾ ə	p ɾ ə t 'ə n d ɾ ə
preromàntics	p ɾ ə r o m 'a n t i t s	p ɾ ə ɾ o m 'a n t i t s
premsa	p ɾ 'e n s ə	p ɾ 'ə m z ə
precursors	p ɾ ə k u ɾ s 'o s	p ɾ ə k u s 'o s
preciosos	p ɾ ə s i 'o z o s	p ɾ ə s i 'o s o s
precioses	p ɾ ə s i 'o z ə s	p ɾ ə s i 'o s ə s
posés	p o z 'e s	p o s 'e s
posant-ne	p o z 'a n n ə	p o z 'a n n n ə
porta-me-les	p 'o ɾ t ə m ə l ə s	p o ɾ t ə m 'e l ə s
plecs	p l 'e t s	p l 'ə t s
planctòniques	p l ə ŋ t t 'o n i k ə s	p l ə n s t 'o n i k ə s
pertenences	p ə ɾ t ə n 'e n s ə s	p ə ɾ t ə n 'ə n s ə s
perpetren	p ə ɾ p 'e t ɾ ə n	p ə ɾ p 'ə t ɾ ə n
permeables	p ə ɾ m e 'a b b l ə s	p ə ɾ ə e 'a b b l ə s
perdre-la	p 'e ɾ ð ɾ ə l ə	p ə ɾ ð ɾ 'e l ə
perdonant-li	p ə ɾ ð o n 'a n l i	p ə ɾ ð o n 'a n i l i
penetren	p ə n 'e t ɾ ə n	p ə n 'ə t ɾ ə n
oasi	o 'a z i	o 'a s i
nedes	n 'e ð ə s	n 'ə ð ə s
neden	n 'e ð ə n	n 'ə ð ə n
neanderthalensis	n e ə n d ə ɾ t ə l 'e n s i s	n ə ə n d ə ɾ t 'a l 'ə n s i s
naips	n 'a j t s	n 'a i t s
mítings	m 'i t i ŋ s	m 'i t i n s
mosaic	m o z 'a j k	m o z 'a i k
molècules	m o l 'ə k u l ə s	m o l 'e k u l ə s
migcampistes	m i k k ə m p 'i s t ə s	m i ŋ k ə m p 'i s t ə s
metros	m 'e t ɾ o s	m 'ə t ɾ o s
marihuana	m ə ɾ i u 'a n ə	m ə ɾ i ə 'a n ə
maltractaments	m ə l t ɾ ə t t ə m 'e n s	m ə l t ɾ ə t t ə m 'e n t s
ma	m 'ə	m ə
líder	l 'i ð ə	l 'i ð e 
lèxics	l 'e t s i t s	l 'ə t s i t s
lluirà	ʎ u i ɾ 'a	ʎ u j ɾ 'a
llesta	ʎ 'e s t ə	ʎ 'ə s t ə
llenya	ʎ 'e ɲ ə	ʎ 'ə ɲ ə
llengües	ʎ 'e ŋ g w ə s	ʎ 'ə ŋ g w ə s
llenci	ʎ 'e n s i	ʎ 'ə n s i
lepra	l 'e p ɾ ə	l 'ə p ɾ ə
kafkiana	k ə f k i 'a n ə	k ə f i i 'a n ə
jueva	ʒ u 'e v ə	ʒ u 'ə v ə
jamaicans	ʒ ə m ə j k 'a n s	ʒ ə m ə i k 'a n s
intèrpret	i n t 'e ɾ p ɾ ə t	i n t ə ɾ p ɾ 'ə t
interrogant-los	i n t ə r o ɣ 'a n l o s	i n t ə r o ɣ 'a n i l o s
interpretant-la	i n t ə ɾ p ɾ ə t 'a n l ə	i n t ə ɾ p ɾ ə t 'a n t  l ə
ingresses	i ŋ g ɾ 'e s ə s	i ŋ g ɾ 'ə s ə s
impermeables	i m p ə ɾ m e 'a b b l ə s	i m p ə ɾ ə e 'a b b l ə s
ideat	i ð e 'a t	i ð ə 'a t
híbrid	'i β ɾ i t	ə β ɾ i t
horts	'o ɾ s	ə ɾ s
hora	'o ɾ ə	ə ɾ ə
harmonioses	ə ɾ m o n i 'o z ə s	ə ɾ m o n i 'o s ə s
haguessis	ə ɣ 'e s i s	ə ɣ 'ə s i s
habituats	ə β i t u 'a t s	ə β i t u 'a s
gènere	ʒ 'e n ə ɾ ə	ʒ 'ə n ə ɾ ə
guinda	g 'i n d ə	g w 'i n d ə
guetos	g 'e t o s	g 'ə t o s
guard	g w 'a ɾ t	g w 'a ɾ ə
guanyant-me	g w ə ɲ 'a m m ə	g w ə ɲ 'a n m m ə
guacamais	g w ə k ə m 'a j s	g w ə k ə m 'a i s
glòbuls	g l 'o β u l s	g l o β 'u l s
gemecs	ʒ ə m 'e t s	ʒ ə m 'ə t s
frens	f ɾ 'ə n s	f ɾ 'e n s
fotre-li	f 'o t ɾ ə l i	f o t ɾ 'e l i
florint-se	f l o ɾ 'i n s ə	f l o ɾ 'i n t s ə
fletxes	f l 'e tʃ ə s	f l 'ə tʃ ə s
fletxa	f l 'e tʃ ə	f l 'ə tʃ ə
fetus	f 'e t u s	f 'ə t u s
fent-lo	f 'e n l o	f 'e n t  l o
fen	f 'e n	f 'ə n
feixos	f 'e ʃ o s	f 'ə ʃ o s
estómac	ə s t 'o m ə k	ə s t o m 'a k
estudiïn	ə s t u ð 'i i n	ə s t u ð i 'i n
estris	'e s t ɾ i s	'ə s t ɾ i s
estrenyent-me	ə s t ɾ ə ɲ 'e m m ə	ə s t ɾ ə ɲ 'ə n m m ə
estimant-la	ə s t i m 'a n l ə	ə s t i m 'a n t l ə
esment	ə z m 'e n t	e z m 'e n t
esgrogueint-se	ə z ɣ ɾ o ɣ ə 'i n s ə	ə z ɣ ɾ o ɣ u z 'i n t s ə
esglai	ə z ɣ l 'a j	ə z ə l 'a i
esgarrifoses	ə z ɣ ə r i f 'o z ə s	ə z ɣ ə r i f 'o s ə s
escrivint-te	ə s k ɾ i v 'i n t ə	ə s k ɾ i v 'i n t t ə
esclafant-les	ə s k l ə f 'a n l ə s	ə s k l ə f 'a n t  l ə s
escaigui	ə s k 'a j ɣ i	ə s k 'a i ɣ i
ensenyi	ə n s 'e ɲ i	ə n s 'ə ɲ i
endreço	ə n d ɾ 'e s o	ə n d ɾ 'ə s o
encabeixi	ə ŋ k ə β 'e ʃ i	ə ŋ k ə β 'ə ʃ i
empentes	ə m p 'ə n t ə s	ə m p 'e n t ə s
empenta	ə m p 'ə n t ə	ə m p 'e n t ə
emborratxant-me	ə m b o r ə tʃ 'a m m ə	ə m b o r ə tʃ 'a n m m ə
embolicant-se	ə m b o l i k 'a n s ə	ə m b o l i k 'a n t s ə
elèctrica	ə l 'ə t t ɾ i k ə	ə l ə t t ɾ 'i k ə
dòlar	d 'o l ə	d o l 'a
dèficits	d 'e f i s i t s	d ə f i s 'i t s
donant-nos	d o n 'a n n o s	d o n 'a n n n o s
donant-los	d o n 'a n l o s	d o n 'a n i l o s
donant-li	d o n 'a n l i	d o n 'a n i l i
dodecàedres	d o ð ə k 'a ə ð ɾ ə s	d o ð ə t s ə ð ɾ ə s
divuitè	d i v u j t 'ə	d i v u i t 'ə
divuitena	d i v u j t 'ə n ə	d i v u i t 'ə n ə
distribuïts	d i s t ɾ i β u 'i t s	d i s t ɾ i β u 'i s
distreuen	d i s t ɾ 'ə w ə n	d i s t ɾ 'e w ə n
distingint	d i s t i n ʒ 'i n t	d i s t i ŋ g 'i n t
disminuïts	d i z m i n u 'i t s	d i z m i n u 'i s
discrepo	d i s k ɾ 'e p o	d i s k ɾ 'ə p o
discjòqueis	d i s k ʒ 'o k ə j s	d i s k ʒ o k 'ə j s
dibuixant-me	d i β u ʃ 'a m m ə	d i β u ʃ 'a n m m ə
desplegant-se	d ə s p l ə ɣ 'a n s ə	d ə s p l ə ɣ 'a n t s ə
deslluïts	d ə z ʎ u 'i t s	d ə z ʎ u 'i s
desitgem	d ə z i dʒ 'ə m	d ə z i tʃ 'ə m
desigs	d ə z 'i tʃ s	d ə z 'i n s
designar	d ə z i n n 'a	d ə z i ə n 'a
deltaic	d ə l t 'a j k	d ə l t 'a i k
delinqüents	d ə l i ŋ k w 'e n s	d ə l i n ə w 'e n s
deixes	d 'e ʃ ə s	d 'ə ʃ ə s
decibels	d ə s i β 'e l s	d ə s i β 'ə l s
cònjuge	k 'o n ʒ u ʒ ə	k o n ʒ 'u ʒ ə
còmplices	k 'o m p l i s ə s	k o m p l 'i s ə s
cuinera	k u j n 'e ɾ ə	k u i n 'e ɾ ə
cuinar	k u j n 'a	k u i n 'a
cuidava	k u j ð 'a v ə	k u i ð 'a v ə
cuidant	k u j ð 'a n t	k u i ð 'a n t
creïn	k ɾ 'e i n	k ɾ ə 'i n
crepitegen	k ɾ ə p i t 'e ʒ ə n	k ɾ ə p i t 'ə ʒ ə n
cremes	k ɾ 'e m ə s	k ɾ 'ə m ə s
cremen	k ɾ 'e m ə n	k ɾ 'ə m ə n
crema	k ɾ 'e m ə	k ɾ 'ə m ə
contenen	k o n t 'e n ə n	k o n t 'ə n ə n
contemplant-li	k o n t ə m p l 'a n l i	k o n t ə m p l ə n 'o l i
construïts	k o n s t ɾ u 'i t s	k o n s t ɾ u 'i s
conseqüents	k o n s ə k w 'e n s	k o n s ə ə w 'e n s
conseqüent	k o n s ə k w 'e n t	k o n s ə ə w 'e n t
comtats	k o n t 'a t s	k o ə t 'a t s
completa-la	k o m p l 'ə t ə l ə	k o m p l ə t 'a l ə
complauen	k o m p l 'a w ə n	k o m p l 'a ə n
comences	k o m 'e n s ə s	k o m 'ə n s ə s
colpeja	k o l p 'e ʒ ə	k o l p 'ə ʒ ə
coloraines	k o l o ɾ 'a j n ə s	k o l o ɾ 'a i n ə s
cofoi	k o f 'o j	k o f 'o i
clavant-li	k l ə v 'a n l i	k l ə v ə n 'e l i
centígrads	s ə n t 'i ɣ ɾ ə t s	s ə n t i ɣ ɾ 'a t s
celebren	s ə l 'e β ɾ ə n	s ə l 'ə β ɾ ə n
casés	k ə z 'e s	k ə s 'e s
castigant-se	k ə s t i ɣ 'a n s ə	k ə s t i ɣ 'a n t s ə
cars	k 'a s	k 'a ɾ s
carai	k ə ɾ 'a j	k ə ɾ 'a i
caracteritzant-lo	k ə ɾ ə t t ə ɾ i d z 'a n l o	k ə ɾ ə t t ə ɾ i d z 'a n i l o
capmàs	k ə m m 'a s	k ə p m 'a s
capbussar	k ə b b u s 'a	k ə p β u s 'a
bàdminton	b 'a m m i n t o n	b ə m m i n t 'o n
buidor	b u j ð 'o	b u i ð 'o
boirina	b o j ɾ 'i n ə	b o i ɾ 'i n ə
bodegues	b o ð 'ə ɣ ə s	b o ð 'e ɣ ə s
beuen	b 'ə w ə n	b 'e w ə n
bes	b 'e s	b 'ə s
beneficiosa	b ə n ə f i s i 'o z ə	b ə n ə f i s i 'o s ə
beatífic	b e ə t 'i f i k	b ə ə t 'i f i k
beata	b e 'a t ə	ə e 'a t ə
basés	b ə z 'e s	b ə s 'e s
barbs	b 'a ɾ t s	b 'a ɾ i s
atribuir-ho	ə t ɾ i β u 'i ɾ o	ə t ɾ i β u i ɾ 'o
assignar	ə s i n n 'a	ə s i ə n 'a
assaigs	ə s 'a tʃ s	ə s ə 'i ə s
assaborint-ne	ə s ə β o ɾ 'i n n ə	ə s ə β o ɾ 'i n n n ə
asimètrica	ə s i m 'e t ɾ i k ə	ə z i m 'e t ɾ i k ə
arrossegant-se	ə r o s ə ɣ 'a n s ə	ə r o s ə ɣ 'a n t s ə
arregla	ə r 'e g g l ə	ə r 'ə g g l ə
apartant-lo	ə p ə ɾ t 'a n l o	ə p ə ɾ t 'a n i l o
anorèxica	ə n o ɾ 'e t s i k ə	ə n o ɾ 'ə t s i k ə
anorèxia	ə n o ɾ 'e t s i ə	ə n o ɾ 'ə t s i ə
anhelant-la	ə n ə l 'a n l ə	ə n ə l 'a n t  l ə
angoixa	ə ŋ g 'o ʃ ə	ə ŋ g o 'i ʃ ə
amagant-li	ə m ə ɣ 'a n l i	ə m ə ɣ 'a n i l i
alts	'a l s	'a l t s
alinear	ə l i n e 'a	ə l i n ə 'a
algebraic	ə l ʒ ə β ɾ 'a j k	ə l ʒ ə β ɾ 'a i k
alegre	ə l 'e ɣ ɾ ə	ə l 'ə ɣ ɾ ə
ajudant-la	ə ʒ u ð 'a n l ə	ə ʒ u ð 'a n i l ə
agraïts	ə ɣ ɾ ə 'i t s	ə ɣ ɾ ə 'i s
afruitat	ə f ɾ u j t 'a t	ə f ɾ u i t 'a t
adscrit	ə s k ɾ 'i t	ə t s k ɾ 'i t
aconseguint	ə k o n s ə ɣ 'i n t	ə k o n s ə ɣ u 'i n t
acceptant-la	ə t s ə t t 'a n l ə	ə t s ə t t 'a n t  l ə
a	'ə	ə
Zürich	z u ɾ 'i k	ə w ɾ 'i k ə
Weissmann	b ə j s m 'a n n	b ə i s m 'a n n
Webs	b 'e t s	b 'ə t s
Venus	v 'e n u s	v 'ə n u s
Ve	v 'e	v 'ə
Unesco	u n 'e s k o	u n 'ə s k o
Ulldemol	u ʎ d ə m 'o l	u ʎ ð ə m 'o l
Tema	t 'e m ə	t 'ə m ə
Te	t 'ə	t ə
Taipei	t ə j p 'ə j	t ə i p 'ə j
Tailàndia	t ə j l 'a n d i ə	t ə i l 'a n d i ə
Suècia	s u 'e s i ə	s u t s i ə
Sistemes	s i s t 'e m ə s	s i s t 'ə m ə s
Sistema	s i s t 'e m ə	s i s t 'ə m ə
Realisme	r e ə l 'i z m ə	r ə ə l 'i z m ə
Quedo	k 'e ð o	k 'ə ð o
Pingu	p 'i ŋ g u	p 'i ŋ g w
Pakistan	p ə k i s t 'a n	p ə z i s t 'a n
Pablo	p 'a β l o	p 'a b b l o
Nois	n 'o j s	n 'o i s
Mètode	m 'e t o ð ə	m 'ə t o ð ə
Munich	m u n 'i k	m u n 'i k ə
Mossegant-se	m o s ə ɣ 'a n s ə	m o s ə ɣ 'a n t s ə
Montseny	m o n s 'ə ɲ	m o n t s 'ə ɲ
Menja	m 'e n ʒ ə	m 'ə n ʒ ə
Martens	m ə ɾ t 'ə n s	m ə ɾ t 'e n s
Légolas	l 'e ɣ o l ə s	l ə ɣ o l 'a s
Lèxic	l 'e t s i k	l 'ə t s i k
Lo	l 'o	l o
Lluch	ʎ 'u k	ʎ 'u k ə
Llevo	ʎ 'e v o	ʎ 'ə v o
Leandre	l e 'a n d ɾ ə	ə e 'a n d ɾ ə
Kirsten	k 'i ɾ s t ə n	k 'i s t ə n
Hug	'u k	'a k
Horta	'o ɾ t ə	ə ɾ t ə
Haig	'a tʃ	a 'i ə
Günther	g w n t 'e	g u n ə 'e
Gènere	ʒ 'e n ə ɾ ə	ʒ 'ə n ə ɾ ə
Guies	g 'i ə s	g w 'i ə s
Floraina	f l o ɾ 'a j n ə	f l o ɾ 'a i n ə
Fent-ho	f 'e n t o	f ə n t 'o
Entren	'e n t ɾ ə n	'ə n t ɾ ə n
Elisenda	ə l i z 'e n d ə	ə l i s 'e n d ə
Ebre	'e β ɾ ə	'ə β ɾ ə
Ebre	'e β ɾ ə	'ə β ɾ ə
EAJA	e 'a ʒ ə	ə 'a ʒ ə
Distingir	d i s t i n ʒ 'i	d i s t i ŋ g 'i
Detroit	d ə t ɾ 'o j t	d ə t ɾ o 'i t
Creui	k ɾ 'e w i	k ɾ 'e i
Creador	k ɾ e ə ð 'o	k ɾ ə ə ð 'o
Copia-la	k o p 'i ə l ə	k o p i 'a l ə
Comences	k o m 'e n s ə s	k o m 'ə n s ə s
Chirac	tʃ i ɾ 'a k	k i ɾ 'a k
Caterina	k ə t ə ɾ 'i n ə	 k e t ə ɾ 'i n ə
Bohigas	b o 'i ɣ ə s	b o 'a ɣ ə s
Bangkok	b ə ŋ k k 'o k	b ə ŋ g k 'o k
Ai	'a j	'a i
el	'ə l	ə l
amb	'ə m	 e m b
oi	'o j	'o i
es	'ə s	ə s
el	'ə l	ə l
a	'ə	ə
Si	s 'i	s i
Li	l 'i	l i
I	'i	i
Ho	'o	o
He	'e	'a
Et	'ə t	ə t
que	k 'ə	k ə
hi	'i	i
guerra	g 'e r ə	g w 'e r ə
Si	s 'i	s i
Queda	k 'e ð ə	k 'ə ð ə
I	'i	i
He	'e	'a
Amb	'ə m	 e m b
xilens	ʃ i l 'ə n s	ʃ i l 'e n s
venda	v 'ə n d ə	v 'e n d ə
ultimàtum	u l t i m 'a t u m	u l t i m ə t 'u m
túnels	t 'u n ə l s	t u n 'e l s
treva	t ɾ 'e v ə	t ɾ 'ə v ə
terrissaires	t ə r i s 'a j ɾ ə s	t ə r i s 'a i ɾ ə s
temple	t 'e m p l ə	t 'ə m p l ə
símbols	s 'i m b o l s	s i m b 'o l s
sys	s 'i s	s s
suspens	s u s p 'ə n s	s u s p 'e n s
surrealisme	s u r e ə l 'i z m ə	s u r ə ə l 'i z m ə
sexi	s 'e t s i	s 'ə t s i
segles	s 'e g g l ə s	s 'e ɣ l ə s
ruixats	r u ʃ 'a t s	r i ʃ 'a t s
repugnant	r ə p u n n 'a n t	r ə p u ə n 'a n t
rebérem	r ə β 'e ɾ ə m	r ə β ə ɾ 'ə m
pàrquings	p 'a ɾ k i ŋ s	p 'a ɾ k i n s
proveïts	p ɾ o v ə 'i t s	p ɾ o v ə 'i s
promig	p ɾ o m 'i tʃ	p ɾ o m 'i k
promig	p ɾ o m 'i tʃ	p ɾ o m 'i k
progressos	p ɾ o ɣ ɾ 'e s o s	p ɾ o ɣ ɾ 'ə s o s
procreat	p ɾ o k ɾ e 'a t	p ɾ o k ɾ ə 'a t
pretenen	p ɾ ə t 'e n ə n	p ɾ ə t 'ə n ə n
preat	p ɾ e 'a t	p ɾ ə 'a t
pircings	p i ɾ s 'i ŋ s	p i ɾ s 'i n ə s
picant-li	p i k 'a n l i	p i k 'a n t  l i
pertinences	p ə ɾ t i n 'e n s ə s	p ə ɾ t i n 'ə n s ə s
peatons	p e ə t 'o n s	p ə ə t 'o n s
peatge	p e 'a dʒ ə	p ə 'a dʒ ə
ofèn	o f 'ə n	o f 'e n
obligant-la	o β l i ɣ 'a n l ə	o β l i ɣ 'a n i l ə
nervioses	n ə ɾ v i 'o z ə s	n ə ɾ v i 'o s ə s
mirant-ne	m i ɾ 'a n n ə	m i ɾ 'a n n n ə
minuciosa	m i n u s i 'o z ə	m i n u s i 'o s ə
melangia	m ə l ə n ʒ 'i ə	m ə l ə ŋ g 'i ə
malestars	m ə l ə s t 'a s	m ə l ə s t 'a ɾ s
maleint-me	m ə l ə 'i m m ə	m ə l 'ə j n t m ə
lluitaven	ʎ u j t 'a v ə n	ʎ u i t 'a v ə n
lletja	ʎ 'e dʒ ə	ʎ 'ə dʒ ə
llestos	ʎ 'e s t o s	ʎ 'ə s t o s
llebre	ʎ 'e β ɾ ə	ʎ 'ə β ɾ ə
kosovars	k o z o v 'a s	k o z o v 'a ɾ s
jazz	ʒ 'a s	ʒ 'a z ə
irreals	i r e 'a l s	i r ə 'a l s
interpreto	i n t ə ɾ p ɾ 'e t o	i n t ə ɾ p ɾ 'ə t o
inspeccionant-la	i n s p ə t s i o n 'a n l ə	i n s p ə t s i o n 'a n i l ə
ingressos	i ŋ g ɾ 'e s o s	i ŋ g ɾ 'ə s o s
incrèdul	i ŋ k ɾ 'e ð u l	i ŋ k ɾ 'ə ð u l
idealitzen	i ð e ə l 'i d z ə n	i ð ə ə l 'i d z ə n
heroi	ə ɾ 'o j	ə ɾ 'o i
guèiser	g 'ə j z ə	g 'ə i z ə
guerxos	g 'e ɾ ʃ o s	g w 'e ɾ ʃ o s
guerres	g 'e r ə s	g w 'e r ə s
guerra	g 'e r ə	g w 'e r ə
ginebra	ʒ i n 'e β ɾ ə	ʒ i n 'ə β ɾ ə
gemma	ʒ 'e m m ə	ʒ 'ə m m ə
fent-los	f 'e n l o s	f ə n 'e l o s
fent-la	f 'e n l ə	f 'e n t  l ə
febre	f 'e β ɾ ə	f 'ə β ɾ ə
exsoci	ə t s 'o s i	ə s 'o s i
estrangers	ə s t ɾ ə n ʒ 'e s	ə s t ɾ ə ŋ g 'e s
espaguetis	ə s p ə ɣ 'e t i s	ə s p ə ɣ u 'e t i s
eso	'e s o	'ə z o
enganxant-ne	ə ŋ g ə n ʃ 'a n n ə	ə ŋ g ə n ʃ 'a n n n ə
ene	'e n ə	'ə n ə
ego	'e ɣ o	'ə ɣ o
efebus	ə f 'e β u s	ə f 'ə β u s
dècimes	d 'ə s i m ə s	d ə s i m ə s
dècim	d 'ə s i m	d ə s i m
dèbils	d 'ə β i l s	d 'e β i l s
dèbils	d 'ə β i l s	d 'e β i l s
dutxant-me	d u tʃ 'a m m ə	d u tʃ 'a n m m ə
dient-me	d i 'e m m ə	d i 'e n t m ə
dient-me	d i 'e m m ə	d i 'e n t m ə
dient-li	d i 'e n l i	d i ə n 'e l i
diamants	d i ə m 'a n s	d i ə m 'a n t s
designés	d ə z i n n 'e s	d ə z i ə n 'e s
daina	d 'a j n ə	d 'a i n ə
càmpings	k 'a m p i ŋ s	k 'a m p i n s
cuinats	k u j n 'a t s	k u i n 'a t s
crearien	k ɾ e ə ɾ 'i ə n	k ɾ ə ə ɾ 'i ə n
creadors	k ɾ e ə ð 'o s	k ɾ ə ə ð 'o s
creadora	k ɾ e ə ð 'o ɾ ə	k ɾ ə ə ð 'o ɾ ə
contempla	k o n t 'e m p l ə	k o n t 'ə m p l ə
conscienciós	k o n t s i ə n s i 'o s	k o n s i ə n s i 'o s
conscienciació	k o n t s i ə n s i ə s i 'o	k o n s i ə n s i ə s i 'o
clixés	k l i ʃ 'e s	k l ʃ 'e s
cereals	s ə ɾ e 'a l s	s ə ɾ ə 'a l s
caiguin	k 'a j ɣ i n	k 'a i ɣ i n
buidant	b u j ð 'a n t	b u i ð 'a n t
be	b 'e	b 'ə
banquers	b ə ŋ k 'e s	 b e ŋ k 'e s
atapeïts	ə t ə p ə 'i t s	ə t ə p ə 'i s
assecant-se	ə s ə k 'a n s ə	ə s ə k 'a n t s ə
ascens	ə t s 'ə n s	ə t s 'e n s
arruinada	ə r u j n 'a ð ə	ə r u i n 'a ð ə
arremangant-se	ə r ə m ə ŋ g 'a n s ə	ə r ə m ə ŋ g 'a n t s ə
apèndix	ə p 'ə n d i t s	ə p 'e n d i t s
amants	ə m 'a n s	ə m 'a n t s
actuïn	ə t t 'u i n	ə t t u 'i n
abertzale	ə β ə ɾ d z 'a l ə	ə β ə ɾ ə z 'a l ə
Ull	'u j	'u ʎ
Sens	s 'ə n s	s 'e n s
Ruth	r 'u t	r 'u t ə
Poder	p o ð 'ə	p o ð 'e
Parisien	p ə ɾ i z 'i ə n	p ə ɾ i s 'i ə n
Montevideo	m o n t ə v i ð 'e o	m o n t ə v i ð 'ə o
Mes	m 'e s	m 'ə s
Lègolas	l 'ə ɣ o l ə s	l ə ɣ o l 'a s
Le	l 'e	l 'ə
Hèlsinki	'e l s i ŋ k i	'e l s i n i
Huc	'u k	'a k
Hisenda	i z 'e n d ə	i s 'e n d ə
Grand	g ɾ 'a n t	g ɾ 'a n ə
Folch	f 'o l k	f 'o l k ə
Endreço	ə n d ɾ 'e s o	ə n d ɾ 'ə s o
Dreamweaver	d ɾ e ə m b e ə v 'e	d ɾ e ə m ə ə v 'e
Cibeles	s i β 'e l ə s	s i β 'ə l ə s
Ben	b 'e n	b 'ə n
Beirut	b ə j ɾ 'u t	b ə i ɾ 'u t
habitualment	ə β i t u ˌ a l m 'e n t	ə β i t u ə l m 'e n t
habituats	ə β i t u 'a t s	ə β i t u 'a s
haguda	ə ɣ 'u ð ə	a ɣ 'u ð ə
hagudes	ə ɣ 'u ð ə s	a ɣ 'u ð ə s
haguessen	ə ɣ 'e s ə n	ə ɣ 'ə s ə n
haguesses	ə ɣ 'e s ə s	ə ɣ 'ə s ə s
haguessis	ə ɣ 'e s i s	ə ɣ 'ə s i s
hagut	ə ɣ 'u t	a ɣ 'u t
haguts	ə ɣ 'u t s	a ɣ 'u t s
hagué	ə ɣ 'e	ə ɣ 'ə
haguéɾem	ə ɣ 'e ɾ ə m	ə ɣ ə ɾ 'ə m
haguéɾeu	ə ɣ 'e ɾ ə w	ə ɣ ə ɾ 'e w
haguéssem	ə ɣ 'e s ə m	ə ɣ ə s 'ə m
haguésseu	ə ɣ 'e s ə w	ə ɣ ə s 'e w
haguéssim	ə ɣ 'e s i m	ə ɣ ə s 'i m
haguéssiu	ə ɣ 'e s i w	ə ɣ ə s 'i w
haia	'a j ə	a 'i ə
haig	'a tʃ	a 'i ə
haitians	ə j t i 'a n s	ə i t i 'a n s
haití	ə j t 'i	ə i t 'i
halteɾofília	ə l t ə ɾ o f 'i l i ə	ə l t ə ɾ o f i l 'i ə
hannoveɾ	ə n n o v 'e	ə n n o v 'ə
haɾdwaɾe	'a ɾ u ə	ə ɾ u 'a ɾ ə
haɾmonioses	ə ɾ m o n i 'o z ə s	ə ɾ m o n i 'o s ə s
haɾmònic	ə ɾ m 'o n i k	ə ɾ m ə n 'i k
haɾmònica	ə ɾ m 'o n i k ə	ə ɾ m ə n 'i k ə
haɾmònicament	ə ɾ m ˌ o n i k ə m 'e n t	ə ɾ m ə n i k ə m 'e n t
haɾmònics	ə ɾ m 'o n i t s	ə ɾ m ə n 'i t s
haɾmòniques	ə ɾ m 'o n i k ə s	ə ɾ m ə n 'i k ə s
hauɾé	ə w ɾ 'e	ə w ɾ 'ə
hauɾíem	ə w ɾ 'i ə m	ə w ɾ i 'ə m
hauɾíeu	ə w ɾ 'i ə w	ə w ɾ i 'e w
hemofília	ə m o f 'i l i ə	ə m o f i l 'i ə
hemoràgia	ə m o r 'a ʒ i ə	ə m o ɾ ə ʒ 'i ə
hemoràgies	ə m o r 'a ʒ i ə s	ə m o ɾ ə ʒ 'i ə s
hepàtic	ə p 'a t i k	ə p ə t 'i k
heɾbívoɾ	ə ɾ β 'i v o ɾ	ə ɾ β i v 'o
heɾbívoɾs	ə ɾ β 'i v o ɾ s	ə ɾ β i v 'o s
heɾeditàɾia	ə ɾ ə ð i t 'a ɾ i ə	ə ɾ ə ð i t ə ɾ 'i ə
heɾeditàɾies	ə ɾ ə ð i t 'a ɾ i ə s	ə ɾ ə ð i t ə ɾ 'i ə s
heɾeten	ə ɾ 'e t ə n	ə ɾ 'ə t ə n
incoheɾència	i ŋ k o ə ɾ 'e n s i ə	i ŋ k o ə ɾ ə n s 'i ə
incoheɾències	i ŋ k o ə ɾ 'e n s i ə s	i ŋ k o ə ɾ ə n s 'i ə s
inhalatòɾia	i n ə l ə t 'o ɾ i ə	i n ə l ə t o ɾ 'i ə
inhibeix	i n i β 'ə ʃ	i n i β 'e ʃ
inhòspit	i n 'o s p i t	i n o s p 'i t
inhòspita	i n 'o s p i t ə	i n o s p 'i t ə
macɾohistòɾia	m ə k ɾ o i s t 'o ɾ i ə	m ə k ɾ o i s t o ɾ 'i ə
