Lleida	ʎ 'e j ð ə
xeic	ʃ 'e j k
Lleida	ʎ 'e j ð ə
caient	 k e j 'e n t 
ajaient	 e ʒ e j 'e n t 
decaient	 d e k e j 'e n t 
Bocairent	 b o k e j ɾ 'e n t 
aiguavent	 e j ɣ u e v 'e n t 
baier	 b e j 'e 
Aiòder	 e j 'ɔ ð e 
aiguer	 e j ɣ 'e 
aioder	 e j o ð 'e 
feyder	 f e j ð 'e 
aldaier	 e l d e j 'e 
copaier	 k o p e j 'e 
gaianer	 g e j e n 'e 
homeier	 o m e j 'e 
meitner	 m e j n n 'e 
Aiguader	 e j ɣ u e ð 'e 
Mainader	 m e j n e ð 'e 
aieloner	 e j e l o n 'e 
aiguader	 e j ɣ u e ð 'e 
