Abraham	ə β ɾ ə 'a m
adherència	ə ð ə ɾ 'ɛ n s i ə
adherències	ə ð ə ɾ 'ɛ n s i ə s
adherida	ə ð ə ɾ 'i ð ə
adherides	ə ð ə ɾ 'i ð ə s
adherir	ə ð ə ɾ 'i
adherit	ə ð ə ɾ 'i t
adherits	ə ð ə ɾ 'i t s
adhesiu	ə ð ə z 'i w
ahir	ə 'i
alcohol	ə l k o 'ɔ l
alcoholisme	ə l k o o l 'i z m ə
aldehid	ə l d ə 'i t
amhàric	ə m 'a ɾ i k
anhel	ə n 'ɛ l
anhela	ə n 'ɛ l ə
anhelada	ə n ə l 'a ð ə
anhelades	ə n ə l 'a ð ə s
anhelant	ə n ə l 'a n t
anhelar	ə n ə l 'a
anhelat	ə n ə l 'a t
anhelats	ə n ə l 'a t s
anheli	ə n 'ɛ l i
anhelis	ə n 'ɛ l i s
anhelo	ə n 'ɛ l o
anihilar	ə n i i l 'a
aprehendre	ə p ɾ ə 'ɛ n d ɾ ə
austrohongarès	ə w s t ɾ o o ŋ g ə ɾ 'ə s
bhutanès	b u t ə n 'ə s
Bohèmia	b o 'ɛ m i ə
cohabitar	k o ə β i t 'a
coherències	k o ə ɾ 'ɛ n s i ə s
Copenhaguen	k o p ə n 'a ɣ ə n
deshidratar	d ə s i ð ɾ ə t 'a
deshumanitzada	d ə s u m ə n i d z 'a ð ə
deshumanitzades	d ə s u m ə n i d z 'a ð ə s
deshumanitzar	d ə s u m ə n i d z 'a
deshumanitzat	d ə s u m ə n i d z 'a t
deshumanitzats	d ə s u m ə n i d z 'a t s
dírham	d 'i ɾ ə m
formaldehid	f o ɾ m ə l d ə 'i t
Ghana	g 'a n ə
ghanès	g ə n 'ə s
hàbil	'a β i l
habilitació	ə β i l i t ə s i 'o
habilitada	ə β i l i t 'a ð ə
habilitades	ə β i l i t 'a ð ə s
habilitar	ə β i l i t 'a
habilitat	ə β i l i t 'a t
habilitats	ə β i l i t 'a t s
hàbit	'a β i t
habitable	ə β i t 'a b b l ə
habitació	ə β i t ə s i 'o
habitacle	ə β i t 'a k l ə
habitada	ə β i t 'a ð ə
habitades	ə β i t 'a ð ə s
habitar	ə β i t 'a
habitat	ə β i t 'a t
hàbitat	'a β i t ə t
habitatge	ə β i t 'a dʒ ə
habitats	ə β i t 'a t s
hàbitats	'a β i t ə t s
habitual	ə β i t u 'a l
habitud	ə β i t 'u t
hadró	ə ð ɾ 'o
hagi	'a ʒ i
hàgim	'a ʒ i m
hàgiu	'a ʒ i w
haguda	ə ɣ 'u ð ə
hagudes	ə ɣ 'u ð ə s
hagut	ə ɣ 'u t
haguts	ə ɣ 'u t s
haixix	ə ʃ 'i ʃ
hala	'a l ə
halada	ə l 'a ð ə
halades	ə l 'a ð ə s
halal	ə l 'a l
halat	ə l 'a t
halats	ə l 'a t s
halibut	ə l i β 'u t
halitosi	ə l i t 'ɔ z i
halòfit	ə l 'ɔ f i t
halogen	ə l 'ɔ ʒ ə n
halur	ə l 'u
hamaca	ə m 'a k ə
hamburguès	ə m b u ɾ ɣ 'ə s
hamburguesa	ə m b u ɾ ɣ 'ə z ə
handbol	ə n d b 'ɔ l
haptè	ə t t 'ə
haram	ə ɾ 'a m
harem	ə ɾ 'ə m
harmonia	ə ɾ m o n 'i ə
harmònic	ə ɾ m 'ɔ n i k
harmònica	ə ɾ m 'ɔ n i k ə
harmoniós	ə ɾ m o n i 'o s
harmonitzada	ə ɾ m o n i d z 'a ð ə
harmonitzades	ə ɾ m o n i d z 'a ð ə s
harmonitzar	ə ɾ m o n i d z 'a
harmonitzat	ə ɾ m o n i d z 'a t
harmonitzats	ə ɾ m o n i d z 'a t s
harpia	ə ɾ p 'i ə
haurà	ə w ɾ 'a
hauré	ə w ɾ 'e
haver	ə v 'ə
havia	ə v 'i ə
hebraic	ə β ɾ 'a j k
hebraista	ə β ɾ ə 'i s t ə
hec	'ɛ k
hectàrea	ə t t 'a ɾ e ə
hectòmetre	ə t t 'ɔ m ə t ɾ ə
hegui	'ɛ ɣ i
heguin	'ɛ ɣ i n
heguis	'ɛ ɣ i s
helicotrema	ə l i k o t ɾ 'ɛ m ə
heliogràfic	ə l i o ɣ ɾ 'a f i k
heliogràfica	ə l i o ɣ ɾ 'a f i k ə
heliogràfics	ə l i o ɣ ɾ 'a f i t s
heliogràfiques	ə l i o ɣ ɾ 'a f i k ə s
heliotropi	ə l i o t ɾ 'ɔ p i
hemangioma	ə m ə n ʒ i 'ɔ m ə
hemàtic	ə m 'a t i k
hemàtica	ə m 'a t i k ə
hemàtics	ə m 'a t i t s
hemàtiques	ə m 'a t i k ə s
hematologia	ə m ə t o l o ʒ 'i ə
hematúria	ə m ə t 'u ɾ i ə
hematúric	ə m ə t 'u ɾ i k
hematúrica	ə m ə t 'u ɾ i k ə
hematúrics	ə m ə t 'u ɾ i t s
hematúriques	ə m ə t 'u ɾ i k ə s
hemeroteca	ə m ə ɾ o t 'ɛ k ə
hemianòpsia	ə m i ə n 'ɔ t s i ə
hemianòpsies	ə m i ə n 'ɔ t s i ə s
heparina	ə p ə ɾ 'i n ə
hepàtic	ə p 'a t i k
hepàtica	ə p 'a t i k ə
hepàtics	ə p 'a t i t s
hepàtiques	ə p 'a t i k ə s
hepatitis	ə p ə t 'i t i s
heptàgon	ə t t 'a ɣ o n
heptagonal	ə t t ə ɣ o n 'a l
heptè	ə t t 'ə
heptilè	ə t t i l 'ə
heràldic	ə ɾ 'a l d i k
heràldica	ə ɾ 'a l d i k ə
herbaci	ə ɾ β 'a s i
herbassar	ə ɾ β ə s 'a
herbei	ə ɾ β 'ə j
herbívora	ə ɾ β 'i v o ɾ ə
herbívores	ə ɾ β 'i v o ɾ ə s
herbolari	ə ɾ β o l 'a ɾ i
herculi	ə ɾ k 'u l i
hereditari	ə ɾ ə ð i t 'a ɾ i
herència	ə ɾ 'ɛ n s i ə
heretar	ə ɾ ə t 'a
heretat	ə ɾ ə t 'a t
heretgia	ə ɾ ə dʒ 'i ə
herètic	ə ɾ 'ɛ t i k
herètica	ə ɾ 'ɛ t i k ə
herètics	ə ɾ 'ɛ t i t s
herètiques	ə ɾ 'ɛ t i k ə s
hereu	ə ɾ 'ɛ w
hermafroditisme	ə ɾ m ə f ɾ o ð i t 'i z m ə
hermenéutica	ə ɾ m ə n 'e w t i k ə
hermètic	ə ɾ m 'ɛ t i k
hèrnia	'ɛ ɾ n i ə
herniar	ə ɾ n i 'a
herniari	ə ɾ n i 'a ɾ i
herniària	ə ɾ n i 'a ɾ i ə
heroi	ə ɾ 'ɔ j
heroic	ə ɾ 'ɔ j k
heroïcitat	ə ɾ o i s i t 'a t
heroïcitats	ə ɾ o i s i t 'a t s
heroïna	ə ɾ o 'i n ə
heroisme	ə ɾ o 'i z m ə
hèrptil	'ɛ ɾ t t i l
hesitació	ə z i t ə s i 'o
hesitada	ə z i t 'a ð ə
hesitades	ə z i t 'a ð ə s
hesitar	ə z i t 'a
hesitat	ə z i t 'a t
hesitats	ə z i t 'a t s
heterogeni	ə t ə ɾ o ʒ 'ɛ n i
heu	'ɛ w
heura	'ɛ w ɾ ə
heure	'ə w ɾ ə
heus	'ɛ w s
hevea	ə v 'ɛ ə
hexàgon	ə t s 'a ɣ o n
hexàpode	ə t s 'a p o ð ə
hibernació	i β ə ɾ n ə s i 'o
hibernada	i β ə ɾ n 'a ð ə
hibernades	i β ə ɾ n 'a ð ə s
hibernar	i β ə ɾ n 'a
hibernat	i β ə ɾ n 'a t
hibernats	i β ə ɾ n 'a t s
hibisc	i β 'i s k
híbrid	'i β ɾ i t
hibridació	i β ɾ i ð ə s i 'o
hibridar	i β ɾ i ð 'a
hibridat	i β ɾ i ð 'a t
hibridí	i β ɾ i ð 'i
hidrant	i ð ɾ 'a n t
hidratant	i ð ɾ ə t 'a n t
hidratar	i ð ɾ ə t 'a
hidroavió	i ð ɾ o ə v i 'o
hidroelèctric	i ð ɾ o ə l 'ɛ t t ɾ i k
hidroelèctrica	i ð ɾ o ə l 'ɛ t t ɾ i k ə
hidroelèctrics	i ð ɾ o ə l 'ɛ t t ɾ i t s
hidroelèctriques	i ð ɾ o ə l 'ɛ t t ɾ i k ə s
hidrogenada	i ð ɾ o ʒ ə n 'a ð ə
hidrogenades	i ð ɾ o ʒ ə n 'a ð ə s
hidrogenar	i ð ɾ o ʒ ə n 'a
hidrogenat	i ð ɾ o ʒ ə n 'a t
hidrogenats	i ð ɾ o ʒ ə n 'a t s
hidrografia	i ð ɾ o ɣ ɾ ə f 'i ə
hidrogràfic	i ð ɾ o ɣ ɾ 'a f i k
hidrogràfica	i ð ɾ o ɣ ɾ 'a f i k ə
hidrogràfics	i ð ɾ o ɣ ɾ 'a f i t s
hidrogràfiques	i ð ɾ o ɣ ɾ 'a f i k ə s
hidromassatge	i ð ɾ o m ə s 'a dʒ ə
hidromel	i ð ɾ o m 'ɛ l
hidroxibenzè	i ð ɾ o t s i β ə n z 'ə
hidroxinaftalè	i ð ɾ o t s i n ə f t ə l 'ə
hieràtic	j ə ɾ 'a t i k
hieràtics	j ə ɾ 'a t i t s
higiene	i ʒ i 'e n ə
higiènic	i ʒ i 'ɛ n i k
higiènica	i ʒ i 'ɛ n i k ə
higiènics	i ʒ i 'ɛ n i t s
higièniques	i ʒ i 'ɛ n i k ə s
himen	'i m ə n
hinduisme	i n d u 'i z m ə
hiperactiu	i p ə ɾ ə t t 'i w
hiperactius	i p ə ɾ ə t t 'i w s
hiperactiva	i p ə ɾ ə t t 'i v ə
hiperactives	i p ə ɾ ə t t 'i v ə s
hiperactivitat	i p ə ɾ ə t t i v i t 'a t
hipèrbaton	i p 'ɛ ɾ β ə t o n
hipèrbola	i p 'ɛ ɾ β o l ə
hipèrbole	i p 'ɛ ɾ β o l ə
hiperbòlic	i p ə ɾ β 'ɔ l i k
hiperbori	i p ə ɾ β 'ɔ ɾ i
hiperespai	i p ə ɾ ə s p 'a j
hiperespais	i p ə ɾ ə s p 'a j s
hipergegant	i p ə ɾ ʒ ə ɣ 'a n t
hipermasculinitat	i p ə ɾ m ə s k u l i n i t 'a t
hiperònim	i p ə ɾ 'ɔ n i m
hiperònima	i p ə ɾ 'ɔ n i m ə
hiperònimes	i p ə ɾ 'ɔ n i m ə s
hiperonímia	i p ə ɾ o n 'i m i ə
hiperònims	i p ə ɾ 'ɔ n i n s
hiperplàsia	i p ə ɾ p l 'a z i ə
hipertensió	i p ə ɾ t ə n s i 'o
hiperventilada	i p ə ɾ v ə n t i l 'a ð ə
hiperventilades	i p ə ɾ v ə n t i l 'a ð ə s
hiperventilar	i p ə ɾ v ə n t i l 'a
hiperventilat	i p ə ɾ v ə n t i l 'a t
hiperventilats	i p ə ɾ v ə n t i l 'a t s
hipocamp	i p o k 'a m p
hipocondria	i p o k o n d ɾ 'i ə
hipocondríac	i p o k o n d ɾ 'i ə k
hipocondríaca	i p o k o n d ɾ 'i ə k ə
hipocorístic	i p o k o ɾ 'i s t i k
hipocorística	i p o k o ɾ 'i s t i k ə
hipocorístics	i p o k o ɾ 'i s t i t s
hipocorístiques	i p o k o ɾ 'i s t i k ə s
hipòcrita	i p 'ɔ k ɾ i t ə
hipofaringe	i p o f ə ɾ 'i n ʒ ə
hipogrif	i p o ɣ ɾ 'i f
hipogriu	i p o ɣ ɾ 'i w
hiponímia	i p o n 'i m i ə
hipopòtam	i p o p 'ɔ t ə m
hipotalàmic	i p o t ə l 'a m i k
hipotàlem	i p o t 'a l ə m
hipoteca	i p o t 'ɛ k ə
hipotecari	i p o t ə k 'a ɾ i
hipotenusa	i p o t ə n 'u z ə
hipòtesi	i p 'ɔ t ə z i
hipotètic	i p o t 'ɛ t i k
hipotètica	i p o t 'ɛ t i k ə
hirsut	i ɾ s 'u t
hirsutisme	i ɾ s u t 'i z m ə
hispanòfil	i s p ə n 'ɔ f i l
hissada	i s 'a ð ə
hissades	i s 'a ð ə s
hissar	i s 'a
histerectomia	i s t ə ɾ ə t t o m 'i ə
histèria	i s t 'ɛ ɾ i ə
histèrica	i s t 'ɛ ɾ i k ə
histològic	i s t o l 'ɔ ʒ i k
història	i s t 'ɔ ɾ i ə
historiador	i s t o ɾ i ə ð 'o
historiar	i s t o ɾ i 'a
historiat	i s t o ɾ i 'a t
historicisme	i s t o ɾ i s 'i z m ə
històries	i s t 'ɔ ɾ i ə s
historieta	i s t o ɾ i 'ə t ə
histrionisme	i s t ɾ i o n 'i z m ə
hitita	i t 'i t ə
hitlerià	i l l ə ɾ i 'a
hivernacle	i v ə ɾ n 'a k l ə
hivernal	i v ə ɾ n 'a l
hivernar	i v ə ɾ n 'a
hivernenc	i v ə ɾ n 'ə ŋ k
hola	'ɔ l ə
holanda	o l 'a n d ə
holandès	o l ə n d 'ə s
holandesa	o l ə n d 'ə z ə
holotúria	o l o t 'u ɾ i ə
home	'ɔ m o
homenatge	o m ə n 'a dʒ ə
homenatjada	o m ə n ə dʒ 'a ð ə
homenatjades	o m ə n ə dʒ 'a ð ə s
homenatjar	o m ə n ə dʒ 'a
homenatjat	o m ə n ə dʒ 'a t
homenatjats	o m ə n ə dʒ 'a t s
homenenc	o m ə n 'ə ŋ k
homenenca	o m ə n 'ə ŋ k ə
homenenques	o m ə n 'ə ŋ k ə s
homenet	o m ə n 'ə t
homenot	o m ə n 'ɔ t
homeostàtic	o m ə o s t 'a t i k
homes	'ɔ m ə s
homicidi	o m i s 'i ð i
homòfoba	o m 'ɔ f o β ə
homòfobes	o m 'ɔ f o β ə s
homofòbia	o m o f 'ɔ β i ə
homòfobs	o m 'ɔ f o t s
homòfon	o m 'ɔ f o n
homofonia	o m o f o n 'i ə
homogeneïtat	o m o ʒ ə n ə i t 'a t
homogeni	o m o ʒ 'ɛ n i
homòleg	o m 'ɔ l ə k
homònim	o m 'ɔ n i m
homònima	o m 'ɔ n i m ə
homònimes	o m 'ɔ n i m ə s
homònims	o m 'ɔ n i n s
hondureny	o n d u ɾ 'ə ɲ
hondurenya	o n d u ɾ 'ə ɲ ə
honestedat	o n ə s t ə ð 'a t
hongarès	o ŋ g ə ɾ 'ə s
hongaresos	o ŋ g ə ɾ 'ə z o s
honor	o n 'o
honorable	o n o ɾ 'a b b l ə
honorari	o n o ɾ 'a ɾ i
honorària	o n o ɾ 'a ɾ i ə
honoràries	o n o ɾ 'a ɾ i ə s
honoraris	o n o ɾ 'a ɾ i s
honorífic	o n o ɾ 'i f i k
honorífica	o n o ɾ 'i f i k ə
honorífics	o n o ɾ 'i f i t s
honorífiques	o n o ɾ 'i f i k ə s
hoquei	o k 'ə j
hora	'ɔ ɾ ə
horari	o ɾ 'a ɾ i
horària	o ɾ 'a ɾ i ə
horàries	o ɾ 'a ɾ i ə s
horaris	o ɾ 'a ɾ i s
hores	'ɔ ɾ ə s
horitzó	o ɾ i d z 'o
horrible	o r 'i b b l ə
horribles	o r 'i b b l ə s
horrífic	o r 'i f i k
horripilar	o r i p i l 'a
hort	'ɔ ɾ t
horta	'ɔ ɾ t ə
hortal	o ɾ t 'a l
hortalissa	o ɾ t ə l 'i s ə
hortènsia	o ɾ t 'ɛ n s i ə
hortolà	o ɾ t o l 'a
hospital	o s p i t 'a l
hospitalari	o s p i t ə l 'a ɾ i
hospitalitat	o s p i t ə l i t 'a t
hospitalització	o s p i t ə l i d z ə s i 'o
hospitalitzada	o s p i t ə l i d z 'a ð ə
hospitalitzades	o s p i t ə l i d z 'a ð ə s
hospitalitzar	o s p i t ə l i d z 'a
hospitalitzat	o s p i t ə l i d z 'a t
hospitalitzats	o s p i t ə l i d z 'a t s
hostal	o s t 'a l
hostatge	o s t 'a dʒ ə
hostatjar	o s t ə dʒ 'a
hòstia	'ɔ s t i ə
hòsties	'ɔ s t i ə s
hostil	o s t 'i l
hostilitat	o s t i l i t 'a t
hotel	o t 'ɛ l
hoteler	o t ə l 'e
humana	u m 'a n ə
humanes	u m 'a n ə s
humanista	u m ə n 'i s t ə
humanitari	u m ə n i t 'a ɾ i
humanitària	u m ə n i t 'a ɾ i ə
humanitàries	u m ə n i t 'a ɾ i ə s
humanitaris	u m ə n i t 'a ɾ i s
humanitarisme	u m ə n i t ə ɾ 'i z m ə
humanitat	u m ə n i t 'a t
humanitats	u m ə n i t 'a t s
humanitzada	u m ə n i d z 'a ð ə
humanitzades	u m ə n i d z 'a ð ə s
humanitzar	u m ə n i d z 'a
humanitzat	u m ə n i d z 'a t
humanitzats	u m ə n i d z 'a t s
humida	u m 'i ð ə
humides	u m 'i ð ə s
humiliació	u m i l i ə s i 'o
humiliada	u m i l i 'a ð ə
humiliades	u m i l i 'a ð ə s
humiliar	u m i l i 'a
humitejada	u m i t ə ʒ 'a ð ə
humitejades	u m i t ə ʒ 'a ð ə s
humitejar	u m i t ə ʒ 'a
humitejat	u m i t ə ʒ 'a t
humitejats	u m i t ə ʒ 'a t s
humor	u m 'o
huracà	u ɾ ə k 'a
incoherència	i ŋ k o ə ɾ 'ɛ n s i ə
incoherent	i ŋ k o ə ɾ 'e n t
inhalada	i n ə l 'a ð ə
inhalades	i n ə l 'a ð ə s
inhalant	i n ə l 'a n t
inhalar	i n ə l 'a
inhalat	i n ə l 'a t
inhalats	i n ə l 'a t s
inhibició	i n i β i s i 'o
inhibida	i n i β 'i ð ə
inhibides	i n i β 'i ð ə s
inhibir	i n i β 'i
inhibit	i n i β 'i t
inhibits	i n i β 'i t s
inhumada	i n u m 'a ð ə
inhumades	i n u m 'a ð ə s
inhumana	i n u m 'a n ə
inhumanes	i n u m 'a n ə s
inhumar	i n u m 'a
kazakh	k ə z 'a k
Khakàssia	k ə k 'a s i ə
Lesotho	l ə z 'ɔ t o
Llorach	ʎ o ɾ 'a k
Mahoma	m ə 'ɔ m ə
malherbologia	m ə l ə ɾ β o l o ʒ 'i ə
muhàrram	m u 'a r ə m
nihilisme	n i i l 'i z m ə
prehistòria	p ɾ ə i s t 'ɔ ɾ i ə
prehistòric	p ɾ ə i s t 'ɔ ɾ i k
prohibició	p ɾ o i β i s i 'o
prohibida	p ɾ o i β 'i ð ə
prohibides	p ɾ o i β 'i ð ə s
prohibir	p ɾ o i β 'i
prohibit	p ɾ o i β 'i t
prohibits	p ɾ o i β 'i t s
prohom	p ɾ o 'o m
rutherfordi	r u t ə ɾ f 'ɔ ɾ ð i
saharià	s ə ə ɾ i 'a
sahrauí	s ə ɾ ə w 'i
Sakhà	s ə k 'a
sikhisme	s i k 'i z m ə
subhasta	s u β 'a s t ə
subhastada	s u β ə s t 'a ð ə
subhastades	s u β ə s t 'a ð ə s
subhastar	s u β ə s t 'a
subhastat	s u β ə s t 'a t
subhastats	s u β ə s t 'a t s
subsaharià	s u t s ə ə ɾ i 'a
ununhexi	u n u n 'ɛ t s i
vehement	v ə ə m 'e n t
vehicle	v ə 'i k l ə
vehiculada	v ə i k u l 'a ð ə
vehiculades	v ə i k u l 'a ð ə s
vehiculares	v ə i k u l 'a ɾ ə s
vehiculat	v ə i k u l 'a t
vehiculats	v ə i k u l 'a t s
ha	'a
hi	'i
havia	ə v 'i ə
ho	'o
he	'e
hem	'ə m
han	'a n
hores	'ɔ ɾ ə s
haver	ə v 'ə
història	i s t 'ɔ ɾ i ə
ahir	ə 'i
home	'ɔ m o
hora	'ɔ ɾ ə
hagi	'a ʒ i
havien	ə v 'i ə n
has	'a s
hagut	ə ɣ 'u t
homes	'ɔ m ə s
Ahir	ə 'i
habitació	ə β i t ə s i 'o
haig	'a tʃ
hagués	ə ɣ 'e s
fer-ho	f 'e ɾ o
Vielha	v i 'ɛ l ə
humans	u m 'a n s
horaris	o ɾ 'a ɾ i s
hagin	'a ʒ i n
humana	u m 'a n ə
havíem	ə v 'i ə m
m'hi	m i
històries	i s t 'ɔ ɾ i ə s
habitacions	ə β i t ə s i 'o n s
habilitat	ə β i l i t 'a t
humor	u m 'o
humida	u m 'i ð ə
històric	i s t 'ɔ ɾ i k
alcohol	ə l k o 'ɔ l
suportar-ho	s u p o ɾ t 'a ɾ o
humà	u m 'a
humanitat	u m ə n i t 'a t
horària	o ɾ 'a ɾ i ə
herois	ə ɾ 'ɔ j s
habitatges	ə β i t 'a dʒ ə s
habilitats	ə β i l i t 'a t s
hotel	o t 'ɛ l
hospitals	o s p i t 'a l s
vehemència	v ə ə m 'ɛ n s i ə
prohibit	p ɾ o i β 'i t
posar-hi	p o z 'a ɾ i
pensar-hi	p ə n s 'a ɾ i
hàbits	'a β i t s
horitzontals	o ɾ i d z o n t 'a l s
hectòmetres	ə t t 'ɔ m ə t ɾ ə s
havies	ə v 'i ə s
haver-hi	ə v 'ɛ ɾ i
habituals	ə β i t u 'a l s
ha	'a
fem-ho	f 'ɛ m o
estar-hi	ə s t 'a ɾ i
tornem-hi	t o ɾ n 'ɛ m i
prohibicions	p ɾ o i β i s i 'o n s
poder-hi	p o ð 'ɛ ɾ i
hostal	o s t 'a l
hortet	o ɾ t 'ə t
hivernal	i v ə ɾ n 'a l
històrica	i s t 'ɔ ɾ i k ə
hipoteques	i p o t 'ɛ k ə s
haguéssim	ə ɣ 'e s i m
habitual	ə β i t u 'a l
habitants	ə β i t 'a n s
guardar-ho	g w ə ɾ ð 'a ɾ o
dirhams	d i ɾ 'a n s
deshidratades	d ə s i ð ɾ ə t 'a ð ə s
cohesió	k o ə z i 'o
anar-hi	ə n 'a ɾ i
alcohòlica	ə l k o 'ɔ l i k ə
whiskys	b 'i s k i s
vehiculada	v ə i k u l 'a ð ə
subhastat	s u β ə s t 'a t
subhasta	s u β 'a s t ə
ser-ho	s 'e ɾ o
ser-hi	s 'e ɾ i
seleccionar-ho	s ə l ə t s i o n 'a ɾ o
sahrauí	s ə ɾ ə w 'i
repetir-ho	r ə p ə t 'i ɾ o
recordar-ho	r ə k o ɾ ð 'a ɾ o
recolzar-hi	r ə k o l z 'a ɾ i
pujar-hi	p u ʒ 'a ɾ i
prohibits	p ɾ o i β 'i t s
prohibides	p ɾ o i β 'i ð ə s
prohibida	p ɾ o i β 'i ð ə
prehistòrics	p ɾ ə i s t 'ɔ ɾ i t s
pensar-ho	p ə n s 'a ɾ o
penetrar-hi	p ə n ə t ɾ 'a ɾ i
participar-hi	p ə ɾ t i s i p 'a ɾ i
parlar-hi	p ə ɾ l 'a ɾ i
oblidar-ho	o β l i ð 'a ɾ o
nihilistes	n i i l 'i s t ə s
nihilista	n i i l 'i s t ə
neanderthalensis	n e ə n d ə ɾ t ə l 'ɛ n s i s
megahertzos	m ə ɣ ə 'ɛ ɾ d z o s
marihuana	m ə ɾ i u 'a n ə
llançar-hi	ʎ ə n s 'a ɾ i
jugar-hi	ʒ u ɣ 'a ɾ i
intentar-ho	i n t ə n t 'a ɾ o
intentant-ho	i n t ə n t 'a n t o
inhabilitaria	i n ə β i l i t ə ɾ 'i ə
inhabilitar	i n ə β i l i t 'a
incoherents	i ŋ k o ə ɾ 'e n s
hòstia	'ɔ s t i ə
híbrid	'i β ɾ i t
hàbit	'a β i t
humorística	u m o ɾ 'i s t i k ə
humitat	u m i t 'a t
humit	u m 'i t
humiliant	u m i l i 'a n t
humanes	u m 'a n ə s
humana	u m 'a n ə
hotelera	o t ə l 'e ɾ ə
hoteler	o t ə l 'e
hostil	o s t 'i l
horàris	o ɾ 'a ɾ i s
horts	'ɔ ɾ s
horrible	o r 'i b b l ə
hora	'ɔ ɾ ə
honoraris	o n o ɾ 'a ɾ i s
honor	o n 'o
hongaresos	o ŋ g ə ɾ 'ə z o s
homonímia	o m o n 'i m i ə
homenots	o m ə n 'ɔ t s
hola	'ɔ l ə
hivernar	i v ə ɾ n 'a
hivernacle	i v ə ɾ n 'a k l ə
histèrics	i s t 'ɛ ɾ i t s
histograma	i s t o ɣ ɾ 'a m ə
hipòtesi	i p 'ɔ t ə z i
hipòdrom	i p 'ɔ ð ɾ o m
hipòcrita	i p 'ɔ k ɾ i t ə
hipoteca	i p o t 'ɛ k ə
hindú	i n d 'u
heteròtrofa	ə t ə ɾ 'ɔ t ɾ o f ə
heretat	ə ɾ ə t 'a t
hemorràgia	ə m o r 'a ʒ i ə
harmoniós	ə ɾ m o n i 'o s
harmonitza	ə ɾ m o n 'i d z ə
harmonioses	ə ɾ m o n i 'o z ə s
haguessis	ə ɣ 'e s i s
haguessin	ə ɣ 'e s i n
hagis	'a ʒ i s
habituats	ə β i t u 'a t s
habito	ə β 'i t o
habitava	ə β i t 'a v ə
guanyar-hi	g w ə ɲ 'a ɾ i
garantir-ho	g ə ɾ ə n t 'i ɾ o
fer-hi	f 'e ɾ i
entrar-hi	ə n t ɾ 'a ɾ i
donar-hi	d o n 'a ɾ i
dir-ho	d 'i ɾ o
desar-hi	d ə z 'a ɾ i
dedicar-hi	d ə ð i k 'a ɾ i
continuar-hi	k o n t i n u 'a ɾ i
coherents	k o ə ɾ 'e n s
clavar-hi	k l ə v 'a ɾ i
celebrar-ho	s ə l ə β ɾ 'a ɾ o
bonhomia	b o n o m 'i ə
bohèmia	b o 'ɛ m i ə
atribuir-ho	ə t ɾ i β u 'i ɾ o
arreglar-hi	ə r ə g g l 'a ɾ i
anhelant-la	ə n ə l 'a n l ə
alcohòliques	ə l k o 'ɔ l i k ə s
aconseguir-ho	ə k o n s ə ɣ 'i ɾ o
accedir-hi	ə t s ə ð 'i ɾ i
acabar-ho	ə k ə β 'a ɾ o
Zürich	z u ɾ 'i k
Munich	m u n 'i k
Lluch	ʎ 'u k
Johannesburg	ʒ o ə n n ə z β 'u ɾ k
Günther	g w n t 'e
Fent-ho	f 'e n t o
Eindhoven	ə j n d 'o v ə n
Delhi	d 'ɛ l i
Copenhague	k o p ə n 'a ɣ ə
Chirac	tʃ i ɾ 'a k
Bohigas	b o 'i ɣ ə s
hi	'i
ah	'a
trobar-hi	t ɾ o β 'a ɾ i
resistir-ho	r ə z i s t 'i ɾ o
prohibir	p ɾ o i β 'i
prohibició	p ɾ o i β i s i 'o
prehistòrica	p ɾ ə i s t 'ɔ ɾ i k ə
passar-ho	p ə s 'a ɾ o
passar-hi	p ə s 'a ɾ i
oposar-hi	o p o z 'a ɾ i
mahogany	m ə o ɣ 'a ɲ
maharajàs	m ə ə ɾ ə ʒ 'a s
inhumana	i n u m 'a n ə
inhalo	i n 'a l o
incoherència	i ŋ k o ə ɾ 'ɛ n s i ə
incloent-hi	i ŋ k l o 'e n t i
hàgim	'a ʒ i m
humorístic	u m o ɾ 'i s t i k
humorista	u m o ɾ 'i s t ə
humits	u m 'i t s
humides	u m 'i ð ə s
hospitalàries	o s p i t ə l 'a ɾ i ə s
horrorós	o r o ɾ 'o s
horroroses	o r o ɾ 'o z ə s
horari	o ɾ 'a ɾ i
honorífics	o n o ɾ 'i f i t s
homenatge	o m ə n 'a dʒ ə
holding	o l d 'i ŋ k
hiverns	i v 'ɛ ɾ n s
històriques	i s t 'ɔ ɾ i k ə s
històrics	i s t 'ɔ ɾ i t s
historietes	i s t o ɾ i 'ə t ə s
hippie	i p p 'i ə
hipotètica	i p o t 'ɛ t i k ə
hipotecari	i p o t ə k 'a ɾ i
hipocresia	i p o k ɾ ə z 'i ə
heroi	ə ɾ 'ɔ j
helvètic	ə l v 'ɛ t i k
havíen	ə v 'i ə n
halo	'a l o
hagué	ə ɣ 'e
habitatge	ə β i t 'a dʒ ə
habitada	ə β i t 'a ð ə
habitació	ə β i t ə s i 'o
escoltar-ho	ə s k o l t 'a ɾ o
dírhams	d 'i ɾ ə n s
desinhibint	d ə z i n i β 'i n t
arribar-hi	ə r i β 'a ɾ i
anhels	ə n 'ɛ l s
alcoholèmies	ə l k o o l 'ɛ m i ə s
ah	'a
afegir-hi	ə f ə ʒ 'i ɾ i
adherits	ə ð ə ɾ 'i t s
Ruth	r 'u t
Folch	f 'o l k
habilidós	ə β i l i ð 'o s
habilita	ə β i l 'i t ə
habilitació	ə β i l i t ə s i 'o
habilitada	ə β i l i t 'a ð ə
habilitades	ə β i l i t 'a ð ə s
habilitaɾ	ə β i l i t 'a
habilitaɾan	ə β i l i t ə ɾ 'a n
habilitaɾà	ə β i l i t ə ɾ 'a
habilitat	ə β i l i t 'a t
habilitats	ə β i l i t 'a t s
habiliteu	ə β i l i t 'ɛ w
habiliti	ə β i l 'i t i
habita	ə β 'i t ə
habitabilitat	ə β i t ə β i l i t 'a t
habitable	ə β i t 'a b b l ə
habitables	ə β i t 'a b b l ə s
habitacions	ə β i t ə s i 'o n s
habitació	ə β i t ə s i 'o
habitacle	ə β i t 'a k l ə
habitacles	ə β i t 'a k l ə s
habitada	ə β i t 'a ð ə
habitades	ə β i t 'a ð ə s
habitant	ə β i t 'a n t
habitants	ə β i t 'a n s
habitaɾ	ə β i t 'a
habitat	ə β i t 'a t
habitatge	ə β i t 'a dʒ ə
habitatges	ə β i t 'a dʒ ə s
habitats	ə β i t 'a t s
habitava	ə β i t 'a v ə
habitaven	ə β i t 'a v ə n
habitem	ə β i t 'ə m
habiten	ə β 'i t ə n
habito	ə β 'i t o
habituació	ə β i t u ə s i 'o
habituada	ə β i t u 'a ð ə
habitual	ə β i t u 'a l
habitualment	ə β i t u ˌ a l m 'e n t
habituals	ə β i t u 'a l s
habituant	ə β i t u 'a n t
habituat	ə β i t u 'a t
habituats	ə β i t u 'a t s
habitud	ə β i t 'u t
hagen	'a ʒ ə n
hages	'a ʒ ə s
hagi	'a ʒ i
hagin	'a ʒ i n
hagiogɾafia	ə ʒ i o ɣ ɾ ə f 'i ə
hagis	'a ʒ i s
haguda	ə ɣ 'u ð ə
hagudes	ə ɣ 'u ð ə s
haguem	ə ɣ 'ə m
hagueɾa	ə ɣ 'e ɾ ə
hagueɾen	ə ɣ 'e ɾ ə n
hagueɾes	ə ɣ 'e ɾ ə s
haguessen	ə ɣ 'e s ə n
haguesses	ə ɣ 'e s ə s
haguessin	ə ɣ 'e s i n
haguessis	ə ɣ 'e s i s
haguessiu	ə ɣ ə s 'i w
hagueu	ə ɣ 'ɛ w
hagut	ə ɣ 'u t
haguts	ə ɣ 'u t s
hagué	ə ɣ 'e
haguéɾem	ə ɣ 'e ɾ ə m
haguéɾeu	ə ɣ 'e ɾ ə w
hagués	ə ɣ 'e s
haguéssem	ə ɣ 'e s ə m
haguésseu	ə ɣ 'e s ə w
haguéssim	ə ɣ 'e s i m
haguéssiu	ə ɣ 'e s i w
haguí	ə ɣ 'i
haia	'a j ə
haig	'a tʃ
haitians	ə j t i 'a n s
haití	ə j t 'i
haixix	ə ʃ 'i ʃ
haja	'a ʒ ə
hala	'a l ə
halloween	ə ʎ o β 'e ə n
halo	'a l o
halteɾofília	ə l t ə ɾ o f 'i l i ə
hambuɾg	ə m b 'u ɾ k
hambuɾguesa	ə m b u ɾ ɣ 'ə z ə
hambuɾgueseɾia	ə m b u ɾ ɣ ə z ə ɾ 'i ə
hambuɾgueses	ə m b u ɾ ɣ 'ə z ə s
han	'a n
handbol	ə n d b 'ɔ l
handicap	ə n d i k 'a p
handicaps	ə n d i k 'a t s
hangaɾ	ə ŋ g 'a
hannoveɾ	ə n n o v 'e
hansen	'a n s ə n
haɾdɾive	ə ɾ ð ɾ 'i v ə
haɾdɾives	ə ɾ ð ɾ 'i v ə s
haɾdwaɾe	'a ɾ u ə
haɾem	ə ɾ 'ə m
haɾmonia	ə ɾ m o n 'i ə
haɾmonies	ə ɾ m o n 'i ə s
haɾmoniosa	ə ɾ m o n i 'o z ə
haɾmoniosament	ə ɾ m o n i ˌ o z ə m 'e n t
haɾmonioses	ə ɾ m o n i 'o z ə s
haɾmoniosos	ə ɾ m o n i 'o z o s
haɾmonitza	ə ɾ m o n 'i d z ə
haɾmonització	ə ɾ m o n i d z ə s i 'o
haɾmonitzada	ə ɾ m o n i d z 'a ð ə
haɾmonitzaɾ	ə ɾ m o n i d z 'a
haɾmonitzat	ə ɾ m o n i d z 'a t
haɾmonitzats	ə ɾ m o n i d z 'a t s
haɾmoniós	ə ɾ m o n i 'o s
haɾmònic	ə ɾ m 'ɔ n i k
haɾmònica	ə ɾ m 'ɔ n i k ə
haɾmònicament	ə ɾ m ˌ ɔ n i k ə m 'e n t
haɾmònics	ə ɾ m 'ɔ n i t s
haɾmòniques	ə ɾ m 'ɔ n i k ə s
haɾpistes	ə ɾ p 'i s t ə s
has	'a s
hauɾan	ə w ɾ 'a n
hauɾem	ə w ɾ 'ə m
hauɾeu	ə w ɾ 'ɛ w
hauɾia	ə w ɾ 'i ə
hauɾien	ə w ɾ 'i ə n
hauɾies	ə w ɾ 'i ə s
hauɾà	ə w ɾ 'a
hauɾàs	ə w ɾ 'a s
hauɾé	ə w ɾ 'e
hauɾíem	ə w ɾ 'i ə m
hauɾíeu	ə w ɾ 'i ə w
hemofília	ə m o f 'i l i ə
hemoglobina	ə m o ɣ l o β 'i n ə
hemoroides	ə m o r 'ɔ j ð ə s
hemoràgia	ə m o r 'a ʒ i ə
hemoràgies	ə m o r 'a ʒ i ə s
henna	'e n n ə
hepatitis	ə p ə t 'i t i s
hepàtic	ə p 'a t i k
heɾba	'ɛ ɾ β ə
heɾbei	ə ɾ β 'ə j
heɾbes	'ɛ ɾ β ə s
heɾbomedicinal	ə ɾ β o m ə ð i s i n 'a l
heɾbívoɾ	ə ɾ β 'i v o ɾ
heɾbívoɾs	ə ɾ β 'i v o ɾ s
heɾeditaɾi	ə ɾ ə ð i t 'a ɾ i
heɾeditàɾia	ə ɾ ə ð i t 'a ɾ i ə
heɾeditàɾies	ə ɾ ə ð i t 'a ɾ i ə s
heɾeta	ə ɾ 'ə t ə
heɾetada	ə ɾ ə t 'a ð ə
heɾetades	ə ɾ ə t 'a ð ə s
heɾetaɾ	ə ɾ ə t 'a
heɾetat	ə ɾ ə t 'a t
heɾetatge	ə ɾ ə t 'a dʒ ə
heɾetats	ə ɾ ə t 'a t s
heɾeten	ə ɾ 'e t ə n
heɾetges	ə ɾ 'e dʒ ə s
heɾetgia	ə ɾ ə dʒ 'i ə
heɾeu	ə ɾ 'ɛ w
heɾeus	ə ɾ 'ɛ w s
heɾeva	ə ɾ 'e v ə
heɾeves	ə ɾ 'e v ə s
inapɾehensible	i n ə p ɾ ə ə n s 'i b b l ə
incoheɾent	i ŋ k o ə ɾ 'e n t
incoheɾents	i ŋ k o ə ɾ 'e n s
incoheɾència	i ŋ k o ə ɾ 'ɛ n s i ə
incoheɾències	i ŋ k o ə ɾ 'ɛ n s i ə s
inexhauɾible	i n ə d z ə w ɾ 'i b b l ə
inexhauɾibles	i n ə d z ə w ɾ 'i b b l ə s
infɾahumanes	i m f ɾ ə u m 'a n ə s
inhabilita	i n ə β i l 'i t ə
inhabilitació	i n ə β i l i t ə s i 'o
inhabilitaɾ	i n ə β i l i t 'a
inhabilitaɾia	i n ə β i l i t ə ɾ 'i ə
inhabilitaɾne	i n ə β i l i t 'a ɾ n ə
inhabilitat	i n ə β i l i t 'a t
inhabitable	i n ə β i t 'a b b l ə
inhabitual	i n ə β i t u 'a l
inhabituals	i n ə β i t u 'a l s
inhalació	i n ə l ə s i 'o
inhalaɾ	i n ə l 'a
inhalat	i n ə l 'a t
inhalatòɾia	i n ə l ə t 'ɔ ɾ i ə
inhalo	i n 'a l o
inheɾent	i n ə ɾ 'e n t
inheɾents	i n ə ɾ 'e n s
inhibeix	i n i β 'ə ʃ
inhibeixen	i n i β 'ə ʃ ə n
inhibeixi	i n i β 'ə ʃ i
inhibia	i n i β 'i ə
inhibicions	i n i β i s i 'o n s
inhibició	i n i β i s i 'o
inhibidoɾ	i n i β i ð 'o
inhibidoɾs	i n i β i ð 'o s
inhibiɾ	i n i β 'i
inhibiɾse	i n i β 'i ɾ s ə
inhibit	i n i β 'i t
inhumació	i n u m ə s i 'o
inhumana	i n u m 'a n ə
inhumanes	i n u m 'a n ə s
inhumanitat	i n u m ə n i t 'a t
inhumans	i n u m 'a n s
inhumà	i n u m 'a
inhòspit	i n 'ɔ s p i t
inhòspita	i n 'ɔ s p i t ə
macɾohistòɾia	m ə k ɾ o i s t 'ɔ ɾ i ə
malhumoɾat	m ˌ a l u m o ɾ 'a t
megaheɾtzos	m ə ɣ ə 'ɛ ɾ d z o s
megaheɾtzs	m ə ɣ ə 'ɛ ɾ d z s
nihilisme	n i i l 'i z m ə
nihilista	n i i l 'i s t ə
nihilistes	n i i l 'i s t ə s
havedora  ə v ə ð 'o ɾ ə 
ahucadora  ə ɣ k ə ð 'o ɾ ə 
deshonora  d ə z o n 'o ɾ ə 
herbivora  ə ɾ β i v 'o ɾ ə 
hidrocora  i ð ɾ o k 'o ɾ ə 
honradora  o n ɾ ə ð 'o ɾ ə 
havedores  ə v ə ð 'o ɾ ə s 
ahucadores  ə ɣ k ə ð 'o ɾ ə s 
deshonores  d ə z o n 'o ɾ ə s 
herbivores  ə ɾ β i v 'o ɾ ə s 
hidrocores  i ð ɾ o k 'o ɾ ə s 
honradores  o n ɾ ə ð 'o ɾ ə s 
adherent	 e ð e ɾ 'e n t 
coherent	 k o e ɾ 'e n t 
afecte	ə f 'ɛ t t ə
èctesi	'ɛ t t ə z i
efecte	ə f 'ɛ t t ə
electe	ə l 'ɛ t t ə
erecte	ə ɾ 'ɛ t t ə
rectes	r 'ɛ t t ə s
sectes	s 'ɛ t t ə s
abjecte	ə β ʒ 'ɛ t t ə
afecten	ə f 'ɛ t t ə n
afectes	ə f 'ɛ t t ə s
afectés	ə f ə t t 'e s
aspecte	ə s p 'ɛ t t ə
bisecte	b i z 'ɛ t t ə
defecte	d ə f 'ɛ t t ə
dejecte	d ə ʒ 'ɛ t t ə
dilecte	d i l 'ɛ t t ə
directe	d i ɾ 'ɛ t t ə
efectes	ə f 'ɛ t t ə s
electes	ə l 'ɛ t t ə s
erectes	ə ɾ 'ɛ t t ə s
infecte	i n f 'ɛ t t ə
insecte	i n s 'ɛ t t ə
objecte	o β ʒ 'ɛ t t ə
selecte	s ə l 'ɛ t t ə
sufecte	s u f 'ɛ t t ə
abjectes	ə β ʒ 'ɛ t t ə s
aspectes	ə s p 'ɛ t t ə s
bisectes	b i z 'ɛ t t ə s
correcte	k o r 'ɛ t t ə
defectes	d ə f 'ɛ t t ə s
dejectes	d ə ʒ 'ɛ t t ə s
dialecte	d i ə l 'ɛ t t ə
dilectes	d i l 'ɛ t t ə s
directes	d i ɾ 'ɛ t t ə s
flecteix	f l ə t t 'e ʃ
infectes	i n f 'ɛ t t ə s
injecten	i n ʒ 'ɛ t t ə n
insectes	i n s 'ɛ t t ə s
objectes	o β ʒ 'ɛ t t ə s
perfecte	p ə ɾ f 'ɛ t t ə
prefecte	p ɾ ə f 'ɛ t t ə
projecte	p ɾ o ʒ 'ɛ t t ə
provecte	p ɾ o v 'ɛ t t ə
respecte	r ə s p 'ɛ t t ə
selectes	s ə l 'ɛ t t ə s
subjecte	s u β ʒ 'ɛ t t ə
sufectes	s u f 'ɛ t t ə s
suspecte	s u s p 'ɛ t t ə
trajecte	t ɾ ə ʒ 'ɛ t t ə
benafecte	b ə n ə f 'ɛ t t ə
connecten	k o n n 'ɛ t t ə n
conspecte	k o n s p 'ɛ t t ə
correctes	k o r 'ɛ t t ə s
desafecte	d ə z ə f 'ɛ t t ə
dialectes	d i ə l 'ɛ t t ə s
idiolecte	i ð i o l 'ɛ t t ə
indirecte	i n d i ɾ 'ɛ t t ə
megarecte	m ə ɣ ə ɾ 'ɛ t t ə
mesorecte	m ə z o ɾ 'ɛ t t ə
pandectes	p ə n d 'ɛ t t ə s
perfectes	p ə ɾ f 'ɛ t t ə s
prefectes	p ɾ ə f 'ɛ t t ə s
projecten	p ɾ o ʒ 'ɛ t t ə n
projectes	p ɾ o ʒ 'ɛ t t ə s
prospecte	p ɾ o s p 'ɛ t t ə
provectes	p ɾ o v 'ɛ t t ə s
respectes	r ə s p 'ɛ t t ə s
semirecte	s ə m i ɾ 'ɛ t t ə
subjecten	s u β ʒ 'ɛ t t ə n
subjectes	s u β ʒ 'ɛ t t ə s
suspectes	s u s p 'ɛ t t ə s
trajectes	t ɾ ə ʒ 'ɛ t t ə s
benafectes	b ə n ə f 'ɛ t t ə s
correctesa	k o r ə t t 'ə z ə
desafectes	d ə z ə f 'ɛ t t ə s
imperfecte	i m p ə ɾ f 'ɛ t t ə
incorrecte	i ŋ k o r 'ɛ t t ə
indirectes	i n d i ɾ 'ɛ t t ə s
insurrecte	i n s u r 'ɛ t t ə
interfecte	i n t ə ɾ f 'ɛ t t ə
predilecte	p ɾ ə ð i l 'ɛ t t ə
prospectes	p ɾ o s p 'ɛ t t ə s
reflecteix	r ə f l ə t t 'e ʃ
semirectes	s ə m i ɾ 'ɛ t t ə s
transsecte	t ɾ ə n s 'ɛ t t ə
accepte	ə t s 'ɛ t t ə
adeptes	ə ð 'ɛ t t ə s
excepte	ə t s 'ɛ t t ə
ineptes	i n 'ɛ t t ə s
accepte	ə t s 'ɛ t t ə
adeptes	ə ð 'ɛ t t ə s
excepte	ə t s 'ɛ t t ə
ineptes	i n 'ɛ t t ə s
accepte	ə t s 'ɛ t t ə
adeptes	ə ð 'ɛ t t ə s
excepte	ə t s 'ɛ t t ə
ineptes	i n 'ɛ t t ə s
prospepte	p ɾ o s p 'ɛ t t ə
proveptes	p ɾ o v 'ɛ t t ə s
respeptes	r ə s p 'ɛ t t ə s
semirepte	s ə m i ɾ 'ɛ t t ə
subjepten	s u β ʒ 'ɛ t t ə n
subjeptes	s u β ʒ 'ɛ t t ə s
suspeptes	s u s p 'ɛ t t ə s
trajeptes	t ɾ ə ʒ 'ɛ t t ə s
benafeptes	b ə n ə f 'ɛ t t ə s
correptesa	k o r ə t t 'ə z ə
desafeptes	d ə z ə f 'ɛ t t ə s
imperfepte	i m p ə ɾ f 'ɛ t t ə
incorrepte	i ŋ k o r 'ɛ t t ə
indireptes	i n d i ɾ 'ɛ t t ə s
insurrepte	i n s u r 'ɛ t t ə
interfepte	i n t ə ɾ f 'ɛ t t ə
predilepte	p ɾ ə ð i l 'ɛ t t ə
prospeptes	p ɾ o s p 'ɛ t t ə s
reflepteix	r ə f l ə t t 'e ʃ
semireptes	s ə m i ɾ 'ɛ t t ə s
