abaltits	ə β ə l t 'i t s
abolits	ə β o l 'i t s
absorbits	ə t s o ɾ β 'i t s
accedits	ə t s ə ð 'i t s
aclarits	ə k l ə ɾ 'i t s
aconseguits	ə k o n s ə ɣ 'i t s
acudits	ə k u ð 'i t s
adherits	ə ð ə ɾ 'i t s
adits	ə ð 'i t s
adormits	ə ð o ɾ m 'i t s
adscrits	ə t s k ɾ 'i t s
afavorits	ə f ə v o ɾ 'i t s
afegits	ə f ə ʒ 'i t s
afligits	ə f l i ʒ 'i t s
agafamosquits	ə ɣ ə f ə m o s k 'i t s
agraïts	ə ɣ ɾ ə 'i t s
agredits	ə ɣ ɾ ə ð 'i t s
ajupits	ə ʒ u p 'i t s
alentits	ə l ə n t 'i t s
alleugerits	ə ʎ ə w ʒ ə ɾ 'i t s
amansits	ə m ə n s 'i t s
amics	ə m 'i t s
ammonits	ə m m o n 'i t s
ampits	ə m p 'i t s
antecedits	ə n t ə s ə ð 'i t s
antics	ə n t 'i t s
apetits	ə p ə t 'i t s
aplaudits	ə p l ə w ð 'i t s
arguïts	ə ɾ ɣ u 'i t s
arraulits	ə r ə w l 'i t s
arrodonits	ə r o ð o n 'i t s
ascendits	ə t s ə n d 'i t s
assaborits	ə s ə β o ɾ 'i t s
assistits	ə s i s t 'i t s
assolits	ə s o l 'i t s
assumits	ə s u m 'i t s
aterrits	ə t ə r 'i t s
atrevits	ə t ɾ ə v 'i t s
atribuïts	ə t ɾ i β u 'i t s
avorrits	ə v o r 'i t s
bastits	b ə s t 'i t s
beneïts	b ə n ə 'i t s
bonics	b o n 'i t s
cabrits	k ə β ɾ 'i t s
capits	k ə p 'i t s
caribs	k ə ɾ 'i t s
cedits	s ə ð 'i t s
cenyits	s ə ɲ 'i t s
coincidits	k o i n s i ð 'i t s
compartits	k o m p ə ɾ t 'i t s
competits	k o m p ə t 'i t s
comprimits	k o m p ɾ i m 'i t s
concedits	k o n s ə ð 'i t s
conduïts	k o n d u 'i t s
conquerits	k o ŋ k ə ɾ 'i t s
consentits	k o n s ə n t 'i t s
consistits	k o n s i s t 'i t s
contradits	k o n t ɾ ə ð 'i t s
contribuïts	k o n t ɾ i β u 'i t s
corregits	k o r ə ʒ 'i t s
corroïts	k o r o 'i t s
cosits	k o z 'i t s
cruixits	k ɾ u ʃ 'i t s
decidits	d ə s i ð 'i t s
deduïts	d ə ð u 'i t s
definits	d ə f i n 'i t s
delinquits	d ə l i ŋ k 'i t s
demolits	d ə m o l 'i t s
departits	d ə p ə ɾ t 'i t s
deprimits	d ə p ɾ i m 'i t s
derruïts	d ə r u 'i t s
descendits	d ə t s ə n d 'i t s
descosits	d ə s k o z 'i t s
descrits	d ə s k ɾ 'i t s
desistits	d ə z i s t 'i t s
desmentits	d ə z m ə n t 'i t s
desobeïts	d ə z o β ə 'i t s
destituïts	d ə s t i t u 'i t s
destruïts	d ə s t ɾ u 'i t s
digerits	d i ʒ ə ɾ 'i t s
dirigits	d i ɾ i ʒ 'i t s
dissuadits	d i s u ə ð 'i t s
distingits	d i s t i n ʒ 'i t s
distribuïts	d i s t ɾ i β u 'i t s
divertits	d i v ə ɾ t 'i t s
dividits	d i v i ð 'i t s
dominics	d o m i n 'i t s
dormits	d o ɾ m 'i t s
eixits	ə ʃ 'i t s
elegits	ə l ə ʒ 'i t s
eludits	ə l u ð 'i t s
embadalits	ə m b ə ð ə l 'i t s
embogits	ə m b o ʒ 'i t s
emergits	ə m ə ɾ ʒ 'i t s
emmalaltits	ə m m ə l ə l t 'i t s
empobrits	ə m p o β ɾ 'i t s
encabits	ə ŋ k ə β 'i t s
encongits	ə ŋ k o n ʒ 'i t s
endarrerits	ə n d ə r ə ɾ 'i t s
enemics	ə n ə m 'i t s
engolits	ə ŋ g o l 'i t s
enllestits	ə n ʎ ə s t 'i t s
ensopits	ə n s o p 'i t s
ensordits	ə n s o ɾ ð 'i t s
enterbolits	ə n t ə ɾ β o l 'i t s
entristits	ə n t ɾ i s t 'i t s
erigits	ə ɾ i ʒ 'i t s
erudits	ə ɾ u ð 'i t s
esbandits	ə z β ə n d 'i t s
escopits	ə s k o p 'i t s
escrits	ə s k ɾ 'i t s
esgrimits	ə z ɣ ɾ i m 'i t s
esmorteïts	ə z m o ɾ t ə 'i t s
esmunyits	ə z m u ɲ 'i t s
espaordits	ə s p ə o ɾ ð 'i t s
evadits	ə v ə ð 'i t s
fallits	f ə ʎ 'i t s
favorits	f ə v o ɾ 'i t s
ferits	f ə ɾ 'i t s
florits	f l o ɾ 'i t s
fornits	f o ɾ n 'i t s
fregits	f ɾ ə ʒ 'i t s
fugits	f u ʒ 'i t s
garantits	g ə ɾ ə n t 'i t s
gaudits	g ə w ð 'i t s
gratuïts	g ɾ ə t u 'i t s
guarits	g w ə ɾ 'i t s
guarnits	g w ə ɾ n 'i t s
impartits	i m p ə ɾ t 'i t s
impedits	i m p ə ð 'i t s
ingerits	i n ʒ ə ɾ 'i t s
inhibits	i n i β 'i t s
inserits	i n s ə ɾ 'i t s
introduïts	i n t ɾ o ð u 'i t s
jaquits	ʒ ə k 'i t s
llegits	ʎ ə ʒ 'i t s
maleïts	m ə l ə 'i t s
malferits	m ə l f ə ɾ 'i t s
mentits	m ə n t 'i t s
mugits	m u ʒ 'i t s
negligits	n ə ɣ l i ʒ 'i t s
nodrits	n o ð ɾ 'i t s
obeïts	o β ə 'i t s
occits	o t s 'i t s
oïts	o 'i t s
oprimits	o p ɾ i m 'i t s
ordits	o ɾ ð 'i t s
païts	p ə 'i t s
parits	p ə ɾ 'i t s
partits	p ə ɾ t 'i t s
perits	p ə ɾ 'i t s
perseguits	p ə ɾ s ə ɣ 'i t s
persistits	p ə ɾ s i s t 'i t s
persuadits	p ə ɾ s u ə ð 'i t s
pescaclics	p ə s k ə k l 'i t s
petits	p ə t 'i t s
polits	p o l 'i t s
posseïts	p o s ə 'i t s
precedits	p ɾ ə s ə ð 'i t s
preferits	p ɾ ə f ə ɾ 'i t s
prefix	p ɾ ə f 'i t s
presidits	p ɾ ə z i ð 'i t s
presumits	p ɾ ə z u m 'i t s
procedits	p ɾ o s ə ð 'i t s
produïts	p ɾ o ð u 'i t s
profits	p ɾ o f 'i t s
prohibits	p ɾ o i β 'i t s
prosseguits	p ɾ o s ə ɣ 'i t s
protegits	p ɾ o t ə ʒ 'i t s
proveïts	p ɾ o v ə 'i t s
reconquerits	r ə k o ŋ k ə ɾ 'i t s
reconstruïts	r ə k o n s t ɾ u 'i t s
redimits	r ə ð i m 'i t s
reduïts	r ə ð u 'i t s
reelegits	r e ə l ə ʒ 'i t s
reescrits	r e ə s k ɾ 'i t s
referits	r ə f ə ɾ 'i t s
reflectits	r ə f l ə t t 'i t s
regits	r ə ʒ 'i t s
rejovenits	r ə ʒ o v ə n 'i t s
rellegits	r ə ʎ ə ʒ 'i t s
rendits	r ə n d 'i t s
repartits	r ə p ə ɾ t 'i t s
repercutits	r ə p ə ɾ k u t 'i t s
repetits	r ə p ə t 'i t s
repics	r ə p 'i t s
reprimits	r ə p ɾ i m 'i t s
reproduïts	r ə p ɾ o ð u 'i t s
requerits	r ə k ə ɾ 'i t s
residits	r ə z i ð 'i t s
resistits	r ə z i s t 'i t s
resseguits	r ə s ə ɣ 'i t s
ressortits	r ə s o ɾ t 'i t s
restringits	r ə s t ɾ i n ʒ 'i t s
resumits	r ə z u m 'i t s
retrunyits	r ə t ɾ u ɲ 'i t s
reunits	r ə u n 'i t s
seguits	s ə ɣ 'i t s
sentits	s ə n t 'i t s
servits	s ə ɾ v 'i t s
sorgits	s o ɾ ʒ 'i t s
sortits	s o ɾ t 'i t s
succeïts	s u t s ə 'i t s
tendits	t ə n d 'i t s
tirapits	t i ɾ ə p 'i t s
tossits	t o s 'i t s
traduïts	t ɾ ə ð u 'i t s
traïts	t ɾ ə 'i t s
transcrits	t ɾ ə n s k ɾ 'i t s
transferits	t ɾ ə n s f ə ɾ 'i t s
transgredits	t ɾ ə n z ɣ ɾ ə ð 'i t s
units	u n 'i t s
xics	ʃ 'i t s
zenits	z ə n 'i t s
amics	ə m 'i t s
dits	d 'i t s
petits	p ə t 'i t s
nits	n 'i t s
crits	k ɾ 'i t s
equips	ə k 'i t s
antics	ə n t 'i t s
sentits	s ə n t 'i t s
Units	u n 'i t s
ferits	f ə ɾ 'i t s
vestits	v ə s t 'i t s
esmorteïts	ə z m o ɾ t ə 'i t s
enemics	ə n ə m 'i t s
llits	ʎ 'i t s
compartits	k o m p ə ɾ t 'i t s
partits	p ə ɾ t 'i t s
gratuïts	g ɾ ə t u 'i t s
escrits	ə s k ɾ 'i t s
units	u n 'i t s
tenyits	t ə ɲ 'i t s
succeïts	s u t s ə 'i t s
sortits	s o ɾ t 'i t s
rics	r 'i t s
prohibits	p ɾ o i β 'i t s
preferits	p ɾ ə f ə ɾ 'i t s
pits	p 'i t s
llegits	ʎ ə ʒ 'i t s
embotits	ə m b o t 'i t s
embolics	ə m b o l 'i t s
dividits	d i v i ð 'i t s
distribuïts	d i s t ɾ i β u 'i t s
disminuïts	d i z m i n u 'i t s
deslluïts	d ə z ʎ u 'i t s
decidits	d ə s i ð 'i t s
construïts	k o n s t ɾ u 'i t s
cedits	s ə ð 'i t s
brogits	b ɾ o ʒ 'i t s
agraïts	ə ɣ ɾ ə 'i t s
acudits	ə k u ð 'i t s
Xics	ʃ 'i t s
Petits	p ə t 'i t s
teixits	t ə ʃ 'i t s
requisits	r ə k i z 'i t s
proveïts	p ɾ o v ə 'i t s
humits	u m 'i t s
divertits	d i v ə ɾ t 'i t s
controvertits	k o n t ɾ o v ə ɾ t 'i t s
atapeïts	ə t ə p ə 'i t s
assumits	ə s u m 'i t s
adormits	ə ð o ɾ m 'i t s
adherits	ə ð ə ɾ 'i t s
Crits	k ɾ 'i t s
