alcoià	ə l k o j 'a
Alcoià	ə l k o j 'a
anoienc	ə n o j 'ə ŋ k
boicotejada	b o j k o t ə ʒ 'a ð ə
boicotejades	b o j k o t ə ʒ 'a ð ə s
boicotejar	b o j k o t ə ʒ 'a
boicotejat	b o j k o t ə ʒ 'a t
boicotejats	b o j k o t ə ʒ 'a t s
boirina	b o j ɾ 'i n ə
boirós	b o j ɾ 'o s
boirum	b o j ɾ 'u m
coiot	k o j 'ɔ t
emboirar	ə m b o j ɾ 'a
joier	ʒ o j 'e
joieria	ʒ o j ə ɾ 'i ə
joiós	ʒ o j 'o s
Moià	m o j 'a
Moianès	m o j ə n 'ə s
moianès	m o j ə n 'ə s
Moisès	m o j z 'ə s
noieta	n o j 'ə t ə
oidà	o j ð 'a
troià	t ɾ o j 'a
voivoda	v o j v 'ɔ ð ə
voivodat	v o j v o ð 'a t
boirum	b o j ɾ 'u m
boirina	b o j ɾ 'i n ə
bonys	b 'o j n s
foier	 f o j 'e 
joier	 ʒ o j 'e 
