alzinoia	ə l z i n 'ɔ j ə
amploia	ə m p l 'ɔ j ə
Anoia	ə n 'ɔ j ə
asteroide	ə s t ə ɾ 'ɔ j ð ə
benzoica	b ə n z 'ɔ j k ə
bioflavonoide	b i o f l ə v o n 'ɔ j ð ə
birimboies	b i ɾ i m b 'ɔ j ə s
boia	b 'ɔ j ə
boina	b 'ɔ j n ə
boira	b 'ɔ j ɾ ə
boires	b 'ɔ j ɾ ə s
broida	b ɾ 'ɔ j ð ə
broides	b ɾ 'ɔ j ð ə s
carantoines	k ə ɾ ə n t 'ɔ j n ə s
claraboia	k l ə ɾ ə β 'ɔ j ə
cofoi	k o f 'ɔ j
comboi	k o m b 'ɔ j
corticoide	k o ɾ t i k 'ɔ j ð ə
cuboide	k u β 'ɔ j ð ə
Eloi	ə l 'ɔ j
escafoide	ə s k ə f 'ɔ j ð ə
escafoides	ə s k ə f 'ɔ j ð ə s
foia	f 'ɔ j ə
gasoil	g ə z 'ɔ j l
heroi	ə ɾ 'ɔ j
heroic	ə ɾ 'ɔ j k
joia	ʒ 'ɔ j ə
limfoide	l i m f 'ɔ j ð ə
limfoides	l i m f 'ɔ j ð ə s
llampoina	ʎ ə m p 'ɔ j n ə
margaridoia	m ə ɾ ɣ ə ɾ i ð 'ɔ j ə
noia	n 'ɔ j ə
noya	n 'ɔ j ə
paranoia	p ə ɾ ə n 'ɔ j ə
paranoic	p ə ɾ ə n 'ɔ j k
paranoide	p ə ɾ ə n 'ɔ j ð ə
roina	r 'ɔ j n ə
sequoia	s ə k w 'ɔ j ə
tifoide	t i f 'ɔ j ð ə
tramoia	t ɾ ə m 'ɔ j ə
trapezoide	t ɾ ə p ə z 'ɔ j ð ə
Troia	t ɾ 'ɔ j ə
troica	t ɾ 'ɔ j k ə
xicoia	ʃ i k 'ɔ j ə
xicoira	ʃ i k 'ɔ j ɾ ə
xirimoia	ʃ i ɾ i m 'ɔ j ə
noi	n 'ɔ j
nois	n 'ɔ j s
Boi	b 'ɔ j
herois	ə ɾ 'ɔ j s
gasoil	g ə z 'ɔ j l
calçoina	k ə l s 'ɔ j n ə
oi	'ɔ j
boira	b 'ɔ j ɾ ə
rampoines	r ə m p 'ɔ j n ə s
cofoi	k o f 'ɔ j
boires	b 'ɔ j ɾ ə s
almoina	ə l m 'ɔ j n ə
Nois	n 'ɔ j s
Detroit	d ə t ɾ 'ɔ j t
Boira	b 'ɔ j ɾ ə
oi	'ɔ j
heroi	ə ɾ 'ɔ j
hemoroides	ə m o r 'ɔ j ð ə s
