afaitada	ə f ə j t 'a ð ə
afaitades	ə f ə j t 'a ð ə s
afaitar	ə f ə j t 'a
afaitat	ə f ə j t 'a t
afaitats	ə f ə j t 'a t s
aidada	ə j ð 'a ð ə
aidades	ə j ð 'a ð ə s
aidant	ə j ð 'a n t
aidar	ə j ð 'a
aidat	ə j ð 'a t
aidats	ə j ð 'a t s
airejar	ə j ɾ ə ʒ 'a
airejós	ə j ɾ ə ʒ 'o s
almenys	ə l m 'ə j n s
amainada	ə m ə j n 'a ð ə
amainades	ə m ə j n 'a ð ə s
amainant	ə m ə j n 'a n t
amainar	ə m ə j n 'a
amainat	ə m ə j n 'a t
amainats	ə m ə j n 'a t s
apaivagada	ə p ə j v ə ɣ 'a ð ə
apaivagades	ə p ə j v ə ɣ 'a ð ə s
apaivagant	ə p ə j v ə ɣ 'a n t
apaivagar	ə p ə j v ə ɣ 'a
apaivagat	ə p ə j v ə ɣ 'a t
apaivagats	ə p ə j v ə ɣ 'a t s
atalaiar	ə t ə l ə j 'a
atraient	ə t ɾ ə j 'e n t
Azerbaidjan	ə z ə ɾ β ə j dʒ 'a n
beina	b 'ə j n ə
beisbol	b ə j z β 'ɔ l
caiac	k ə j 'a k
caient	k ə j 'e n t
caiguda	k ə j ɣ 'u ð ə
caigudes	k ə j ɣ 'u ð ə s
caigut	k ə j ɣ 'u t
caiguts	k ə j ɣ 'u t s
caireta	k ə j ɾ 'ə t ə
caironada	k ə j ɾ o n 'a ð ə
caironades	k ə j ɾ o n 'a ð ə s
caironat	k ə j ɾ o n 'a t
caironats	k ə j ɾ o n 'a t s
caiuc	k ə j 'u k
carei	k ə ɾ 'ə j
Ceilan	s ə j l 'a n
ceilòmetre	s ə j l 'ɔ m ə t ɾ ə
ceilòmetres	s ə j l 'ɔ m ə t ɾ ə s
creient	k ɾ ə j 'e n t
deis	d 'ə j s
desembeinar	d ə z ə m b ə j n 'a
deslleial	d ə z ʎ ə j 'a l
desmaiar	d ə z m ə j 'a
eina	'ə j n ə
Eivissa	ə j v 'i s ə
eivissenc	ə j v i s 'ə ŋ k
embaietar	ə m b ə j ə t 'a
empaitar	ə m p ə j t 'a
enlairament	ə n l ə j ɾ ə m 'e n t
escaiola	ə s k ə j 'ɔ l ə
escairada	ə s k ə j ɾ 'a ð ə
escairades	ə s k ə j ɾ 'a ð ə s
escairar	ə s k ə j ɾ 'a
escairat	ə s k ə j ɾ 'a t
escairats	ə s k ə j ɾ 'a t s
esglaiada	ə z ɣ l ə j 'a ð ə
esglaiades	ə z ɣ l ə j 'a ð ə s
esglaiar	ə z ɣ l ə j 'a
esglaiat	ə z ɣ l ə j 'a t
esglaiats	ə z ɣ l ə j 'a t s
espaiador	ə s p ə j ə ð 'o
espaiar	ə s p ə j 'a
espaiat	ə s p ə j 'a t
espaiós	ə s p ə j 'o s
esplaiada	ə s p l ə j 'a ð ə
esplaiades	ə s p l ə j 'a ð ə s
esplaiar	ə s p l ə j 'a
esplaiat	ə s p l ə j 'a t
esplaiats	ə s p l ə j 'a t s
faisà	f ə j z 'a
feina	f 'ə j n ə
feinada	f ə j n 'a ð ə
feinejar	f ə j n ə ʒ 'a
feiner	f ə j n 'e
feyan	f ə j 'a n
feyen	f 'ə j ə n
flairada	f l ə j ɾ 'a ð ə
flairades	f l ə j ɾ 'a ð ə s
flairar	f l ə j ɾ 'a
flairat	f l ə j ɾ 'a t
flairats	f l ə j ɾ 'a t s
flairós	f l ə j ɾ 'o s
gaiata	g ə j 'a t ə
gaiato	g ə j 'a t o
gairebé	g ə j ɾ ə β 'e
gaiter	g ə j t 'e
guaiaba	g w ə j 'a β ə
Guaiana	g w ə j 'a n ə
guaità	g w ə j t 'a
guaitar	g w ə j t 'a
guaitat	g w ə j t 'a t
Hainan	ə j n 'a n
Hainaut	ə j n 'a w t
Haití	ə j t 'i
herbei	ə ɾ β 'ə j
hoquei	o k 'ə j
ideia	i ð 'ə j ə
irremeiable	i r ə m ə j 'a b b l ə
jersei	ʒ ə ɾ s 'ə j
kuwaitià	k u β ə j t i 'a
llei	ʎ 'ə j
lleial	ʎ ə j 'a l
lleialtat	ʎ ə j ə l t 'a t
lleis	ʎ 'ə j s
madrilenys	m ə ð ɾ i l 'ə j n s
maial	m ə j 'a l
maimó	m ə j m 'o
mainada	m ə j n 'a ð ə
meitat	m ə j t 'a t
menys	m 'ə j n s
minairó	m i n ə j ɾ 'o
onomatopeia	o n o m ə t o p 'ə j ə
onomatopeic	o n o m ə t o p 'ə j k
pailó	p ə j l 'o
pairal	p ə j ɾ 'a l
paisatge	p ə j z 'a dʒ ə
paracaigudes	p ə ɾ ə k ə j ɣ 'u ð ə s
paracaigudisme	p ə ɾ ə k ə j ɣ u ð 'i z m ə
paracaigudista	p ə ɾ ə k ə j ɣ u ð 'i s t ə
peitoví	p ə j t o v 'i
prenys	p ɾ 'ə j n s
proteic	p ɾ o t 'ə j k
recaiguda	r ə k ə j ɣ 'u ð ə
recaigudes	r ə k ə j ɣ 'u ð ə s
reial	r ə j 'a l
reialisme	r ə j ə l 'i z m ə
reialme	r ə j 'a l m ə
reiet	r ə j 'ə t
reietó	r ə j ə t 'o
remei	r ə m 'ə j
remeiada	r ə m ə j 'a ð ə
remeiades	r ə m ə j 'a ð ə s
remeiar	r ə m ə j 'a
remeiat	r ə m ə j 'a t
remeiats	r ə m ə j 'a t s
remeis	r ə m 'ə j s
sainet	s ə j n 'ə t
seient	s ə j 'e n t
seitó	s ə j t 'o
sensefeina	s ə n s ə f 'ə j n ə
servei	s ə ɾ v 'ə j
tailandesa	t ə j l ə n d 'ə z ə
tailandeses	t ə j l ə n d 'ə z ə s
Tailàndia	t ə j l 'a n d i ə
taiwanès	t ə j β ə n 'ə s
taiwanesa	t ə j β ə n 'ə z ə
taiwaneses	t ə j β ə n 'ə z ə s
taiwanesos	t ə j β ə n 'ə z o s
teia	t 'ə j ə
vailet	v ə j l 'ə t
vainilla	v ə j n 'i ʎ ə
vainilles	v ə j n 'i ʎ ə s
vairescut	v ə j ɾ ə s k 'u t
vaiverejar	v ə j v ə ɾ ə ʒ 'a
xangainès	ʃ ə ŋ g ə j n 'ə s
xemeneia	ʃ ə m ə n 'ə j ə
zairès	z ə j ɾ 'ə s
feina	f 'ə j n ə
menys	m 'ə j n s
gairebé	g ə j ɾ ə β 'e
servei	s ə ɾ v 'ə j
serveis	s ə ɾ v 'ə j s
paisatge	p ə j z 'a dʒ ə
meitat	m ə j t 'a t
lleis	ʎ 'ə j s
leis	l 'ə j s
Servei	s ə ɾ v 'ə j
almenys	ə l m 'ə j n s
feines	f 'ə j n ə s
caigut	k ə j ɣ 'u t
Gairebé	g ə j ɾ ə β 'e
eina	'ə j n ə
jersei	ʒ ə ɾ s 'ə j
eines	'ə j n ə s
Eines	'ə j n ə s
remei	r ə m 'ə j
caiguda	k ə j ɣ 'u ð ə
aimara	ə j m 'a ɾ ə
Serveis	s ə ɾ v 'ə j s
Eivissa	ə j v 'i s ə
Arenys	ə ɾ 'ə j n s
terrenys	t ə r 'ə j n s
seitons	s ə j t 'o n s
paisatgisme	p ə j z ə dʒ 'i z m ə
kuwaitians	k u β ə j t i 'a n s
jamaicà	ʒ ə m ə j k 'a
jamaicans	ʒ ə m ə j k 'a n s
discjòqueis	d i s k ʒ 'ɔ k ə j s
caigudes	k ə j ɣ 'u ð ə s
Weissmann	b ə j s m 'a n n
Vailets	v ə j l 'ə t s
Taipei	t ə j p 'ə j
Tailàndia	t ə j l 'a n d i ə
Serveis	s ə ɾ v 'ə j s
Remei	r ə m 'ə j
Nairobi	n ə j ɾ 'ɔ β i
Eindhoven	ə j n d 'o v ə n
guèiser	g 'ə j z ə
feina	f 'ə j n ə
caiguts	k ə j ɣ 'u t s
Beirut	b ə j ɾ 'u t
haitians	ə j t i 'a n s
haití	ə j t 'i
heɾbei	ə ɾ β 'ə j
bailaora  b ə j l ə 'o ɾ ə 
seiedora  s ə j ə ð 'o ɾ ə 
ailladora  ə j ʎ ə ð 'o ɾ ə 
esvaidora  ə z v ə j ð 'o ɾ ə 
feinadora  f ə j n ə ð 'o ɾ ə 
bailaores  b ə j l ə 'o ɾ ə s 
seiedores  s ə j ə ð 'o ɾ ə s 
ailladores  ə j ʎ ə ð 'o ɾ ə s 
esvaidores  ə z v ə j ð 'o ɾ ə s 
feinadores  f ə j n ə ð 'o ɾ ə s 
