A	'a	 a 
ababol	a β a β 'o l	 a β a β 'ɔ l 
abandonis	a β a n d 'ɔ n i s	 a β a n d 'o n i s 
abdomen	a b d 'o m e n	 a b d 'ɔ m e n 
abduir	a b d w 'i ɾ	 a b d u 'i ɾ 
abellerol	a β e ʎ e ɾ 'o l	 a β e ʎ e ɾ 'ɔ l 
Abraham	a β ɾ a 'a m	 a β ɾ a 'ɛ m 
absents	a p s 'e n s	 a p s 'e n t s 
absolt	a p s 'ɔ l t	 a p s 'o l t 
absolts	a p s 'ɔ l s	 a p s 'o l t s 
acariciem	a k a ɾ i s i 'ɛ m	 a k a ɾ i s i 'e m 
aconseguida	a k o n s e ɣ 'i ð a	 a k o n s e ɣ u 'i ð a 
aconseguides	a k o n s e ɣ 'i ð e s	 a k o n s e ɣ u 'i ð e s 
acorda	a k 'o ɾ ð a	 a k 'ɔ ɾ ð a 
adduir	a d d w 'i ɾ	 a d d u 'i ɾ 
Adelaida	a ð e l 'a j ð a	 a ð e l a 'i ð a 
adius	a ð 'i w s	 a ð i 'u s 
admesa	a d m 'e z a	 a d m 'ɛ z a 
admeses	a d m 'e z e s	 a d m 'ɛ z e s 
admesos	a d m 'e z o s	 a d m 'ɛ z o s 
admetre	a d m 'e t ɾ e	 a d m 'ɛ t ɾ e 
adolescents	a ð o l e s 'e n s	 a ð o l e s 'e n t s 
adorem	a ð o ɾ 'ɛ m	 a ð o ɾ 'e m 
adúltera	a ð 'u l t e ɾ a	 a ð u l t 'e ɾ a 
adults	a ð 'u l s	 a ð 'u l t s 
advers	a d v 'ɛ ɾ s	 a d v 'e ɾ s 
aeroport	a e ɾ o p 'ɔ ɾ t	 a e ɾ o p 'o ɾ t 
aerosol	a e ɾ o z 'o l	 a e ɾ o z 'ɔ l 
afaitada	a f a j t 'a ð a	 a f a i t 'a ð a 
afaitades	a f a j t 'a ð e s	 a f a i t 'a ð e s 
afaitar	a f a j t 'a ɾ	 a f a i t 'a ɾ 
afaitat	a f a j t 'a t	 a f a i t 'a t 
afaitats	a f a j t 'a t s	 a f a i t 'a t s 
afectem	a f e k t 'ɛ m	 a f e k t 'e m 
Afganistan	a v ɣ a n i s t 'a n	 a f ɣ a n i s t 'a n 
afilem	a f i l 'ɛ m	 a f i l 'e m 
aflores	a f l 'ɔ ɾ e s	 a f l 'o ɾ e s 
afronta	a f ɾ 'o n t a	 a f ɾ 'ɔ n t a 
agenda	a d ʒ 'e n d a	 a d ʒ 'ɛ n d a 
agents	a d ʒ 'e n s	 a d ʒ 'e n t s 
agudesa	a ɣ u ð 'e z a	 a ɣ u ð 'ɛ z a 
ai	'a j	 'a i 
Àiax	'a j a k s	 a j 'a k s 
aidada	a j ð 'a ð a	 a i ð 'a ð a 
aidades	a j ð 'a ð e s	 a i ð 'a ð e s 
aidant	a j ð 'a n t	 a i ð 'a n t 
aidar	a j ð 'a ɾ	 a i ð 'a ɾ 
aidat	a j ð 'a t	 a i ð 'a t 
aidats	a j ð 'a t s	 a i ð 'a t s 
al	'a l	 a l 
albanesos	a l β a n 'e z o s	 a l β a n 'ɛ z o s 
alcohol	a l k o 'ɔ l	 a l k o 'a l 
alegre	a l 'e ɣ ɾ e	 a l 'ɛ ɣ ɾ e 
algebraic	a l d ʒ e β ɾ 'a j k	 a l d ʒ e β ɾ 'a i k 
àlgids	'a l d ʒ i t s	 'a l d ʒ i ð s 
algueresa	a l ɣ e ɾ 'e z a	 a l ɣ e ɾ 'ɛ z a 
algutzir	a l ɣ u d z 'i ɾ	 a l ɣ u t z 'i ɾ 
àliga	'a l i ɣ a	 ' a l i ɣ a 
àligues	'a l i ɣ e s	 ' a l i ɣ e s 
almenys	a l m 'e ɲ s	 a l m 'ɛ ɲ s 
almívar	a l m 'i v a ɾ	 a l m i v 'a ɾ 
Altai	a l t 'a j	 a l t 'a i 
altaic	a l t 'a j k	 a l t 'a i k 
altesa	a l t 'e z a	 a l t 'ɛ z a 
altruisme	a l t ɾ w 'i z m e	 a l t ɾ u 'i z m e 
altruista	a l t ɾ w 'i s t a	 a l t ɾ u 'i s t a 
alts	'a l s	 'a l t s 
Àlvar	'a l v a ɾ	 a l v 'a ɾ 
amagueu	a m a ɣ 'e w	 a m a ɣ 'ɛ w 
amainada	a m a j n 'a ð a	 a m a i n 'a ð a 
amainades	a m a j n 'a ð e s	 a m a i n 'a ð e s 
amainant	a m a j n 'a n t	 a m a i n 'a n t 
amainar	a m a j n 'a ɾ	 a m a i n 'a ɾ 
amainat	a m a j n 'a t	 a m a i n 'a t 
amainats	a m a j n 'a t s	 a m a i n 'a t s 
ametlla	a m 'e l l a	 a m 'ɛ l ʎ a 
ametller	a m e l l 'e ɾ	 a m e ʎ l 'e ɾ 
amiants	a m i 'a n s	 a m i 'a n t s 
ampolla	a m p 'o ʎ a	 a m p 'ɔ ʎ a 
anàrquica	a n 'a ɾ k i k a	 a n a ɾ k 'i k a 
anàrquics	a n 'a ɾ k i k s	 a n a ɾ k 'i k s 
Andreu	a n d ɾ 'e w	 a n d ɾ 'ɛ w 
anglesa	a ŋ g l 'e z a	 a ŋ g l 'ɛ z a 
anglesos	a ŋ g l 'e z o s	 a ŋ g l 'ɛ z o s 
Ànglia	'a ŋ g l i a	 a ŋ g l 'i a 
anguila	a ŋ g 'i l a	 a ŋ g u 'i l a 
anguiles	a ŋ g 'i l e s	 a ŋ g u 'i l e s 
antimoni	a n t i m 'ɔ n i	 a n t i m 'o n i 
Antoni	a n t 'ɔ n i	 a n t 'o n i 
ants	'a n s	 'a n t s 
aplec	a p l 'e k	 a p l 'ɛ k 
apòstrofs	a p 'ɔ s t ɾ o f s	 a p o s t ɾ 'ɔ f s 
apresa	a p ɾ 'e z a	 a p ɾ 'ɛ z a 
apreses	a p ɾ 'e z e s	 a p ɾ 'ɛ z e s 
aquàriums	a k w 'a ɾ i u m s	 a k w 'a ɾ i w m s 
aqüeducte	a k w e ð 'u k t e	 a k e ð 'u k t e 
aqüeductes	a k w e ð 'u k t e s	 a k e ð 'u k t e s 
aquest	a k 'e s t	 a k 'ɛ s t 
aqüícola	a k w 'i k o l a	 a k 'i k o l a 
aqüicultura	a k w i k u l t 'u ɾ a	 a k i k u l t 'u ɾ a 
aqüífer	a k w 'i f e ɾ	 a k 'i f e ɾ 
àrab	'a ɾ a p	 'a ɾ a β 
aràcnid	a ɾ 'a g n i t	 a ɾ 'a k n i t 
arameu	a ɾ a m 'e w	 a ɾ a m 'ɛ w 
arcaics	a ɾ k 'a j k s	 a ɾ k a 'i k s 
àrguens	'a ɾ ɣ e n s	 a ɾ ɣ 'e n s 
aritmètic	a ɾ i d m 'ɛ t i k	 a ɾ i t m 'ɛ t i k 
aritmètica	a ɾ i d m 'ɛ t i k a	 a ɾ i t m 'ɛ t i k a 
arraulint	a r a w l 'i n t	 a r a u l 'i n t 
arraulir	a r a w l 'i ɾ	 a r a u l 'i ɾ 
arreu	a r 'e w	 a r 'ɛ w 
asimètric	a s i m 'ɛ t ɾ i k	 a z i m 'ɛ t ɾ i k 
asímptota	a z 'i m t o t a	 a z i m p t 'ɔ t a 
asseure	a s 'e w ɾ e	 a s 'ɛ w ɾ e 
asseure's	a s 'e w ɾ e s	 a s e w ɾ 'ɛ s 
assumpte	a s 'u m t e	 a s 'u m p t e 
assumptes	a s 'u m t e s	 a s 'u m p t e s 
asteroide	a s t e ɾ 'ɔ j ð e	 a s t e ɾ o 'i ð e 
astronauta	a s t ɾ o n 'a w t a	 a s t ɾ o n a 'u t a 
atendre	a t 'e n d ɾ e	 a t 'ɛ n d ɾ e 
ateneu	a t e n 'e w	 a t e n 'ɛ w 
Ateneu	a t e n 'e w	 a t e n 'ɛ w 
atesa	a t 'e z a	 a t 'ɛ z a 
ateses	a t 'e z e s	 a t 'ɛ z e s 
atesos	a t 'e z o s	 a t 'ɛ z o s 
ateu	a t 'e w	 a t 'ɛ w 
atleta	a d l 'e t a	 a t l 'e t a 
atlètic	a d l 'ɛ t i k	 a t l 'ɛ t i k 
atraient	a t ɾ a j 'e n t	 a t ɾ a i 'e n t 
atreure	a t ɾ 'e w ɾ e	 a t ɾ 'ɛ w ɾ e 
atribuint	a t ɾ i β w 'i n t	 a t ɾ i β u 'i n t 
atribuir	a t ɾ i β w 'i ɾ	 a t ɾ i β u 'i ɾ 
atroç	a t ɾ 'ɔ s	 a t ɾ 'o s 
augment	a w g m 'e n t	 a w a m 'e n t 
Àustria	'a w s t ɾ i a	 a w s t ɾ 'i a 
autòmats	a w t 'ɔ m a t s	 a w t o m 'a t s 
avinentesa	a v i n e n t 'e z a	 a v i n e n t 'ɛ z a 
babiloni	b a β i l 'ɔ n i	 b a β i l 'o n i 
Badakhxan	b a ð a k t ʃ 'a n	 b a ð a k e 'a n 
bàdminton	b 'a d m i n t o n	 b a d m i n t 'o n 
Bahames	b a 'a m e s	 b a m m e s 
basquetbol	b a s k e d b 'o l	 b a s k e t b 'ɔ l 
batec	b a t 'e k	 b a t 'ɛ k 
batlle	b 'a l l e	 b 'a t ʎ e 
Batlle	b 'a l l e	 b 'a t ʎ e 
batlles	b 'a l l e s	 b 'a t ʎ e s 
be	b 'e	 b 'ɛ 
bec	b 'e k	 b 'ɛ k 
beca	b 'e k a	 b 'ɛ k a 
befa	b 'e f a	 b 'ɛ f a 
bei	b 'ɛ j	 b 'ɛ i 
bellesa	b e ʎ 'e z a	 b e ʎ 'ɛ z a 
ben	b 'e n	 b 'ɛ n 
beneficiem	b e n e f i s i 'ɛ m	 b e n e f i s i 'e m 
beneitó	b e n e j t 'o	 b e n e i t 'o 
bens	b 'e n s	 b 'ɛ n s 
beques	b 'e k e s	 b 'ɛ k e s 
Bèrgam	b 'ɛ ɾ ɣ a m	 b e ɾ ɣ 'a m 
berkeli	b e ɾ k 'ɛ l i	 b e ɾ e 'ɛ l i 
bertrol	b e ɾ t ɾ 'o l	 b e ɾ t ɾ 'ɔ l 
bes	b 'e s	 b 'ɛ s 
besnebot	b e z n e β 'o t	 b e z n e β 'ɔ t 
beso	b 'e z o	 b 'ɛ z o 
bestiesa	b e s t i 'e z a	 b e s t i 'ɛ z a 
beu	b 'e w	 b 'ɛ w 
beure	b 'e w ɾ e	 b 'ɛ w ɾ e 
beus	b 'e w s	 b 'ɛ w s 
Bigorra	b i ɣ 'ɔ r a	 b i ɣ 'o r a 
bilbaí	b i l β a 'i	 b i l β 'a t 
bilingüe	b i l 'i ŋ g w e	 b i l 'i ŋ g e 
Blai	b l 'a j	 b l 'a i 
bleda	b l 'e ð a	 b l 'ɛ ð a 
boca	b 'o k a	 b 'ɔ k a 
boda	b 'o ð a	 b 'ɔ ð a 
bodega	b o ð 'e ɣ a	 b o ð 'ɛ ɣ a 
bodes	b 'o ð e s	 b 'ɔ ð e s 
boga	b 'o ɣ a	 b 'ɔ ɣ a 
boirina	b o j ɾ 'i n a	 b o i ɾ 'i n a 
boirós	b o j ɾ 'o s	 b o i ɾ 'o s 
bolca	b 'o l k a	 b 'ɔ l k a 
boletaire	b o l e t 'a j ɾ e	 b o l e t a 'i ɾ e 
bolígrafs	b o l 'i ɣ ɾ a f s	 b o l i ɣ ɾ 'a f s 
bolívar	b o l 'i v a ɾ	 b o l i v 'a ɾ 
bolquen	b 'o l k e n	 b 'ɔ l k e n 
bomba	b 'o m b a	 b 'ɔ m b a 
bombes	b 'o m b e s	 b 'ɔ m b e s 
bombo	b 'o m b o	 b 'ɔ m b o 
bombolla	b o m b 'o ʎ a	 b o m b 'ɔ ʎ a 
bonze	b 'ɔ n z e	 b 'o n z e 
boques	b 'o k e s	 b 'ɔ k e s 
borda	b 'o ɾ ð a	 b 'ɔ ɾ ð a 
Bordeus	b o ɾ ð 'e w s	 b o ɾ ð 'ɛ w s 
bordo	b 'o ɾ ð o	 b 'ɔ ɾ ð o 
borrissol	b o r i s 'o l	 b o r i s 'ɔ l 
borsa	b 'o ɾ s a	 b 'ɔ ɾ s a 
borses	b 'o ɾ s e s	 b 'ɔ ɾ s e s 
bosquerol	b o s k e ɾ 'o l	 b o s k e ɾ 'ɔ l 
bossa	b 'o s a	 b 'ɔ s a 
bosses	b 'o s e s	 b 'ɔ s e s 
bot	b 'o t	 b 'ɔ t 
bou	b 'ɔ w	 b 'o w 
bous	b 'ɔ w s	 b o 'u s 
boxa	b 'o k s a	 b 'ɔ k s a 
boxes	b 'o k s e s	 b 'ɔ k s e s 
brànquia	b ɾ 'a ŋ k i a	 b ɾ a ŋ k 'i a 
brànquies	b ɾ 'a ŋ k i e s	 b ɾ a ŋ k 'i e s 
brega	b ɾ 'e ɣ a	 b ɾ 'ɛ ɣ a 
bretxa	b ɾ 'e t ʃ a	 b ɾ 'ɛ t ʃ a 
breu	b ɾ 'e w	 b ɾ 'ɛ w 
breus	b ɾ 'e w s	 b ɾ 'ɛ w s 
broda	b ɾ 'o ð a	 b ɾ 'ɔ ð a 
broida	b ɾ 'ɔ j ð a	 b ɾ o 'i ð a 
broides	b ɾ 'ɔ j ð e s	 b ɾ o 'i ð e s 
brolla	b ɾ 'o ʎ a	 b ɾ 'ɔ ʎ a 
brollen	b ɾ 'o ʎ e n	 b ɾ 'ɔ ʎ e n 
brot	b ɾ 'o t	 b ɾ 'ɔ t 
brou	b ɾ 'ɔ w	 b ɾ 'o w 
búbal	b 'u β a l	 b u β 'a l 
búfal	b 'u f a l	 b u f 'a l 
búfals	b 'u f a l s	 b u f 'a l s 
búgula	b 'u ɣ u l a	 b u ɣ 'u l a 
buit	b w 'i t	 b u 'i t 
buixol	b u j ʃ 'o l	 b u j ʃ 'ɔ l 
búlgar	b 'u l ɣ a ɾ	 b u l ɣ 'a ɾ 
búlgara	b 'u l ɣ a ɾ a	 b u l ɣ 'a ɾ a 
búlgares	b 'u l ɣ a ɾ e s	 b u l ɣ 'a ɾ e s 
burgesa	b u ɾ d ʒ 'e z a	 b u ɾ d ʒ 'ɛ z a 
burgesos	b u ɾ d ʒ 'e z o s	 b u ɾ d ʒ 'ɛ z o s 
butlla	b 'u l l a	 b 'u t ʎ a 
butlles	b 'u l l e s	 b 'u t ʎ e s 
butlletins	b u l l e t 'i n s	 b u ʎ l e t 'i n s 
cabeça	k a β 'ɛ s a	 k a β 'e s a 
caber	k a β 'ɛ ɾ	 k a β 'e ɾ 
cabirol	k a β i ɾ 'o l	 k a β i ɾ 'ɔ l 
cabiscol	k a β i s k 'o l	 k a β i s k 'ɔ l 
cacem	k a s 'ɛ m	 k a s 'e m 
caiguda	k a j ɣ 'u ð a	 k a i ɣ 'u ð a 
caigudes	k a j ɣ 'u ð e s	 k a i ɣ 'u ð e s 
caigut	k a j ɣ 'u t	 k a i ɣ 'u t 
caiguts	k a j ɣ 'u t s	 k a i ɣ 'u t s 
calabruixar	k a l a β ɾ u j ʃ 'a ɾ	 k a l a β ɾ u i ʃ 'a ɾ 
calàndria	k a l 'a n d ɾ i a	 k a l a n d ɾ 'i a 
calb	k 'a l p	 k 'a l i 
campestre	k a m p 'e s t ɾ e	 k a m p 'ɛ s t ɾ e 
camps	k 'a m s	 k 'a m p s 
càncers	k 'a n s e ɾ s	 k a n s 'e ɾ s 
càndids	k 'a n d i t s	 k a n d i 'a s 
caníbals	k a n 'i β a l s	 k a n i β 'a l s 
canoa	k a n 'o a	 k a n 'ɔ a 
cants	k 'a n s	 k 'a n t s 
capdavall	k a b d a v 'a ʎ	 k a p d a v 'a ʎ 
captem	k a p t 'ɛ m	 k a p t 'e m 
caragol	k a ɾ a ɣ 'o l	 k a ɾ a ɣ 'ɔ l 
carantoines	k a ɾ a n t 'ɔ j n e s	 k a ɾ a n t 'ɔ i n e s 
caribeny	k a ɾ i β 'e ɲ	 k a ɾ i β 'ɛ ɲ 
caricaturesc	k a ɾ i k a t u ɾ 'e s k	 k a ɾ i k a t u ɾ 'ɛ s k 
cartaginesos	k a ɾ t a d ʒ i n 'e z o s	 k a ɾ t a d ʒ i n 'ɛ z o s 
cartílag	k a ɾ t 'i l a k	 k a ɾ t i l 'a k 
cartílags	k a ɾ t 'i l a k s	 k a ɾ t i l 'a k s 
caserna	k a z 'ɛ ɾ n a	 k a s 'ɛ ɾ n a 
catanyol	k a t a ɲ 'o l	 k a t a ɲ 'ɔ l 
catorze	k a t 'o ɾ z e	 k a t 'ɔ ɾ z e 
cauts	k 'a w t s	 k a 'u t s 
cautxú	k a w t ʃ 'u	 k a u t ʃ 'u 
ce	s 'e	 s 'ɛ 
cec	s 'e k	 s 'ɛ k 
cecs	s 'e k s	 s 'ɛ k s 
cedre	s 'e ð ɾ e	 s 'ɛ ð ɾ e 
cega	s 'e ɣ a	 s 'ɛ ɣ a 
cegues	s 'e ɣ e s	 s 'ɛ ɣ e s 
ceguesa	s e ɣ 'e z a	 s e ɣ 'ɛ z a 
cens	s 'e n s	 s 'ɛ n s 
censos	s 'e n s o s	 s 'ɛ n s o s 
centre	s 'e n t ɾ e	 s 'ɛ n t ɾ e 
centren	s 'e n t ɾ e n	 s 'ɛ n t ɾ e n 
centres	s 'e n t ɾ e s	 s 'ɛ n t ɾ e s 
cèntrics	s 'ɛ n t ɾ i k s	 s e n t ɾ 'i k s 
centro	s 'e n t ɾ o	 s 'ɛ n t ɾ o 
ceptre	s 'e p t ɾ e	 s 'ɛ p t ɾ e 
cèrcols	s 'ɛ ɾ k o l s	 s e ɾ k 'ɔ l s 
cervesa	s e ɾ v 'e z a	 s e ɾ v 'ɛ z a 
Cèsar	s 'ɛ z a ɾ	 s e z 'a ɾ 
cessen	s 'e s e n	 s 'ɛ s e n 
cessin	s 'e s i n	 s 'ɛ s i n 
cèstrum	s 'ɛ s t ɾ u m	 s e s t ɾ 'u m 
ciberespai	s i β e ɾ e s p 'a j	 s i β e ɾ e s p 'a i 
ciberespais	s i β e ɾ e s p 'a j s	 s i β e ɾ e s p 'a i s 
Cíclades	s 'i k l a ð e s	 s i k l 'a ð e s 
cilíndrica	s i l 'i n d ɾ i k a	 s i l i n d ɾ 'i k a 
cínamom	s 'i n a m o m	 s i n a m 'o m 
circuit	s i ɾ k w 'i t	 s 'i ɾ k 'u 'i t 
circuits	s i ɾ k w 'i t s	 s 'i ɾ k 'u 'i t s 
ciutadà	s i w t a ð 'a	 s 'i w t 'a ð 'a 
ciutadania	s i w t a ð a n 'i a	 s 'i w t 'a ð a n 'i a 
clavicèmbal	k l a v i s 'ɛ m b a l	 k l a v i s e m b 'a l 
clona	k l 'ɔ n a	 k l 'o n a 
clones	k l 'ɔ n e s	 k l 'o n e s 
cloni	k l 'ɔ n i	 k l 'o n i 
clonin	k l 'ɔ n i n	 k l 'o n i n 
clonis	k l 'ɔ n i s	 k l 'o n i s 
clono	k l 'ɔ n o	 k l 'o n o 
clora	k l 'ɔ ɾ a	 k l 'o ɾ a 
clores	k l 'ɔ ɾ e s	 k l 'o ɾ e s 
closes	k l 'ɔ z e s	 k l 'o z e s 
clou	k l 'ɔ w	 k l 'o w 
cobla	k 'o β l a	 k 'ɔ β l a 
cobles	k 'o β l e s	 k 'ɔ β l e s 
cobra	k 'o β ɾ a	 k 'ɔ β ɾ a 
cobren	k 'o β ɾ e n	 k 'ɔ β ɾ e n 
cobres	k 'o β ɾ e s	 k 'ɔ β ɾ e s 
cobro	k 'o β ɾ o	 k 'ɔ β ɾ o 
coco	k 'o k o	 k 'ɔ k o 
cocs	k 'o k s	 k 'ɔ k s 
còctels	k 'ɔ k t e l s	 k o k t 'ɛ l s 
coexistirem	k o e g z i s t i ɾ 'ɛ m	 k o e g z i s t i ɾ 'e m 
cofoi	k o f 'ɔ j	 k o f 'o i 
cofre	k 'o f ɾ e	 k 'ɔ f ɾ e 
cogoma	k o ɣ 'ɔ m a	 k o ɣ 'o m a 
cogombre	k o ɣ 'o m b ɾ e	 k o ɣ 'ɔ m b ɾ e 
coit	k 'ɔ j t	 k o 'i t 
colesteatoma	k o l e s t e a t 'ɔ m a	 k o l e s t e a t 'o m a 
colesteatomes	k o l e s t e a t 'ɔ m e s	 k o l e s t e a t 'o m e s 
colossos	k o l 'o s o s	 k o l 'ɔ s o s 
colza	k 'o l z a	 k 'ɔ l z a 
colze	k 'o l z e	 k 'ɔ l z e 
colzes	k 'o l z e s	 k 'ɔ l z e s 
comandem	k o m a n d 'ɛ m	 k o m a n d 'e m 
comboi	k o m b 'ɔ j	 k o m b 'o i 
comesa	k o m 'e z a	 k o m 'ɛ z a 
comeses	k o m 'e z e s	 k o m 'ɛ z e s 
comesos	k o m 'e z o s	 k o m 'ɛ z o s 
cometre	k o m 'e t ɾ e	 k o m 'ɛ t ɾ e 
còmplices	k 'ɔ m p l i s e s	 k o m p l 'i s e s 
compliquem	k o m p l i k 'ɛ m	 k o m p l i k 'e m 
compost	k o m p 'ɔ s t	 k o m p 'o s t 
compra	k 'o m p ɾ a	 k 'ɔ m p ɾ a 
compren	k 'o m p ɾ e n	 k 'ɔ m p ɾ e n 
compres	k 'o m p ɾ e s	 k 'ɔ m p ɾ e s 
compresa	k o m p ɾ 'e z a	 k o m p ɾ 'ɛ z a 
compreses	k o m p ɾ 'e z e s	 k o m p ɾ 'ɛ z e s 
compresos	k o m p ɾ 'e z o s	 k o m p ɾ 'ɛ z o s 
compro	k 'o m p ɾ o	 k 'ɔ m p ɾ o 
compromesa	k o m p ɾ o m 'e z a	 k o m p ɾ o m 'ɛ z a 
compromeses	k o m p ɾ o m 'e z e s	 k o m p ɾ o m 'ɛ z e s 
compromesos	k o m p ɾ o m 'e z o s	 k o m p ɾ o m 'ɛ z o s 
comprometre	k o m p ɾ o m 'e t ɾ e	 k o m p ɾ o m 'ɛ t ɾ e 
compta	k 'o m t a	 k 'ɔ m p t a 
compte	k 'o m t e	 k 'ɔ m p t e 
compten	k 'o m t e n	 k 'ɔ m p t e n 
comptes	k 'o m t e s	 k 'ɔ m p t e s 
compto	k 'o m t o	 k 'ɔ m p t o 
comte	k 'o m t e	 k 'ɔ m t e 
comtes	k 'o m t e s	 k 'ɔ m t e s 
conca	k 'o ŋ k a	 k 'ɔ ŋ k a 
concloses	k o ŋ k l 'ɔ z e s	 k o ŋ k l 'o z e s 
conclosos	k o ŋ k l 'ɔ z o s	 k o ŋ k l 'o z o s 
conduir	k o n d w 'i ɾ	 k o n d u 'i ɾ 
cònjuge	k 'ɔ n d ʒ u d ʒ e	 k o n d ʒ 'u d ʒ e 
conques	k 'o ŋ k e s	 k 'ɔ ŋ k e s 
conquesta	k o ŋ k 'e s t a	 k o ŋ k 'ɛ s t a 
consens	k o n s 'e n s	 k o n s 'ɛ n s 
conseqüència	k o n s e k w 'ɛ n s i a	 k o n s e k 'ɛ n s i a 
conseqüències	k o n s e k w 'ɛ n s i e s	 k o n s e k 'ɛ n s i e s 
consta	k 'o n s t a	 k 'ɔ n s t a 
consten	k 'o n s t e n	 k 'ɔ n s t e n 
constituents	k o n s t i t u 'e n s	 k o n s t i t u 'e n t s 
construir	k o n s t ɾ w 'i ɾ	 k o n s t ɾ u 'i ɾ 
consuetud	k o n s u e t 'u t	 k o n s e t 'u t 
conta	k 'o n t a	 k 'ɔ n t a 
conte	k 'o n t e	 k 'ɔ n t e 
conten	k 'o n t e n	 k 'ɔ n t e n 
contes	k 'o n t e s	 k 'ɔ n t e s 
contingents	k o n t i n d ʒ 'e n s	 k o n t i n d ʒ 'e n t s 
contra	k 'o n t ɾ a	 k 'ɔ n t ɾ a 
contres	k 'o n t ɾ e s	 k 'ɔ n t ɾ e s 
contreure	k o n t ɾ 'e w ɾ e	 k o n t ɾ 'ɛ w ɾ e 
contribuents	k o n t ɾ i β u 'e n s	 k o n t ɾ i β u 'e n t s 
contribuir	k o n t ɾ i β w 'i ɾ	 k o n t ɾ i β u 'i ɾ 
cookie	k o o k 'i e	 k o o 'i e 
cop	k 'o p	 k 'ɔ p 
copa	k 'o p a	 k 'ɔ p a 
copes	k 'o p e s	 k 'ɔ p e s 
copsa	k 'o p s a	 k 'ɔ p s a 
cora	k 'ɔ ɾ a	 k 'o ɾ a 
corre	k 'o r e	 k 'ɔ r e 
corren	k 'o r e n	 k 'ɔ r e n 
correu	k o r 'e w	 k o r 'ɛ w 
corro	k 'o r o	 k 'ɔ r o 
corrompre	k o r 'o m p ɾ e	 k o r 'ɔ m p ɾ e 
corsa	k 'o ɾ s a	 k 'ɔ ɾ s a 
corses	k 'o ɾ s e s	 k 'ɔ ɾ s e s 
corsos	k 'o ɾ s o s	 k 'ɔ ɾ s o s 
cortesa	k o ɾ t 'e z a	 k o ɾ t 'ɛ z a 
corticoide	k o ɾ t i k 'ɔ j ð e	 k o ɾ t i k o 'i ð e 
cosa	k 'ɔ z a	 k 'o z a 
coses	k 'ɔ z e s	 k 'o z e s 
cosmos	k 'o z m o s	 k 'ɔ z m o s 
cossol	k o s 'o l	 k o s 'ɔ l 
cost	k 'ɔ s t	 k 'o s t 
cotxe	k 'o t ʃ e	 k 'ɔ t ʃ e 
cotxes	k 'o t ʃ e s	 k 'ɔ t ʃ e s 
cou	k 'ɔ w	 k 'o w 
coure	k 'o w ɾ e	 k 'ɔ w ɾ e 
cova	k 'o v a	 k 'ɔ v a 
crec	k ɾ 'e k	 k ɾ 'ɛ k 
creen	k ɾ 'e e n	 k ɾ 'ɛ e n 
creï	k ɾ 'e i	 k ɾ 'ɛ i 
creient	k ɾ e j 'e n t	 k ɾ e i 'e n t 
creïn	k ɾ 'e i n	 k ɾ e 'i n 
cremen	k ɾ 'e m e n	 k ɾ 'ɛ m e n 
cremes	k ɾ 'e m e s	 k ɾ 'ɛ m e s 
cresta	k ɾ 'e s t a	 k ɾ 'ɛ s t a 
crestes	k ɾ 'e s t e s	 k ɾ 'ɛ s t e s 
cretes	k ɾ 'ɛ t e s	 k ɾ 'e t e s 
creu	k ɾ 'e w	 k ɾ 'ɛ w 
creure	k ɾ 'e w ɾ e	 k ɾ 'ɛ w ɾ e 
creus	k ɾ 'e w s	 k ɾ 'ɛ w s 
cruesa	k ɾ u 'e z a	 k ɾ u 'ɛ z a 
cruixida	k ɾ u j ʃ 'i ð a	 k ɾ u i ʃ 'i ð a 
cruixides	k ɾ u j ʃ 'i ð e s	 k ɾ u i ʃ 'i ð e s 
cruixir	k ɾ u j ʃ 'i ɾ	 k ɾ u i ʃ 'i ɾ 
cruixit	k ɾ u j ʃ 'i t	 k ɾ u i ʃ 'i t 
cruixits	k ɾ u j ʃ 'i t s	 k ɾ u i ʃ 'i t s 
cuboide	k u β 'ɔ j ð e	 k u β o 'i ð e 
cudol	k u ð 'o l	 k u ð 'ɔ l 
cuida	k w 'i ð a	 k d ʒ 'i ð a 
cuides	k w 'i ð e s	 k 'u j ð e s 
cuido	k w 'i ð o	 k 'u j ð o 
cuina	k w 'i n a	 k 'u j n a 
cuir	k w 'i ɾ	 k t 'i ɾ 
cupaire	k u p 'a j ɾ e	 k u p a 'i ɾ e 
currículum	k u r 'i k u l u m	 k u r i k u l 'u m 
currículums	k u r 'i k u l u m s	 k u r i k u l 'u m s 
damisel·la	d a m i z 'ɛ l a	 d a m i s 'ɛ l a 
danesos	d a n 'e z o s	 d a n 'ɛ z o s 
dantesc	d a n t 'e s k	 d a n t 'ɛ s k 
dantesca	d a n t 'e s k a	 d a n t 'ɛ s k a 
dantesques	d a n t 'e s k e s	 d a n t 'ɛ s k e s 
darrere	d a r 'e ɾ e	 d a r 'ɛ ɾ e 
de	d 'e	 d e 
dec	d 'e k	 d 'ɛ k 
dècada	d 'ɛ k a ð a	 d e k 'a ð a 
dècade	d 'ɛ k a ð e	 d e k 'a ð e 
dèdal	d 'ɛ ð a l	 d e ð 'a l 
deduir	d e ð w 'i ɾ	 d e ð u 'i ɾ 
defendre	d e f 'e n d ɾ e	 d e f 'ɛ n d ɾ e 
dèficit	d 'ɛ f i s i t	 d e f i s 'i t 
definirem	d e f i n i ɾ 'ɛ m	 d e f i n i ɾ 'e m 
defora	d e f 'ɔ ɾ a	 d e f 'o ɾ a 
deixadesa	d e j ʃ a ð 'e z a	 d e j ʃ a ð 'ɛ z a 
deixeble	d e j ʃ 'e β l e	 d e j ʃ 'ɛ β l e 
deler	d e l 'ɛ ɾ	 d e l 'e ɾ 
delicadesa	d e l i k a ð 'e z a	 d e l i k a ð 'ɛ z a 
dempeus	d e m p 'e w s	 d e m p 'ɛ w s 
Dénia	d 'e n i a	 d e n 'i a 
dens	d 'e n s	 d 'ɛ n s 
densa	d 'e n s a	 d 'ɛ n s a 
denses	d 'e n s e s	 d 'ɛ n s e s 
densos	d 'e n s o s	 d 'ɛ n s o s 
dependre	d e p 'e n d ɾ e	 d e p 'ɛ n d ɾ e 
desa	d 'e z a	 d 'ɛ z a 
desatendre	d e z a t 'e n d ɾ e	 d e z a t 'ɛ n d ɾ e 
descompte	d e s k 'o m t e	 d e s k 'ɔ m p t e 
descontentem	d e s k o n t e n t 'ɛ m	 d e s k o n t e n t 'e m 
descuit	d e s k w 'i t	 d e s k u 'i t 
desembeinar	d e z e m b e j n 'a ɾ	 d e z e m b e i n 'a ɾ 
desembre	d e z 'e m b ɾ e	 d e z 'ɛ m b ɾ e 
deshidratar	d e s i ð ɾ a t 'a ɾ	 d e z i ð ɾ a t 'a ɾ 
deshonest	d e s o n 'e s t	 d e z o n 'ɛ s t 
desig	d e z 'i t ʃ	 d e z 'i ɣ 
desigs	d e z 'i t ʃ s	 d e z 'i d ʒ s 
desmai	d e z m 'a j	 d e z m 'a i 
deso	d 'e z o	 d 'ɛ z o 
desordre	d e z 'o ɾ ð ɾ e	 d e z 'ɔ ɾ ð ɾ e 
despendre	d e s p 'e n d ɾ e	 d e s p 'ɛ n d ɾ e 
despesa	d e s p 'e z a	 d e s p 'ɛ z a 
despeses	d e s p 'e z e s	 d e s p 'ɛ z e s 
destra	d 'e s t ɾ a	 d 'ɛ s t ɾ a 
destres	d 'e s t ɾ e s	 d 'ɛ s t ɾ e s 
destruir	d e s t ɾ w 'i ɾ	 d e s t ɾ u 'i ɾ 
desvetllada	d e z v e l l 'a ð a	 d e z v e ʎ l 'a ð a 
desvetllades	d e z v e l l 'a ð e s	 d e z v e ʎ l 'a ð e s 
desvetllament	d e z v e l l a m 'e n t	 d e z v e l ʎ a m 'e n t 
desvetllar	d e z v e l l 'a ɾ	 d e z v e ʎ l 'a ɾ 
desvetllat	d e z v e l l 'a t	 d e z v e ʎ l 'a t 
desvetllats	d e z v e l l 'a t s	 d e z v e ʎ l 'a t s 
detectivesc	d e t e k t i v 'e s k	 d e t e k t i v 'ɛ s k 
detectivesca	d e t e k t i v 'e s k a	 d e t e k t i v 'ɛ s k a 
detona	d e t 'ɔ n a	 d e t 'o n a 
detones	d e t 'ɔ n e s	 d e t 'o n e s 
detono	d e t 'ɔ n o	 d e t 'o n o 
deu	d 'e w	 d 'ɛ w 
deure	d 'e w ɾ e	 d 'ɛ w ɾ e 
deus	d 'e w s	 d 'ɛ w s 
deute	d 'e w t e	 d 'ɛ w t e 
devers	d e v 'ɛ ɾ s	 d e v 'e ɾ s 
difondre	d i f 'o n d ɾ e	 d i f 'ɔ n d ɾ e 
dijous	d i d ʒ 'ɔ w s	 d i d ʒ o 'u s 
diluir	d i l w 'i ɾ	 d i l u 'i ɾ 
dimecres	d i m 'e k ɾ e s	 d i m 'ɛ k ɾ e s 
dimoni	d i m 'ɔ n i	 d i m 'o n i 
dimonis	d i m 'ɔ n i s	 d i m 'o n i s 
dinou	d i n 'ɔ w	 d i n 'o w 
discoteca	d i s k o t 'e k a	 d i s k o t 'ɛ k a 
disminuir	d i z m i n w 'i ɾ	 d i z m i n u 'i ɾ 
dispers	d i s p 'ɛ ɾ s	 d i s p 'e ɾ s 
displicent	d i s p l i s 'e n t	 d i s p l i k 'e n t 
disseny	d i s 'e ɲ	 d i s 'ɛ ɲ 
dissequem	d i s e k 'ɛ m	 d i s e k 'e m 
dissolt	d i s 'ɔ l t	 d i s 'o l t 
dissort	d i s 'ɔ ɾ t	 d i s 'o ɾ t 
distendre	d i s t 'e n d ɾ e	 d i s t 'ɛ n d ɾ e 
distreure	d i s t ɾ 'e w ɾ e	 d i s t ɾ 'ɛ w ɾ e 
distribuir	d i s t ɾ i β w 'i ɾ	 d i s t ɾ i β u 'i ɾ 
diumenge	d i w m 'e n d ʒ e	 d i w m 'ɛ n d ʒ e 
divendres	d i v 'e n d ɾ e s	 d i v 'ɛ n d ɾ e s 
divers	d i v 'ɛ ɾ s	 d i v 'e ɾ s 
divuit	d i v w 'i t	 d i v i 'i t 
Djibouti	d d ʒ i β 'ɔ w t i	 d d ʒ i β o 'u t i 
dobla	d 'o β l a	 d 'ɔ β l a 
doble	d 'o β l e	 d 'ɔ β l e 
doblen	d 'o β l e n	 d 'ɔ β l e n 
dobles	d 'o β l e s	 d 'ɔ β l e s 
dodecaedre	d o ð e k a 'e ð ɾ e	 d o ð e k a 'ɛ ð ɾ e 
dogma	d 'o g m a	 d 'ɔ g m a 
dogmes	d 'o g m e s	 d 'ɔ g m e s 
dolça	d 'o l s a	 d 'ɔ l s a 
dolces	d 'o l s e s	 d 'ɔ l s e s 
dolços	d 'o l s o s	 d 'ɔ l s o s 
doler	d o l 'ɛ ɾ	 d o l 'e ɾ 
domem	d o m 'ɛ m	 d o m 'e m 
dona	d 'ɔ n a	 d 'o n a 
donen	d 'o n e n	 d 'ɔ n e n 
dones	d 'ɔ n e s	 d 'o n e s 
dònut	d 'ɔ n u t	 d o n 'u t 
dopa	d 'o p a	 d 'ɔ p a 
dotze	d 'o d z e	 d 'ɔ d z e 
drapaire	d ɾ a p 'a j ɾ e	 d ɾ a p a 'i ɾ e 
dropo	d ɾ 'o p o	 d ɾ 'ɔ p o 
dropos	d ɾ 'o p o s	 d ɾ 'ɔ p o s 
duaner	d u a n 'e ɾ	 d w a n 'e ɾ 
duresa	d u ɾ 'e z a	 d u ɾ 'ɛ z a 
e	'e	 k 
Ebre	'e β ɾ e	 'ɛ β ɾ e 
eco	'e k o	 'ɛ k o 
efluir	e f l w 'i ɾ	 a f l u 'i ɾ 
ego	'e ɣ o	 'ɛ ɣ o 
ei	'e j	 'ɛ i 
eina	'e j n a	 d ʒ 'i n a 
Eivissa	e j v 'i s a	 e i v 'i s a 
eixe	'e j ʃ e	 'ɛ j ʃ e 
elàstic	e l 'a s t i k	 a l 'a s t i k 
elàstica	e l 'a s t i k a	 a l 'a s t i k a 
elàstics	e l 'a s t i k s	 a l 'a s t i k s 
elàstiques	e l 'a s t i k e s	 a l 'a s t i k e s 
elèctrica	e l 'ɛ k t ɾ i k a	 e l e k t ɾ 'i k a 
elèctrics	e l 'ɛ k t ɾ i k s	 e l e k t ɾ 'i k s 
elèctrode	e l 'ɛ k t ɾ o ð e	 e l e k t ɾ 'ɔ ð e 
element	e l e m 'e n t	 ɛ l e m 'e n t 
Elies	e l 'i e s	 a l 'i e s 
el·lipsoide	e l i p s 'ɔ j ð e	 e l i p s o 'i ð e 
Eloi	e l 'ɔ j	 a l 'o i 
eloqüent	e l o k w 'e n t	 e l o k 'e n t 
emanar	e m a n 'a ɾ	 a m a n 'a ɾ 
emancipació	e m a n s i p a s i 'o	 a m a n s i p a s i 'o 
emasculada	a m a s k u l 'a ð a	 e m a s k u l 'a ð a 
emasculades	a m a s k u l 'a ð e s	 e m a s k u l 'a ð e s 
emascular	a m a s k u l 'a ɾ	 e m a s k u l 'a ɾ 
emasculat	a m a s k u l 'a t	 e m a s k u l 'a t 
emasculats	a m a s k u l 'a t s	 e m a s k u l 'a t s 
emboirar	a m b o j ɾ 'a ɾ	 a m b o i ɾ 'a ɾ 
embruixar	a m b ɾ u j ʃ 'a ɾ	 a m b ɾ i ʃ 'a ɾ 
emèrit	e m 'ɛ ɾ i t	 a m 'ɛ ɾ i t 
emèrita	e m 'ɛ ɾ i t a	 a m 'ɛ ɾ i t a 
emèrites	e m 'ɛ ɾ i t e s	 a m 'ɛ ɾ i t e s 
emèrits	e m 'ɛ ɾ i t s	 a m 'ɛ ɾ i t s 
emesa	e m 'e z a	 e m 'ɛ z a 
emeses	e m 'e z e s	 e m 'ɛ z e s 
emesos	e m 'e z o s	 e m 'ɛ z o s 
emetre	e m 'e t ɾ e	 e m 'ɛ t ɾ e 
emigres	e m 'i ɣ ɾ e s	 a m 'i ɣ ɾ e s 
emigri	e m 'i ɣ ɾ i	 a m 'i ɣ ɾ i 
emigro	e m 'i ɣ ɾ o	 a m 'i ɣ ɾ o 
Emili	e m 'i l i	 a m 'i l i 
Emília	e m 'i l i a	 a m 'i l i a 
emissari	e m i s 'a ɾ i	 a m i s 'a ɾ i 
emissió	e m i s i 'o	 a m i s i 'o 
emissor	e m i s 'o ɾ	 a m i s 'o ɾ 
emissora	e m i s 'o ɾ a	 a m i s 'o ɾ a 
empait	a m p 'a j t	 a m p a 'i t 
empaitar	a m p a j t 'a ɾ	 a m p a i t 'a ɾ 
empesa	a m p 'e z a	 a m p 'ɛ z a 
empeses	a m p 'e z e s	 a m p 'ɛ z e s 
empesos	a m p 'e z o s	 a m p 'ɛ z o s 
empra	'e m p ɾ a	 ' a m p ɾ a 
empremta	a m p ɾ 'e m t a	 a m p ɾ 'ɛ m t a 
empren	'e m p ɾ e n	 ' a m p ɾ e n 
empresa	a m p ɾ 'e z a	 a m p ɾ 'ɛ z a 
emula	e m 'u l a	 a m 'u l a 
emulació	e m u l a s i 'o	 a m u l a s i 'o 
emulada	e m u l 'a ð a	 a m u l 'a ð a 
emular	e m u l 'a ɾ	 a m u l 'a ɾ 
emulares	e m u l 'a ɾ e s	 a m u l 'a ɾ e s 
emularia	e m u l a ɾ 'i a	 a m u l a ɾ 'i a 
emulava	e m u l 'a v a	 a m u l 'a v a 
emulsió	e m u l s i 'o	 a m u l s i 'o 
emulsionar	e m u l s i o n 'a ɾ	 a m u l s i o n 'a ɾ 
en	'e n	 e n 
enagos	e n 'a ɣ o s	 a n 'a ɣ o s 
enaltir	e n a l t 'i ɾ	 a n a l t 'i ɾ 
encèfal	a n s 'ɛ f a l	 a n s e f 'a l 
encendre	a n s 'e n d ɾ e	 a n s 'ɛ n d ɾ e 
encens	a n s 'e n s	 a n s 'ɛ n s 
encesa	a n s 'e z a	 a n s 'ɛ z a 
enceses	a n s 'e z e s	 a n s 'ɛ z e s 
encesos	a n s 'e z o s	 a n s 'ɛ z o s 
endarrere	a n d a r 'e ɾ e	 a n d a r 'ɛ ɾ e 
ene	'e n e	 'ɛ n e 
ènema	'ɛ n e m a	 d n 'e m a 
engruixir	a ŋ g ɾ u j ʃ 'i ɾ	 a ŋ g ɾ u i ʃ 'i ɾ 
enlairament	a n l a j ɾ a m 'e n t	 a n l a i ɾ a m 'e n t 
enmig	a m m 'i t ʃ	 a n m 'i ɣ 
enorme	e n 'o ɾ m e	 a n 'ɔ ɾ m e 
enormes	e n 'o ɾ m e s	 a n 'ɔ ɾ m e s 
enormitat	e n o ɾ m i t 'a t	 a n o ɾ m i t 'a t 
enquesta	a ŋ k 'e s t a	 a ŋ k 'ɛ s t a 
ensems	a n s 'e m s	 a n s 'ɛ m s 
entendre	a n t 'e n d ɾ e	 a n t 'ɛ n d ɾ e 
entesa	a n t 'e z a	 a n t 'ɛ z a 
enteses	a n t 'e z e s	 a n t 'ɛ z e s 
entesos	a n t 'e z o s	 a n t 'ɛ z o s 
entre	'e n t ɾ e	 ' a n t ɾ e 
entren	'e n t ɾ e n	 ' a n t ɾ e n 
entres	'e n t ɾ e s	 ' a n t ɾ e s 
entro	'e n t ɾ o	 ' a n t ɾ o 
ep	'e p	 'ɛ p 
èpsilon	'ɛ p s i l o n	 ɛ p s i l 'o n 
eqüestre	e k w 'e s t ɾ e	 e k 'ɛ s t ɾ e 
equivoco	e k i v 'o k o	 e k i v 'ɔ k o 
eren	'e ɾ e n	 'ɛ ɾ e n 
éreu	'e ɾ e w	 ' e ɾ e w 
erm	'e ɾ m	 'ɛ ɾ m 
ermini	e ɾ m 'i n i	 a ɾ m 'i n i 
erroni	e r 'ɔ n i	 e r 'o n i 
es	'e s	 e s 
Esaú	a z a 'u	 a z 'a t 
escairada	a s k a j ɾ 'a ð a	 a s k a i ɾ 'a ð a 
escairades	a s k a j ɾ 'a ð e s	 a s k a i ɾ 'a ð e s 
escairar	a s k a j ɾ 'a ɾ	 a s k a i ɾ 'a ɾ 
escairat	a s k a j ɾ 'a t	 a s k a i ɾ 'a t 
escairats	a s k a j ɾ 'a t s	 a s k a i ɾ 'a t s 
escassesa	a s k a s 'e z a	 a s k a s 'ɛ z a 
escil·la	a s 'i l a	 a s k 'i l a 
escletxa	a s k l 'e t ʃ a	 a s k l 'ɛ t ʃ a 
escoceses	a s k o s 'e z e s	 a s k o s 'ɛ z e s 
escocesos	a s k o s 'e z o s	 a s k o s 'ɛ z o s 
escolta	a s k 'o l t a	 a s k 'ɔ l t a 
escombra	a s k 'o m b ɾ a	 a s k 'ɔ m b ɾ a 
escomesa	a s k o m 'e z a	 a s k o m 'ɛ z a 
escometre	a s k o m 'e t ɾ e	 a s k o m 'ɛ t ɾ e 
escuixar	a s k u j ʃ 'a ɾ	 a s k u i ʃ 'a ɾ 
esglai	a z ɣ l 'a j	 a z ɣ l 'a i 
esma	'e z m a	 a z m a 
esment	a z m 'e n t	 e z m 'e n t 
espai	a s p 'a j	 a s p 'a i 
espais	a s p 'a j s	 a s p 'a i s 
espardenya	a s p a ɾ ð 'e ɲ a	 a s p a ɾ ð 'ɛ ɲ a 
espectre	a s p 'e k t ɾ e	 a s p 'ɛ k t ɾ e 
espetec	a s p e t 'e k	 a s p e t 'ɛ k 
esplai	a s p l 'a j	 a s p l 'a i 
esplèndids	a s p l 'ɛ n d i t s	 a s p l e n d i 'a s 
espona	a s p 'ɔ n a	 a s p 'o n a 
esquetx	a s k 'e t ʃ	 a s k 'ɛ t ʃ 
essencialisme	e s e n s i a l 'i z m e	 a s e n s i a l 'i z m e 
essencialista	e s e n s i a l 'i s t a	 a s e n s i a l 'i s t a 
ésser	'e s e ɾ	 ' e s e ɾ 
est	'e s t	 'a s t 
esta	'e s t a	 a s t a 
estai	a s t 'a j	 a s t 'a i 
estàndard	a s t 'a n d a ɾ t	 a s t a n d 'a ɾ t 
estàndards	a s t 'a n d a ɾ t s	 a s t 'a n d a ɾ s 
estanyol	a s t a ɲ 'o l	 a s t a ɲ 'ɔ l 
estendre	a s t 'e n d ɾ e	 a s t 'ɛ n d ɾ e 
estepa	a s t 'e p a	 a s t 'ɛ p a 
esteperol	a s t e p e ɾ 'o l	 a s t e p e ɾ 'ɔ l 
estesa	a s t 'e z a	 a s t 'ɛ z a 
esteses	a s t 'e z e s	 a s t 'ɛ z e s 
estesos	a s t 'e z o s	 a s t 'ɛ z o s 
estómac	a s t 'o m a k	 a s t o m 'a k 
estos	'e s t o s	 a s t o s 
estramoni	a s t ɾ a m 'ɔ n i	 a s t ɾ a m 'o n i 
estrateg	a s t ɾ a t 'e k	 a s t ɾ a t 'ɛ g 
estri	'ɛ s t ɾ i	 a s t ɾ i 
estris	'ɛ s t ɾ i s	 a s t ɾ i s 
eta	'ɛ t a	 'e t a 
età	e t 'a	 a t 'a 
etcètera	e t s 'ɛ t e ɾ a	 a t s 'ɛ t e ɾ a 
etíop	e t 'i o p	 a t 'i o p 
ètnia	'ɛ d n i a	 'ɛ t n i a 
ètnic	'ɛ d n i k	 'ɛ t n i k 
eucaliptus	e w k a l 'i p t u s	 a w k a l 'i p t u s 
eudiòmetre	e w ð i 'ɔ m e t ɾ e	 ɛ w ð i 'ɔ m e t ɾ e 
eudiòmetres	e w ð i 'ɔ m e t ɾ e s	 ɛ w ð i 'ɔ m e t ɾ e s 
eufoni	e w f 'ɔ n i	 e w f 'o n i 
Eulàlia	e w l 'a l i a	 e u l 'a l i a 
euro	'e w ɾ o	 'ɛ w ɾ o 
europeu	e w ɾ o p 'e w	 e w ɾ o p 'ɛ w 
èuscar	'ɛ w s k a ɾ	 ɛ w s k 'a ɾ 
évol	'e v o l	 d v o l 
exabrupte	e g z a β ɾ 'u p t e	 e k s a β ɾ 'u p t e 
exemple	e g z 'e m p l e	 e g z 'ɛ m p l e 
exempt	e g z 'e m t	 e g z 'ɛ m p t 
exemptar	e g z e m t 'a ɾ	 e g z e m p t 'a ɾ 
exhaust	e g z 'a w s t	 e g z 'e w s t 
exili	e g z 'i l i	 e k s 'i l i 
exotòxic	e g z o t 'ɔ k s i k	 e k s o t 'ɔ k s i k 
expresses	e k s p ɾ 'e s e s	 e k s p ɾ 'ɛ s e s 
expressos	e k s p ɾ 'e s o s	 e k s p ɾ 'ɛ s o s 
extens	e k s t 'e n s	 e k s t 'ɛ n s 
extensa	e k s t 'e n s a	 e k s t 'ɛ n s a 
extenses	e k s t 'e n s e s	 e k s t 'ɛ n s e s 
extensos	e k s t 'e n s o s	 e k s t 'ɛ n s o s 
extra	'e k s t ɾ a	 'ɛ k s t ɾ a 
extremeny	e k s t ɾ e m 'e ɲ	 e k s t ɾ e m 'ɛ ɲ 
extremenya	e k s t ɾ e m 'e ɲ a	 e k s t ɾ e m 'ɛ ɲ a 
extreure	e k s t ɾ 'e w ɾ e	 e k s t ɾ 'ɛ w ɾ e 
Ezequiel	e z e k i 'ɛ l	 d z e k i 'ɛ l 
Fàbregas	f 'a β ɾ e ɣ a s	 f a β ɾ e ɣ 'a s 
fageda	f a d ʒ 'e ð a	 f a d ʒ 'ɛ ð a 
fagosoma	f a ɣ o z 'ɔ m a	 f a ɣ o z 'o m a 
fajol	f a d ʒ 'o l	 f a d ʒ 'ɔ l 
faltem	f a l t 'ɛ m	 f a l t 'e m 
fatxenda	f a t ʃ 'e n d a	 f a t ʃ 'ɛ n d a 
fe	f 'e	 f 'ɛ 
feble	f 'e β l e	 f 'ɛ β l e 
febles	f 'e β l e s	 f 'ɛ β l e s 
feblesa	f e β l 'e z a	 f e β l 'ɛ z a 
febre	f 'e β ɾ e	 f 'ɛ β ɾ e 
febres	f 'e β ɾ e s	 f 'ɛ β ɾ e s 
feina	f 'e j n a	 f 'ɛ j n a 
feinada	f e j n 'a ð a	 f e i n 'a ð a 
feiner	f e j n 'e ɾ	 f e i n 'e ɾ 
fen	f 'e n	 f 'ɛ n 
feren	f 'e ɾ e n	 f 'ɛ ɾ e n 
ferm	f 'e ɾ m	 f 'ɛ ɾ m 
ferma	f 'e ɾ m a	 f 'ɛ ɾ m a 
fermes	f 'e ɾ m e s	 f 'ɛ ɾ m e s 
ferms	f 'e ɾ m s	 f 'ɛ ɾ m s 
fes	f 'e s	 f 'ɛ s 
Fes	f 'e s	 f 'ɛ s 
fesol	f e z 'o l	 f e z 'ɔ l 
fessin	f 'e s i n	 f 'ɛ s i n 
fessis	f 'e s i s	 f 'ɛ s i s 
festa	f 'e s t a	 f 'ɛ s t a 
festes	f 'e s t e s	 f 'ɛ s t e s 
feu	f 'e w	 f 'ɛ w 
feus	f 'e w s	 f 'ɛ w s 
fillol	f i ʎ 'o l	 f i ʎ 'ɔ l 
fímbria	f 'i m b ɾ i a	 f i m b ɾ 'i a 
finestra	f i n 'e s t ɾ a	 f i n 'ɛ s t ɾ a 
finlandesa	f i n l a n d 'e z a	 f i n l a n d 'ɛ z a 
finlandesos	f i n l a n d 'e z o s	 f i n l a n d 'ɛ z o s 
flairada	f l a j ɾ 'a ð a	 f l a i ɾ 'a ð a 
flairades	f l a j ɾ 'a ð e s	 f l a i ɾ 'a ð e s 
flairar	f l a j ɾ 'a ɾ	 f l a i ɾ 'a ɾ 
flairat	f l a j ɾ 'a t	 f l a i ɾ 'a t 
flairats	f l a j ɾ 'a t s	 f l a i ɾ 'a t s 
fleca	f l 'e k a	 f l 'ɛ k a 
flegma	f l 'e g m a	 f l 'ɛ g m a 
fleques	f l 'e k e s	 f l 'ɛ k e s 
fletxa	f l 'e t ʃ a	 f l 'ɛ t ʃ a 
fletxes	f l 'e t ʃ e s	 f l 'ɛ t ʃ e s 
floricol	f l o ɾ i k 'o l	 f l o ɾ i k 'ɔ l 
floristeria	f l o ɾ i s t e ɾ 'i a	 f l 'ɔ ɾ 'i s t e ɾ 'i a 
fluid	f l w 'i t	 f l s 'i t 
fluir	f l w 'i ɾ	 f l u 'i ɾ 
fluixesa	f l u j ʃ 'e z a	 f l u j ʃ 'ɛ z a 
fluorescents	f l u o ɾ e s 'e n s	 f l u o ɾ e s 'e n t s 
folla	f 'o ʎ a	 f 'ɔ ʎ a 
folles	f 'o ʎ e s	 f 'ɔ ʎ e s 
fonda	f 'o n d a	 f 'ɔ n d a 
fondes	f 'o n d e s	 f 'ɔ n d e s 
fondo	f 'o n d o	 f 'ɔ n d o 
fondos	f 'o n d o s	 f 'ɔ n d o s 
fondre	f 'o n d ɾ e	 f 'ɔ n d ɾ e 
fonen	f 'o n e n	 f 'ɔ n e n 
fora	f 'ɔ ɾ a	 f 'o ɾ a 
forca	f 'o ɾ k a	 f 'ɔ ɾ k a 
foren	f 'o ɾ e n	 f 'ɔ ɾ e n 
forma	f 'o ɾ m a	 f 'ɔ ɾ m a 
formen	f 'o ɾ m e n	 f 'ɔ ɾ m e n 
formes	f 'o ɾ m e s	 f 'ɔ ɾ m e s 
formo	f 'o ɾ m o	 f 'ɔ ɾ m o 
forques	f 'o ɾ k e s	 f 'ɔ ɾ k e s 
fort	f 'ɔ ɾ t	 f 'o ɾ t 
fortalesa	f o ɾ t a l 'e z a	 f o ɾ t a l 'ɛ z a 
fosca	f 'o s k a	 f 'ɔ s k a 
foscos	f 'o s k o s	 f 'ɔ s k o s 
fosques	f 'o s k e s	 f 'ɔ s k e s 
foten	f 'o t e n	 f 'ɔ t e n 
fotesa	f o t 'e z a	 f o t 'ɛ z a 
foto	f 'o t o	 f 'ɔ t o 
fotoelèctrica	f o t o e l 'ɛ k t ɾ i k a	 f o t o e l e k t ɾ 'i k a 
fotoelèctrics	f o t o e l 'ɛ k t ɾ i k s	 f o t o e l e k t ɾ 'i k s 
fotos	f 'o t o s	 f 'ɔ t o s 
fotovoltaic	f o t o v o l t 'a j k	 f o t o v o l t 'a i k 
fotovoltaics	f o t o v o l t 'a j k s	 f o t o v o l t a 'i k s 
fotovoltaiques	f o t o v o l t 'a j k e s	 f o t o v o l t 'a i k e s 
fotre	f 'o t ɾ e	 f 'ɔ t ɾ e 
francesa	f ɾ a n s 'e z a	 f ɾ a n s 'ɛ z a 
Francesc	f ɾ a n s 'e s k	 f ɾ a n s 'ɛ s k 
franceses	f ɾ a n s 'e z e s	 f ɾ a n s 'ɛ z e s 
francesos	f ɾ a n s 'e z o s	 f ɾ a n s 'ɛ z o s 
franquesa	f ɾ a ŋ k 'e z a	 f ɾ a ŋ k 'ɛ z a 
fre	f ɾ 'e	 f ɾ 'ɛ 
frec	f ɾ 'e k	 f ɾ 'ɛ k 
freda	f ɾ 'e ð a	 f ɾ 'ɛ ð a 
fredes	f ɾ 'e ð e s	 f ɾ 'ɛ ð e s 
freds	f ɾ 'e t s	 f ɾ 'ɛ d s 
frega	f ɾ 'e ɣ a	 f ɾ 'ɛ ɣ a 
frego	f ɾ 'e ɣ o	 f ɾ 'ɛ ɣ o 
freguen	f ɾ 'e ɣ e n	 f ɾ 'ɛ ɣ e n 
fregues	f ɾ 'e ɣ e s	 f ɾ 'ɛ ɣ e s 
frenen	f ɾ 'e n e n	 f ɾ 'ɛ n e n 
freno	f ɾ 'e n o	 f ɾ 'ɛ n o 
frens	f ɾ 'e n s	 f ɾ 'ɛ n s 
freqüentar	f ɾ e k w e n t 'a ɾ	 f ɾ e k e n t 'a ɾ 
fresa	f ɾ 'e z a	 f ɾ 'ɛ z a 
fresc	f ɾ 'e s k	 f ɾ 'ɛ s k 
fresca	f ɾ 'e s k a	 f ɾ 'ɛ s k a 
frescos	f ɾ 'e s k o s	 f ɾ 'ɛ s k o s 
fresques	f ɾ 'e s k e s	 f ɾ 'ɛ s k e s 
fruit	f ɾ w 'i t	 f ɾ u 'i t 
fruita	f ɾ w 'i t a	 f ɾ d ʒ 'i t a 
fui	f w 'i	 f 'u i 
fuita	f w 'i t a	 f 'u j t a 
fumerol	f u m e ɾ 'o l	 f u m e ɾ 'ɔ l 
futbol	f u d b 'ɔ l	 f u t b 'ɔ l 
futbolí	f u d b o l 'i	 f u t b o l 'i 
futbolista	f u d b o l 'i s t a	 f u t b o l 'i s t a 
gai	g 'a j	 g 'a i 
gaita	g 'a j t a	 g a 'i t a 
gaiter	g a j t 'e ɾ	 g a i t 'e ɾ 
galilea	g a l i l 'ɛ a	 g a l i l 'e a 
Galileu	g a l i l 'e w	 g a l i l 'ɛ w 
gallec	g a ʎ 'e k	 g a ʎ 'ɛ k 
galleda	g a ʎ 'e ð a	 g a ʎ 'ɛ ð a 
gal·lesos	g a l 'e z o s	 g a l 'ɛ z o s 
ganyol	g a ɲ 'o l	 g a ɲ 'ɔ l 
gasela	g a z 'ɛ l a	 g a s 'ɛ l a 
gasoil	g a z 'ɔ j l	 g a z o 'i l 
gegantesc	d ʒ e ɣ a n t 'e s k	 d ʒ e ɣ a n t 'ɛ s k 
gemec	d ʒ e m 'e k	 d ʒ e m 'ɛ k 
gemma	d ʒ 'e m m a	 d ʒ 'ɛ m m a 
Gemma	d ʒ 'e m m a	 d ʒ 'ɛ m m a 
genovesa	d ʒ e n o v 'e z a	 d ʒ e n o v 'ɛ z a 
gens	d ʒ 'e n s	 d ʒ 'ɛ n s 
geocèntrics	d ʒ e o s 'ɛ n t ɾ i k s	 d ʒ e o s e n t ɾ 'i k s 
gespa	d ʒ 'e s p a	 g s p a 
gest	d ʒ 'e s t	 d ʒ 'ɛ s t 
gesta	d ʒ 'e s t a	 d ʒ 'ɛ s t a 
gestes	d ʒ 'e s t e s	 d ʒ 'ɛ s t e s 
gestos	d ʒ 'e s t o s	 d ʒ 'ɛ s t o s 
ginebra	d ʒ i n 'e β ɾ a	 d ʒ i n 'ɛ β ɾ a 
Ginebra	d ʒ i n 'e β ɾ a	 d ʒ i n 'ɛ β ɾ a 
ginesta	d ʒ i n 'e s t a	 d ʒ i n 'ɛ s t a 
glands	g l 'a n s	 g l 'a n d s 
glop	g l 'o p	 g l 'ɔ p 
glosa	g l 'ɔ z a	 g l 'o z a 
gloses	g l 'ɔ z e s	 g l 'o z e s 
golfa	g 'o l f a	 g 'ɔ l f a 
golfes	g 'o l f e s	 g 'ɔ l f e s 
gorg	g 'o ɾ k	 g 'ɔ ɾ i 
gossa	g 'o s a	 g 'ɔ s a 
gossos	g 'o s o s	 g 'ɔ s o s 
gota	g 'o t a	 g 'ɔ t a 
gotes	g 'o t e s	 g 'ɔ t e s 
granuloma	g ɾ a n u l 'ɔ m a	 g ɾ a n u l 'o m a 
grec	g ɾ 'e k	 g ɾ 'ɛ k 
grecs	g ɾ 'e k s	 g ɾ 'ɛ k s 
grega	g ɾ 'e ɣ a	 g ɾ 'ɛ ɣ a 
gregues	g ɾ 'e ɣ e s	 g ɾ 'ɛ ɣ e s 
gresca	g ɾ 'e s k a	 g ɾ 'ɛ s k a 
greu	g ɾ 'e w	 g ɾ 'ɛ w 
greuge	g ɾ 'e w d ʒ e	 g ɾ 'ɛ w d ʒ e 
greus	g ɾ 'e w s	 g ɾ 'ɛ w s 
grinyol	g ɾ i ɲ 'o l	 g ɾ i ɲ 'ɔ l 
gronxa	g ɾ 'o n t ʃ a	 g ɾ 'ɔ n t ʃ a 
grop	g ɾ 'o p	 g ɾ 'ɔ p 
grotesc	g ɾ o t 'e s k	 g ɾ o t 'ɛ s k 
guaita	g w 'a j t a	 g w a 'i t a 
guaitar	g w a j t 'a ɾ	 g w a i t 'a ɾ 
guaitat	g w a j t 'a t	 g w a i t 'a t 
guaito	g w 'a j t o	 g w a 'i t o 
guatlla	g w 'a l l a	 g w 'a t ʎ a 
guèiser	g 'ɛ j z e ɾ	 g 'ɛ i z e ɾ 
guinda	g 'i n d a	 g w 'i n d a 
guineu	g i n 'e w	 g i n 'ɛ w 
guisa	g 'i z a	 g u 'i z a 
Guissona	g i s 'ɔ n a	 g i s 'o n a 
guix	g 'i ʃ	 g 'i t ʃ 
hàbitat	'a β i t a t	 a β i t 'a t 
hàbitats	'a β i t a t s	 a β i t 'a t s 
hafni	'a f n i	 i 'a f n i 
hagi	'a d ʒ i	 'ɔ d ʒ i 
hàgim	'a d ʒ i m	 'ɔ d ʒ i m 
hàgiu	'a d ʒ i w	 'ɔ d ʒ i w 
Haia	'a j a	 a 'i a 
Hainan	a j n 'a n	 a i n 'a n 
Hainaut	a j n 'a w t	 a i n a 'u t 
Haití	a j t 'i	 a i t 'i 
haixix	a j ʃ 'i ʃ	 a j ʃ 'i k s 
hamburguesa	a m b u ɾ ɣ 'e z a	 a m b u ɾ ɣ u 'ɛ z a 
he	'e	 'ɛ 
hebraic	e β ɾ 'a j k	 e β ɾ 'a i k 
hebreu	e β ɾ 'e w	 e β ɾ 'ɛ w 
Hèlios	'ɛ l i o s	 'ɔ l i o s 
hemeroteca	e m e ɾ o t 'e k a	 e m e ɾ o t 'ɛ k a 
hèrnia	'ɛ ɾ n i a	 s 'ɛ ɾ n i a 
heroi	e ɾ 'ɔ j	 e ɾ 'o i 
heroic	e ɾ 'ɔ j k	 e ɾ o 'i k 
hèrptil	'ɛ ɾ p t i l	 ɛ ɾ p t 'i l 
heu	'e w	 'ɛ w 
heure	'e w ɾ e	 a 'u ɾ e 
heus	'e w s	 'ɛ w s 
hevea	e v 'ɛ a	 e v 'e a 
hexagonal	e g z a ɣ o n 'a l	 e k s a ɣ o n 'a l 
hexé	e g z 'e	 e t ʃ 'e 
hi	'i	 i 
híbrid	'i β ɾ i t	 i β ɾ i t 
hidroelèctrica	i ð ɾ o e l 'ɛ k t ɾ i k a	 i ð ɾ o e l e k t ɾ 'i k a 
hidroelèctrics	i ð ɾ o e l 'ɛ k t ɾ i k s	 i ð ɾ o e l e k t ɾ 'i k s 
hieràtic	j e ɾ 'a t i k	 i e ɾ 'a t i k 
hieràtics	j e ɾ 'a t i k s	 i e ɾ 'a t i k s 
himne	'i m n e	 u 'i m n e 
hindi	'i n d i	 i n d i 
hinduisme	i n d w 'i z m e	 i n d u 'i z m e 
hiperespai	i p e ɾ e s p 'a j	 i p e ɾ e s p 'a i 
hiperespais	i p e ɾ e s p 'a j s	 i p e ɾ e s p 'a i s 
hipnosi	i b n 'ɔ z i	 i p n 'ɔ z i 
hipnòtic	i b n 'ɔ t i k	 i p n 'ɔ t i k 
hipnotisme	i b n o t 'i z m e	 i p n o t 'i z m e 
hipoteca	i p o t 'e k a	 i p o t 'ɛ k a 
holandesa	o l a n d 'e z a	 o l a n d 'ɛ z a 
holmi	'ɔ l m i	 u l m i 
hon	'o n	 'a n 
hondureny	o n d u ɾ 'e ɲ	 o n d u ɾ 'ɛ ɲ 
honest	o n 'e s t	 o n 'ɛ s t 
hongaresos	o ŋ g a ɾ 'e z o s	 o ŋ g a ɾ 'ɛ z o s 
hoquei	o k 'e j	 o k 'ɛ i 
hora	'ɔ ɾ a	 a ɾ a 
hores	'ɔ ɾ e s	 i 'o ɾ e s 
hòrrid	'ɔ r i t	 i r i t 
hort	'ɔ ɾ t	 i 'o ɾ t 
horta	'ɔ ɾ t a	 i ɾ t a 
hostes	'ɔ s t e s	 i s t e s 
hòstia	'ɔ s t i a	 i s t i a 
hòsties	'ɔ s t i e s	 i s t i e s 
húmer	'u m e ɾ	 a m e ɾ 
humus	'u m u s	 a m u s 
i	'i	 i 
iaia	j 'a j a	 i 'a j a 
iaies	j 'a j e s	 i a 'i e s 
iaio	j 'a j o	 i 'a j o 
iarda	j 'a ɾ ð a	 i 'a ɾ ð a 
ictus	'i k t u s	 i k t 'u s 
iemenita	j e m e n 'i t a	 i e m e n 'i t a 
immens	i m m 'e n s	 i m m 'ɛ n s 
ímpetu	'i m p e t u	 i m p e t 'u 
imposes	i m p 'ɔ z e s	 i m p 'o z e s 
impremta	i m p ɾ 'e m t a	 i m p ɾ 'ɛ m t a 
impresa	i m p ɾ 'e z a	 i m p ɾ 'ɛ z a 
impreses	i m p ɾ 'e z e s	 i m p ɾ 'ɛ z e s 
impresos	i m p ɾ 'e z o s	 i m p ɾ 'ɛ z o s 
impuresa	i m p u ɾ 'e z a	 i m p u ɾ 'ɛ z a 
induir	i n d w 'i ɾ	 i n d u 'i ɾ 
indústria	i n d 'u s t ɾ i a	 i n d u s t ɾ 'i a 
inhòspit	i n 'ɔ s p i t	 i n 'e s p i t 
ininterromput	i n i n t e r o m p 'u t	 i n 'i n t e r 'o m p 'u t 
insensatesa	i n s e n s a t 'e z a	 i n s e n s a t 'ɛ z a 
insolents	i n s o l 'e n s	 i n s o l 'e n t s 
instruir	i n s t ɾ w 'i ɾ	 i n s t ɾ u 'i ɾ 
insulinoma	i n s u l i n 'ɔ m a	 i n s u l i n 'o m a 
insultem	i n s u l t 'ɛ m	 i n s u l t 'e m 
insurgents	i n s u ɾ d ʒ 'e n s	 i n s u ɾ d ʒ 'e n t s 
intens	i n t 'e n s	 i n t 'ɛ n s 
intèrpret	i n t 'ɛ ɾ p ɾ e t	 i n t e ɾ p ɾ 'e t 
interrompre	i n t e r 'o m p ɾ e	 i n t e r 'ɔ m p ɾ e 
introduir	i n t ɾ o ð w 'i ɾ	 i n t ɾ o ð u 'i ɾ 
iogui	j 'ɔ ɣ i	 i 'ɔ ɣ i 
iogurt	j o ɣ 'u ɾ t	 i o ɣ 'u ɾ t 
iònica	j 'ɔ n i k a	 i 'ɔ n i k a 
ípsilon	'i p s i l o n	 i p s i l 'o n 
irlandesa	i ɾ l a n d 'e z a	 i ɾ l a n d 'ɛ z a 
irlandeses	i ɾ l a n d 'e z e s	 i ɾ l a n d 'ɛ z e s 
irlandesos	i ɾ l a n d 'e z o s	 i ɾ l a n d 'ɛ z o s 
irremeiable	i r e m e j 'a β l e	 i r e m e i 'a β l e 
islandesos	i z l a n d 'e z o s	 i z l a n d 'ɛ z o s 
istme	'i s m e	 'i s t m e 
Ístria	'i s t ɾ i a	 i s t ɾ 'i a 
iugoslau	j u ɣ o z l 'a w	 i w ɣ o z l 'a w 
Iugoslàvia	j u ɣ o z l 'a v i a	 i w ɣ o z l 'a v i a 
ix	'i ʃ	 'i k s 
ja	j 'a	 d ʒ 'a 
japonesos	d ʒ a p o n 'e z o s	 d ʒ a p o n 'ɛ z o s 
jazz	d ʒ 'a s	 d ʒ 'a z i 
jersei	d ʒ e ɾ s 'e j	 d ʒ e ɾ s 'ɛ i 
jeu	d ʒ 'e w	 d ʒ 'ɛ w 
jeure	d ʒ 'e w ɾ e	 d ʒ 'ɛ w ɾ e 
jove	d ʒ 'o v e	 d ʒ 'ɔ v e 
jóvens	d ʒ 'o v e n s	 d ʒ o v 'e n s 
joves	d ʒ 'o v e s	 d ʒ 'ɔ v e s 
jueu	d ʒ u 'e w	 d ʒ u 'ɛ w 
junts	d ʒ 'u n s	 d ʒ 'u n t s 
justesa	d ʒ u s t 'e z a	 d ʒ u s t 'ɛ z a 
kafkià	k a f k i 'a	 k a f i i 'a 
Kenya	k 'e ɲ a	 k 'ɛ ɲ a 
kenyà	k e ɲ 'a	 d ʒ e ɲ 'a 
kenyana	k e ɲ 'a n a	 d ʒ e ɲ 'a n a 
khmer	k m 'e ɾ	 k a 'e ɾ 
kilocaloria	k i l o k a l o ɾ 'i a	 s i l o k a l o ɾ 'i a 
kilòmetre	k i l 'ɔ m e t ɾ e	 i i l 'ɔ m e t ɾ e 
Kirguizistan	k i ɾ ɣ i z i s t 'a n	 s i ɾ ɣ i z i s t 'a n 
la	l 'a	 l a 
laberints	l a β e ɾ 'i n s	 l a β e ɾ 'i n t s 
lacrosse	l a k ɾ 'o s e	 l a k ɾ 'ɔ s e 
lemes	l 'e m e s	 l 'ɛ m e s 
lepra	l 'e p ɾ a	 l 'ɛ p ɾ a 
les	l 'e s	 l e s 
lesa	l 'e z a	 l 'ɛ z a 
leu	l 'e w	 l 'ɛ w 
li	l 'i	 l i 
Líban	l 'i β a n	 l i β 'a n 
liceu	l i s 'e w	 l i s 'ɛ w 
Liceu	l i s 'e w	 l i s 'ɛ w 
lígur	l 'i ɣ u ɾ	 l i ɣ 'u ɾ 
lingot	l i ŋ g 'o t	 l i ŋ g 'ɔ t 
liqüeféu	l i k w e f 'e w	 l i k e f 'e w 
lisosoma	l i z o z 'ɔ m a	 l i z o z 'o m a 
llampec	ʎ a m p 'e k	 ʎ a m p 'ɛ k 
llargs	ʎ 'a ɾ k s	 ʎ 'a ɾ i s 
llauna	ʎ 'a w n a	 ʎ a 'u n a 
llebre	ʎ 'e β ɾ e	 ʎ 'ɛ β ɾ e 
llega	ʎ 'e ɣ a	 ʎ 'ɛ ɣ a 
llegenda	ʎ e d ʒ 'e n d a	 ʎ e d ʒ 'ɛ n d a 
llegendes	ʎ e d ʒ 'e n d e s	 ʎ e d ʒ 'ɛ n d e s 
llei	ʎ 'e j	 ʎ 'ɛ i 
Lleida	ʎ 'e j ð a	 ʎ e 'i ð a 
lleis	ʎ 'e j s	 ʎ 'ɛ i s 
lleixa	ʎ 'e j ʃ a	 ʎ 'ɛ j ʃ a 
llencen	ʎ 'e n s e n	 ʎ 'ɛ n s e n 
llenço	ʎ 'e n s o	 ʎ 'ɛ n s o 
llenços	ʎ 'e n s o s	 ʎ 'ɛ n s o s 
llenya	ʎ 'e ɲ a	 ʎ 'ɛ ɲ a 
llepa	ʎ 'e p a	 ʎ 'ɛ p a 
llepen	ʎ 'e p e n	 ʎ 'ɛ p e n 
llépol	ʎ 'e p o l	 ʎ e p 'ɔ l 
llesques	ʎ 'e s k e s	 ʎ 'ɛ s k e s 
llest	ʎ 'e s t	 ʎ 'ɛ s t 
llesta	ʎ 'e s t a	 ʎ 'ɛ s t a 
llestes	ʎ 'e s t e s	 ʎ 'ɛ s t e s 
llestos	ʎ 'e s t o s	 ʎ 'ɛ s t o s 
lletra	ʎ 'e t ɾ a	 ʎ 'ɛ t ɾ a 
lletres	ʎ 'e t ɾ e s	 ʎ 'ɛ t ɾ e s 
lleu	ʎ 'e w	 ʎ 'ɛ w 
lleure	ʎ 'e w ɾ e	 ʎ 'ɛ w ɾ e 
lleus	ʎ 'e w s	 ʎ 'ɛ w s 
lleva	ʎ 'e v a	 ʎ 'ɛ v a 
lleves	ʎ 'e v e s	 ʎ 'ɛ v e s 
llevo	ʎ 'e v o	 ʎ 'ɛ v o 
lloa	ʎ 'o a	 ʎ 'ɔ a 
lloba	ʎ 'o β a	 ʎ 'ɔ β a 
lloen	ʎ 'o e n	 ʎ 'ɔ e n 
llop	ʎ 'o p	 ʎ 'ɔ p 
Llorach	ʎ o ɾ 'a k	 ʎ o ɾ 'a s i 
lloro	ʎ 'o ɾ o	 ʎ 'ɔ ɾ o 
lloros	ʎ 'o ɾ o s	 ʎ 'ɔ ɾ o s 
lluir	ʎ w 'i ɾ	 ʎ u 'i ɾ 
lluita	ʎ w 'i t a	 ʎ u 'i t a 
Londres	l 'o n d ɾ e s	 l 'ɔ n d ɾ e s 
luxemburguesa	l u k s e m b u ɾ ɣ 'e z a	 l u k s e m b u ɾ ɣ u 'ɛ z a 
ma	m 'a	 m a 
macedoni	m a s e ð 'ɔ n i	 m a s e ð 'o n i 
madrileny	m a ð ɾ i l 'e ɲ	 m a ð ɾ i l 'ɛ ɲ 
madrilenya	m a ð ɾ i l 'e ɲ a	 m a ð ɾ i l 'ɛ ɲ a 
madrilenyes	m a ð ɾ i l 'e ɲ e s	 m a ð ɾ i l 'ɛ ɲ e s 
madrilenys	m a ð ɾ i l 'e ɲ s	 m a ð ɾ i l 'ɛ ɲ s 
maduixer	m a ð u j ʃ 'e ɾ	 m a ð u i ʃ 'e ɾ 
maduresa	m a ð u ɾ 'e z a	 m a ð u ɾ 'ɛ z a 
Mahoma	m a 'ɔ m a	 m a m m a 
mainada	m a j n 'a ð a	 m a i n 'a ð a 
malai	m a l 'a j	 m a l 'a i 
malais	m a l 'a j s	 m a l 'a i s 
Malàisia	m a l 'a j z i a	 m a l 'a i z i a 
mallol	m a ʎ 'o l	 m a ʎ 'ɔ l 
manifest	m a n i f 'e s t	 m a n i f 'ɛ s t 
manlleu	m a n ʎ 'e w	 m a n ʎ 'ɛ w 
manlleus	m a n ʎ 'e w s	 m a n ʎ 'ɛ w s 
mantingueu	m a n t i ŋ g 'e w	 m a n t i ŋ g 'ɛ w 
manxec	m a n t ʃ 'e k	 m a n t ʃ 'ɛ k 
manxiula	m a n t ʃ 'i w l a	 m a n t ʃ i 'u l a 
maresme	m a ɾ 'e z m e	 m a ɾ 'ɛ z m e 
marquesa	m a ɾ k 'e z a	 m a ɾ k 'ɛ z a 
màrqueting	m 'a ɾ k e t i ŋ k	 m a ɾ k e t 'i ŋ k 
marrec	m a r 'e k	 m a r 'ɛ k 
matallops	m a t a ʎ 'o p s	 m a t a ʎ 'ɔ p s 
Mateu	m a t 'e w	 m a t 'ɛ w 
mausoleu	m a w z o l 'e w	 m a w z o l 'ɛ w 
me	m 'e	 m e 
meca	m 'e k a	 m 'ɛ k a 
Meca	m 'e k a	 m 'ɛ k a 
meitat	m e j t 'a t	 m e i t 'a t 
membre	m 'e m b ɾ e	 m 'ɛ m b ɾ e 
membres	m 'e m b ɾ e s	 m 'ɛ m b ɾ e s 
menen	m 'e n e n	 m 'ɛ n e n 
mengen	m 'e n d ʒ e n	 m 'ɛ n d ʒ e n 
menges	m 'e n d ʒ e s	 m 'ɛ n d ʒ e s 
menja	m 'e n d ʒ a	 m 'ɛ n d ʒ a 
menjo	m 'e n d ʒ o	 m 'ɛ n d ʒ o 
mentre	m 'e n t ɾ e	 m 'ɛ n t ɾ e 
menys	m 'e ɲ s	 m 'ɛ ɲ s 
mero	m 'e ɾ o	 m 'ɛ ɾ o 
mes	m 'e s	 m 'ɛ s 
mesa	m 'e z a	 m 'ɛ z a 
mescla	m 'e s k l a	 m 'ɛ s k l a 
mesclen	m 'e s k l e n	 m 'ɛ s k l e n 
mescles	m 'e s k l e s	 m 'ɛ s k l e s 
meses	m 'e z e s	 m 'ɛ z e s 
mesos	m 'e z o s	 m 'ɛ z o s 
mestra	m 'e s t ɾ a	 m 'ɛ s t ɾ a 
mestre	m 'e s t ɾ e	 m 'ɛ s t ɾ e 
mestres	m 'e s t ɾ e s	 m 'ɛ s t ɾ e s 
metem	m e t 'ɛ m	 m e t 'e m 
metre	m 'e t ɾ e	 m 'ɛ t ɾ e 
metres	m 'e t ɾ e s	 m 'ɛ t ɾ e s 
metro	m 'e t ɾ o	 m 'ɛ t ɾ o 
metxa	m 'e t ʃ a	 m 'ɛ t ʃ a 
meu	m 'e w	 m 'ɛ w 
meua	m 'e w a	 m 'ɛ w a 
meus	m 'e w s	 m 'ɛ w s 
meva	m 'e v a	 m 'ɛ v a 
meves	m 'e v e s	 m 'ɛ v e s 
mig	m 'i t ʃ	 m 'i k 
migcampista	m i k k a m p 'i s t a	 m i ɣ k a m p 'i s t a 
milanesa	m i l a n 'e z a	 m i l a n 'ɛ z a 
miop	m i 'o p	 m i 'ɔ p 
misàndria	m i z 'a n d ɾ i a	 m i z a n d ɾ 'i a 
mix	m 'i ʃ	 m 'i k s 
mocs	m 'o k s	 m 'ɔ k s 
modest	m o ð 'e s t	 m o ð 'ɛ s t 
mogol	m o ɣ 'o l	 m o ɣ 'ɔ l 
moher	m o 'ɛ ɾ	 m o 'e ɾ 
molsa	m 'o l s a	 m 'ɔ l s a 
molts	m 'o l s	 m 'o l t s 
mòlts	m 'ɔ l s	 m 'ɔ l t s 
monàrquica	m o n 'a ɾ k i k a	 m o n a ɾ k 'i k a 
monàrquics	m o n 'a ɾ k i k s	 m o n a ɾ k 'i k s 
moneda	m o n 'e ð a	 m o n 'ɛ ð a 
monocroma	m o n o k ɾ 'ɔ m a	 m o n o k ɾ 'o m a 
monocromes	m o n o k ɾ 'ɔ m e s	 m o n o k ɾ 'o m e s 
monologuista	m o n o l o ɣ 'i s t a	 m o n o l o ɣ u 'i s t a 
Montse	m 'o n s e	 m 'ɔ n d z e 
Montseny	m o n s 'e ɲ	 m o n s 'ɛ ɲ 
morro	m 'o r o	 m 'ɔ r o 
morros	m 'o r o s	 m 'ɔ r o s 
mort	m 'ɔ ɾ t	 m 'o ɾ t 
mosaic	m o z 'a j k	 m o z 'a i k 
mosca	m 'o s k a	 m 'ɔ s k a 
mosques	m 'o s k e s	 m 'ɔ s k e s 
mossàrab	m o s 'a ɾ a p	 m o s 'a ɾ a β 
mossega	m o s 'e ɣ a	 m o s 'ɛ ɣ a 
mossegaire	m o s e ɣ 'a j ɾ e	 m o s e ɣ a 'i ɾ e 
mosso	m 'o s o	 m 'ɔ s o 
mossos	m 'o s o s	 m 'ɔ s o s 
mot	m 'o t	 m 'ɔ t 
motllura	m o l l 'u ɾ a	 m o ʎ l 'u ɾ a 
motllurada	m o l l u ɾ 'a ð a	 m o l ʎ u ɾ 'a ð a 
motllurades	m o l l u ɾ 'a ð e s	 m o l ʎ u ɾ 'a ð e s 
motllurar	m o l l u ɾ 'a ɾ	 m o l ʎ u ɾ 'a ɾ 
motllurat	m o l l u ɾ 'a t	 m o l ʎ u ɾ 'a t 
motllurats	m o l l u ɾ 'a t s	 m o l ʎ u ɾ 'a t s 
moto	m 'o t o	 m 'ɔ t o 
motos	m 'o t o s	 m 'ɔ t o s 
motoserra	m o t o z 'ɛ r a	 m o t o s 'ɛ r a 
mou	m 'ɔ w	 m 'o w 
mous	m 'ɔ w s	 m o 'u s 
mudèjar	m u ð 'ɛ d ʒ a ɾ	 m u ð e d ʒ 'a ɾ 
mujol	m u d ʒ 'o l	 m u d ʒ 'ɔ l 
multivers	m u l t i v 'ɛ ɾ s	 m u l t i v 'e ɾ s 
museu	m u z 'e w	 m u z 'ɛ w 
nadius	n a ð 'i w s	 n a ð i 'u s 
nahua	n a 'u a	 n a j a 
naturalesa	n a t u ɾ a l 'e z a	 n a t u ɾ a l 'ɛ z a 
nàufrag	n 'a w f ɾ a k	 n a w f ɾ 'a k 
navarresa	n a v a r 'e z a	 n a v a r 'ɛ z a 
navarreses	n a v a r 'e z e s	 n a v a r 'ɛ z e s 
navarresos	n a v a r 'e z o s	 n a v a r 'ɛ z o s 
neboda	n e β 'o ð a	 n e β 'ɔ ð a 
nebot	n e β 'o t	 n e β 'ɔ t 
neda	n 'e ð a	 n 'ɛ ð a 
neden	n 'e ð e n	 n 'ɛ ð e n 
nedes	n 'e ð e s	 n 'ɛ ð e s 
neerlandesa	n e e ɾ l a n d 'e z a	 n e e ɾ l a n d 'ɛ z a 
nega	n 'e ɣ a	 n 'ɛ ɣ a 
nego	n 'e ɣ o	 n 'ɛ ɣ o 
negra	n 'e ɣ ɾ a	 n 'ɛ ɣ ɾ a 
negre	n 'e ɣ ɾ e	 n 'ɛ ɣ ɾ e 
negres	n 'e ɣ ɾ e s	 n 'ɛ ɣ ɾ e s 
neguen	n 'e ɣ e n	 n 'ɛ ɣ e n 
negues	n 'e ɣ e s	 n 'ɛ ɣ e s 
nen	n 'e n	 n 'ɛ n 
nens	n 'e n s	 n 'ɛ n s 
nepalesa	n e p a l 'e z a	 n e p a l 'ɛ z a 
nepaleses	n e p a l 'e z e s	 n e p a l 'ɛ z e s 
nepalesos	n e p a l 'e z o s	 n e p a l 'ɛ z o s 
neu	n 'e w	 n 'ɛ w 
neulir	n e w l 'i ɾ	 n e u l 'i ɾ 
neus	n 'e w s	 n 'ɛ w s 
neva	n 'e v a	 n 'ɛ v a 
niciesa	n i s i 'e z a	 n i s i 'ɛ z a 
noblesa	n o β l 'e z a	 n o β l 'ɛ z a 
noi	n 'ɔ j	 n 'o i 
nois	n 'ɔ j s	 n 'o i s 
nombre	n 'o m b ɾ e	 n 'ɔ m b ɾ e 
nombres	n 'o m b ɾ e s	 n 'ɔ m b ɾ e s 
Nombres	n 'o m b ɾ e s	 n 'ɔ m b ɾ e s 
nord	n 'ɔ ɾ t	 n 'o ɾ t 
nores	n 'ɔ ɾ e s	 n 'o ɾ e s 
norma	n 'o ɾ m a	 n 'ɔ ɾ m a 
normes	n 'o ɾ m e s	 n 'ɔ ɾ m e s 
noruec	n o ɾ u 'e k	 n o ɾ u 'ɛ k 
Noruega	n o ɾ u 'e ɣ a	 n o ɾ u 'ɛ ɣ a 
nou	n 'ɔ w	 n 'o w 
noucasat	n o w k a z 'a t	 n o u k a z 'a t 
nous	n 'ɔ w s	 n o 'u s 
novembre	n o v 'e m b ɾ e	 n o v 'ɛ m b ɾ e 
noya	n 'ɔ j a	 n 'ɔ a 
noyes	n 'ɔ j e s	 n 'ɔ e s 
nuesa	n u 'e z a	 n u 'ɛ z a 
oasi	o 'a z i	 o 'a s i 
obrellaunes	o β ɾ e ʎ 'a w n e s	 o β ɾ e ʎ a 'u n e s 
obscenes	o p s 'e n e s	 o p s k 'e n e s 
obscens	o p s 'e n s	 o p s k 'ɛ n s 
octubre	o k t 'u β ɾ e	 ɔ k t 'u β ɾ e 
oest	o 'e s t	 o 'ɛ s t 
ofec	o f 'e k	 o f 'ɛ k 
ofega	o f 'e ɣ a	 o f 'ɛ ɣ a 
ofendre	o f 'e n d ɾ e	 o f 'ɛ n d ɾ e 
oi	'ɔ j	 'o i 
olíban	o l 'i β a n	 o l i β 'a n 
oligàrquica	o l i ɣ 'a ɾ k i k a	 o l i ɣ a ɾ k 'i k a 
oligàrquics	o l i ɣ 'a ɾ k i k s	 o l i ɣ a ɾ k 'i k s 
ombra	'o m b ɾ a	 'ɔ m b ɾ a 
ombres	'o m b ɾ e s	 'ɔ m b ɾ e s 
omega	o m 'e ɣ a	 o m 'ɛ ɣ a 
ometre	o m 'e t ɾ e	 o m 'ɛ t ɾ e 
òmicron	'ɔ m i k ɾ o n	 ɔ m i k ɾ 'o n 
omple	'o m p l e	 'ɔ m p l e 
omplen	'o m p l e n	 'ɔ m p l e n 
omples	'o m p l e s	 'ɔ m p l e s 
omplo	'o m p l o	 'ɔ m p l o 
oncle	'o ŋ k l e	 'ɔ ŋ k l e 
oncles	'o ŋ k l e s	 'ɔ ŋ k l e s 
onomatopeia	o n o m a t o p 'e j a	 o n o m a t o p e 'i a 
onzes	'o n z e s	 'ɔ n z e s 
opta	'o p t a	 'ɔ p t a 
opten	'o p t e n	 'ɔ p t e n 
opto	'o p t o	 'ɔ p t o 
orca	'o ɾ k a	 'ɔ ɾ k a 
orde	'o ɾ ð e	 'ɔ ɾ ð e 
ordeno	o ɾ ð 'e n o	 o ɾ ð 'ɛ n o 
ordes	'o ɾ ð e s	 'ɔ ɾ ð e s 
ordre	'o ɾ ð ɾ e	 'ɔ ɾ ð ɾ e 
ordres	'o ɾ ð ɾ e s	 'ɔ ɾ ð ɾ e s 
ores	'ɔ ɾ e s	 'o ɾ e s 
orgull	o ɾ ɣ 'u ʎ	 ɔ ɾ ɣ 'u ʎ 
ornament	o ɾ n a m 'e n t	 ɔ ɾ n a m 'e n t 
oro	'o ɾ o	 'ɔ ɾ o 
orques	'o ɾ k e s	 'ɔ ɾ k e s 
orquestra	o ɾ k 'e s t ɾ a	 o ɾ k 'ɛ s t ɾ a 
ortodoxa	o ɾ t o ð 'o k s a	 o ɾ t o ð 'ɔ k s a 
ossos	'o s o s	 'ɔ s o s 
osteosarcoma	o s t e o z a ɾ k 'ɔ m a	 o s t e o z a ɾ k 'o m a 
òstria	'ɔ s t ɾ i a	 ɔ s t ɾ 'i a 
ou	'ɔ w	 'o w 
ous	'ɔ w s	 o 'u s 
oxímoron	o k s 'i m o ɾ o n	 o k s i m o ɾ 'o n 
paiol	p a j 'o l	 p a j 'ɔ l 
pairal	p a j ɾ 'a l	 p a i ɾ 'a l 
pakistanesa	p a k i s t a n 'e z a	 p a z i s t a n 'ɛ z a 
pakistaneses	p a k i s t a n 'e z e s	 p a z i s t a n 'ɛ z e s 
pakistanesos	p a k i s t a n 'e z o s	 p a z i s t a n 'ɛ z o s 
pallol	p a ʎ 'o l	 p a ʎ 'ɔ l 
pamperol	p a m p e ɾ 'o l	 p a m p e ɾ 'ɔ l 
panameny	p a n a m 'e ɲ	 p a n a m 'ɛ ɲ 
pandemoni	p a n d e m 'ɔ n i	 p a n d e m 'o n i 
papagai	p a p a ɣ 'a j	 p a p a ɣ 'a i 
papil·loma	p a p i l 'ɔ m a	 p a p i l 'o m a 
paranoic	p a ɾ a n 'ɔ j k	 p a ɾ a n o 'i k 
paranoide	p a ɾ a n 'ɔ j ð e	 p a ɾ a n o 'i ð e 
paraula	p a ɾ 'a w l a	 p a ɾ a 'u l a 
parènquima	p a ɾ 'ɛ ŋ k i m a	 p a ɾ e ŋ k 'i m a 
parlessin	p a ɾ l 'e s i n	 p a ɾ l 'ɛ s i n 
parleu	p a ɾ l 'e w	 p a ɾ l 'ɛ w 
parlotaire	p a ɾ l o t 'a j ɾ e	 p a ɾ l o t a 'i ɾ e 
pàrquing	p 'a ɾ k i ŋ k	 p a ɾ k 'i ŋ k 
patracol	p a t ɾ a k 'o l	 p a t ɾ a k 'ɔ l 
patrimoni	p a t ɾ i m 'ɔ n i	 p a t ɾ i m 'o n i 
pebre	p 'e β ɾ e	 p 'ɛ β ɾ e 
peca	p 'e k a	 p 'ɛ k a 
pedra	p 'e ð ɾ a	 p 'ɛ ð ɾ a 
pedres	p 'e ð ɾ e s	 p 'ɛ ð ɾ e s 
pega	p 'e ɣ a	 p 'ɛ ɣ a 
pego	p 'e ɣ o	 p 'ɛ ɣ o 
peguen	p 'e ɣ e n	 p 'ɛ ɣ e n 
pegues	p 'e ɣ e s	 p 'ɛ ɣ e s 
peixos	p 'e j ʃ o s	 p 'ɛ j ʃ o s 
pèlag	p 'ɛ l a k	 p e l 'a k 
pendeloc	p e n d e l 'o k	 p e n d e l 'ɔ k 
penetra	p e n 'e t ɾ a	 p e n 'ɛ t ɾ a 
pengen	p 'e n d ʒ e n	 p 'ɛ n d ʒ e n 
penges	p 'e n d ʒ e s	 p 'ɛ n d ʒ e s 
penja	p 'e n d ʒ a	 p 'ɛ n d ʒ a 
penjo	p 'e n d ʒ o	 p 'ɛ n d ʒ o 
penombra	p e n 'o m b ɾ a	 p e n 'ɔ m b ɾ a 
pensa	p 'e n s a	 p 'ɛ n s a 
pensen	p 'e n s e n	 p 'ɛ n s e n 
penses	p 'e n s e s	 p 'ɛ n s e s 
penso	p 'e n s o	 p 'ɛ n s o 
penya	p 'e ɲ a	 p 'ɛ ɲ a 
penyes	p 'e ɲ e s	 p 'ɛ ɲ e s 
pequem	p e k 'ɛ m	 p e k 'e m 
pequen	p 'e k e n	 p 'ɛ k e n 
pequinesos	p e k i n 'e z o s	 p e k i n 'ɛ z o s 
per	p 'e ɾ	 p e ɾ 
Pere	p 'e ɾ e	 p 'ɛ ɾ e 
perenne	p e ɾ 'e n n e	 p e ɾ 'ɛ n n e 
peresa	p e ɾ 'e z a	 p e ɾ 'ɛ z a 
permesa	p e ɾ m 'e z a	 p e ɾ m 'ɛ z a 
permeses	p e ɾ m 'e z e s	 p e ɾ m 'ɛ z e s 
permesos	p e ɾ m 'e z o s	 p e ɾ m 'ɛ z o s 
permetre	p e ɾ m 'e t ɾ e	 p e ɾ m 'ɛ t ɾ e 
perseguida	p e ɾ s e ɣ 'i ð a	 p e ɾ s e ɣ u 'i ð a 
perseguides	p e ɾ s e ɣ 'i ð e s	 p e ɾ s e ɣ u 'i ð e s 
persuasiu	p e ɾ s u a z 'i w	 p e ɾ s u a s 'i w 
pervers	p e ɾ v 'ɛ ɾ s	 p e ɾ v 'e ɾ s 
pes	p 'e s	 p 'ɛ s 
pesa	p 'e z a	 p 'ɛ z a 
pesca	p 'e s k a	 p 'ɛ s k a 
pesco	p 'e s k o	 p 'ɛ s k o 
pesen	p 'e z e n	 p 'ɛ z e n 
peses	p 'e z e s	 p 'ɛ z e s 
peso	p 'e z o	 p 'ɛ z o 
pesos	p 'e z o s	 p 'ɛ z o s 
pesquen	p 'e s k e n	 p 'ɛ s k e n 
pessebre	p e s 'e β ɾ e	 p e s 'ɛ β ɾ e 
pessigolles	p e s i ɣ 'o ʎ e s	 p e s i ɣ 'ɔ ʎ e s 
pesta	p 'e s t a	 p 'ɛ s t a 
petitesa	p e t i t 'e z a	 p e t i t 'ɛ z a 
peto	p 'e t o	 p 'ɛ t o 
picarol	p i k a ɾ 'o l	 p i k a ɾ 'ɔ l 
pícnic	p 'i g n i k	 p 'i k n i k 
piemontesa	p i e m o n t 'e z a	 p i e m o n t 'ɛ z a 
piemontesos	p i e m o n t 'e z o s	 p i e m o n t 'ɛ z o s 
pigarg	p i ɣ 'a ɾ k	 p i ɣ 'a ɾ i 
pigmeu	p i g m 'e w	 p i g m 'ɛ w 
pinacoteca	p i n a k o t 'e k a	 p i n a k o t 'ɛ k a 
pineda	p i n 'e ð a	 p i n 'ɛ ð a 
piquem	p i k 'ɛ m	 p i k 'e m 
Pirineu	p i ɾ i n 'e w	 p i ɾ i n 'ɛ w 
Pirineus	p i ɾ i n 'e w s	 p i ɾ i n 'ɛ w s 
piulada	p i w l 'a ð a	 p i u l 'a ð a 
piular	p i w l 'a ɾ	 p i u l 'a ɾ 
pixa	p 'i ʃ a	 p 'i k s a 
plàncton	p l 'a ŋ k t o n	 p l a ŋ k t 'o n 
plataforma	p l a t a f 'o ɾ m a	 p l a t a f 'ɔ ɾ m a 
ple	p l 'e	 p l 'ɛ 
plebeu	p l e β 'e w	 p l e β 'ɛ w 
plec	p l 'e k	 p l 'ɛ k 
plega	p l 'e ɣ a	 p l 'ɛ ɣ a 
plego	p l 'e ɣ o	 p l 'ɛ ɣ o 
pleguen	p l 'e ɣ e n	 p l 'ɛ ɣ e n 
plens	p l 'e n s	 p l 'ɛ n s 
plomo	p l 'o m o	 p l 'ɔ m o 
plores	p l 'ɔ ɾ e s	 p l 'o ɾ e s 
plou	p l 'ɔ w	 p l 'o w 
plutoni	p l u t 'ɔ n i	 p l u t 'o n i 
poblen	p 'o β l e n	 p 'ɔ β l e n 
pobresa	p o β ɾ 'e z a	 p o β ɾ 'ɛ z a 
poden	p 'o ð e n	 p 'ɔ ð e n 
poesia	p o e z 'i a	 p o e s 'i a 
polla	p 'o ʎ a	 p 'ɔ ʎ a 
pol·luir	p o l w 'i ɾ	 p o l u 'i ɾ 
polonesa	p o l o n 'e z a	 p o l o n 'ɛ z a 
poloneses	p o l o n 'e z e s	 p o l o n 'ɛ z e s 
polonesos	p o l o n 'e z o s	 p o l o n 'ɛ z o s 
poloni	p o l 'ɔ n i	 p o l 'o n i 
polpa	p 'o l p a	 p 'ɔ l p a 
poltre	p 'o l t ɾ e	 p 'ɔ l t ɾ e 
polze	p 'o l z e	 p 'ɔ l z e 
pop	p 'o p	 p 'ɔ p 
popa	p 'o p a	 p 'ɔ p a 
popes	p 'o p e s	 p 'ɔ p e s 
porpra	p 'o ɾ p ɾ a	 p 'ɔ ɾ p ɾ a 
porro	p 'o r o	 p 'ɔ r o 
porros	p 'o r o s	 p 'ɔ r o s 
port	p 'ɔ ɾ t	 p 'o ɾ t 
portuguesa	p o ɾ t u ɣ 'e z a	 p o ɾ t u ɣ 'ɛ z a 
portugueses	p o ɾ t u ɣ 'e z e s	 p o ɾ t u ɣ 'ɛ z e s 
portuguesos	p o ɾ t u ɣ 'e z o s	 p o ɾ t u ɣ 'ɛ z o s 
post	p 'ɔ s t	 p 'o s t 
postludi	p o s l 'u ð i	 p o s t l 'u ð i 
postres	p 'o s t ɾ e s	 p 'ɔ s t ɾ e s 
pòstums	p 'ɔ s t u m s	 p o s t 'u m s 
pous	p 'o w s	 p o 'u s 
prec	p ɾ 'e k	 p ɾ 'ɛ k 
precoç	p ɾ e k 'ɔ s	 p ɾ e k 'o s 
precs	p ɾ 'e k s	 p ɾ 'ɛ k s 
prega	p ɾ 'e ɣ a	 p ɾ 'ɛ ɣ a 
prego	p ɾ 'e ɣ o	 p ɾ 'ɛ ɣ o 
premsa	p ɾ 'e m s a	 p ɾ 'ɛ m z a 
pren	p ɾ 'e n	 p ɾ 'ɛ n 
prenen	p ɾ 'e n e n	 p ɾ 'ɛ n e n 
prens	p ɾ 'e n s	 p ɾ 'ɛ n s 
preqüela	p ɾ e k w 'ɛ l a	 p ɾ e k 'ɛ l a 
pres	p ɾ 'e s	 p ɾ 'ɛ s 
presa	p ɾ 'e z a	 p ɾ 'ɛ z a 
preses	p ɾ 'e z e s	 p ɾ 'ɛ z e s 
presos	p ɾ 'e z o s	 p ɾ 'ɛ z o s 
pressupost	p ɾ e s u p 'ɔ s t	 p ɾ e s u p 'o s t 
presta	p ɾ 'e s t a	 p ɾ 'ɛ s t a 
presten	p ɾ 'e s t e n	 p ɾ 'ɛ s t e n 
prestes	p ɾ 'e s t e s	 p ɾ 'ɛ s t e s 
presto	p ɾ 'e s t o	 p ɾ 'ɛ s t o 
presumpció	p ɾ e z u m s i 'o	 p ɾ e z u m p s i 'o 
presumpta	p ɾ e z 'u m t a	 p ɾ e z 'u m p t a 
presumpte	p ɾ e z 'u m t e	 p ɾ e z 'u m p t e 
pretendre	p ɾ e t 'e n d ɾ e	 p ɾ e t 'ɛ n d ɾ e 
pretesa	p ɾ e t 'e z a	 p ɾ e t 'ɛ z a 
preteses	p ɾ e t 'e z e s	 p ɾ e t 'ɛ z e s 
pretesos	p ɾ e t 'e z o s	 p ɾ e t 'ɛ z o s 
preufetaire	p ɾ e w f e t 'a j ɾ e	 p ɾ e w f e t a 'i ɾ e 
preveure	p ɾ e v 'e w ɾ e	 p ɾ e v 'ɛ w ɾ e 
prínceps	p ɾ 'i n s e p s	 p ɾ i n s 'e p s 
princesa	p ɾ i n s 'e z a	 p ɾ i n s 'ɛ z a 
proa	p ɾ 'o a	 p ɾ 'ɔ a 
produir	p ɾ o ð w 'i ɾ	 p ɾ o ð u 'i ɾ 
prohom	p ɾ o 'o m	 p ɾ o 'ɛ m 
prolixa	p ɾ o l 'i ʃ a	 p ɾ o l 'i k s a 
prolixes	p ɾ o l 'i ʃ e s	 p ɾ o l 'i k s e s 
promesa	p ɾ o m 'e z a	 p ɾ o m 'ɛ z a 
promeses	p ɾ o m 'e z e s	 p ɾ o m 'ɛ z e s 
promesos	p ɾ o m 'e z o s	 p ɾ o m 'ɛ z o s 
Prometeu	p ɾ o m e t 'e w	 p ɾ o m e t 'ɛ w 
prometre	p ɾ o m 'e t ɾ e	 p ɾ o m 'ɛ t ɾ e 
prona	p ɾ 'ɔ n a	 p ɾ 'o n a 
prones	p ɾ 'ɔ n e s	 p ɾ 'o n e s 
prosseguida	p ɾ o s e ɣ 'i ð a	 p ɾ o s e ɣ u 'i ð a 
prosseguides	p ɾ o s e ɣ 'i ð e s	 p ɾ o s e ɣ u 'i ð e s 
proteic	p ɾ o t 'ɛ j k	 p ɾ o t 'ɛ i k 
protesta	p ɾ o t 'e s t a	 p ɾ o t 'ɛ s t a 
prou	p ɾ 'ɔ w	 p ɾ 'o w 
pruir	p ɾ w 'i ɾ	 p ɾ u 'i ɾ 
púlsar	p 'u l s a ɾ	 p u l s 'a ɾ 
puresa	p u ɾ 'e z a	 p u ɾ 'ɛ z a 
quaresma	k w a ɾ 'e z m a	 k w a ɾ 'ɛ z m a 
queixa	k 'e j ʃ a	 k 'ɛ j ʃ a 
qüestió	k w e s t i 'o	 k e s t i 'o 
qüestionada	k w e s t i o n 'a ð a	 k e s t i o n 'a ð a 
qüestionades	k w e s t i o n 'a ð e s	 k e s t i o n 'a ð e s 
qüestionar	k w e s t i o n 'a ɾ	 k e s t i o n 'a ɾ 
qüestionari	k w e s t i o n 'a ɾ i	 k e s t i o n 'a ɾ i 
qüestionat	k w e s t i o n 'a t	 k e s t i o n 'a t 
qüestionats	k w e s t i o n 'a t s	 k e s t i o n 'a t s 
quid	k 'i t	 k 'i ð 
quítxua	k 'i t ʃ u a	 k 'i t ʃ w a 
rai	r 'a j	 r 'a i 
rail	r 'a j l	 r 'a i l 
readmetre	r e a d m 'e t ɾ e	 r e a d m 'ɛ t ɾ e 
reben	r 'e β e n	 r 'ɛ β e n 
rebo	r 'e β o	 r 'ɛ β o 
rebost	r e β 'ɔ s t	 r e β 'o s t 
rebre	r 'e β ɾ e	 r 'ɛ β ɾ e 
rec	r 'e k	 r 'ɛ k 
reca	r 'e k a	 r 'ɛ k a 
recompte	r e k 'o m t e	 r e k 'ɔ m p t e 
reconstruir	r e k o n s t ɾ w 'i ɾ	 r e k o n s t ɾ u 'i ɾ 
recorre	r e k 'o r e	 r e k 'ɔ r e 
redempció	r e ð e m s i 'o	 r e ð e m p s i 'o 
reduir	r e ð w 'i ɾ	 r e ð u 'i ɾ 
refeu	r e f 'e w	 r e f 'ɛ w 
refluir	r e f l w 'i ɾ	 r e f l u 'i ɾ 
reforma	r e f 'o ɾ m a	 r e f 'ɔ ɾ m a 
refresc	r e f ɾ 'e s k	 r e f ɾ 'ɛ s k 
rega	r 'e ɣ a	 r 'ɛ ɣ a 
regla	r 'e ɣ l a	 r 'ɛ ɣ l a 
regles	r 'e ɣ l e s	 r 'ɛ ɣ l e s 
rei	r 'e j	 r i 
reialme	r e j 'a l m e	 r e i 'a l m e 
reietó	r e j e t 'o	 r e i e t 'o 
reina	r 'e j n a	 r e 'i n a 
reintroduir	r e i n t ɾ o ð w 'i ɾ	 r e i n t ɾ o ð u 'i ɾ 
reis	r 'e j s	 r 'ɛ i s 
reiteració	r e i t e ɾ a s i 'o	 r e j t e ɾ a s i 'o 
reiterada	r e i t e ɾ 'a ð a	 r e j t e ɾ 'a ð a 
reiterades	r e i t e ɾ 'a ð e s	 r e j t e ɾ 'a ð e s 
reiterar	r e i t e ɾ 'a ɾ	 r e j t e ɾ 'a ɾ 
reiterat	r e i t e ɾ 'a t	 r e j t e ɾ 'a t 
reiterats	r e i t e ɾ 'a t s	 r e j t e ɾ 'a t s 
reïx	r e 'i ʃ	 r e 'i t ʃ 
reixa	r 'e j ʃ a	 r 'ɛ j ʃ a 
relleu	r e ʎ 'e w	 r e ʎ 'ɛ w 
remei	r e m 'e j	 r e m 'ɛ i 
remeis	r e m 'e j s	 r e m 'ɛ i s 
remes	r 'e m e s	 r 'ɛ m e s 
remetre	r e m 'e t ɾ e	 r e m 'ɛ t ɾ e 
remo	r 'e m o	 r 'ɛ m o 
ren	r 'e n	 r 'ɛ n 
renda	r 'e n d a	 r 'ɛ n d a 
rendes	r 'e n d e s	 r 'ɛ n d e s 
renebot	r e n e β 'o t	 r e n e β 'ɔ t 
renec	r e n 'e k	 r e n 'ɛ k 
rengla	r 'e ŋ g l a	 r 'ɛ ŋ g l a 
rengle	r 'e ŋ g l e	 r 'ɛ ŋ g l e 
rengles	r 'e ŋ g l e s	 r 'ɛ ŋ g l e s 
renou	r e n 'ɔ w	 r e n 'o w 
renten	r 'e n t e n	 r 'ɛ n t e n 
renya	r 'e ɲ a	 r 'ɛ ɲ a 
renyen	r 'e ɲ e n	 r 'ɛ ɲ e n 
rep	r 'e p	 r 'ɛ p 
represa	r e p ɾ 'e z a	 r e p ɾ 'ɛ z a 
represes	r e p ɾ 'e z e s	 r e p ɾ 'ɛ z e s 
reproduir	r e p ɾ o ð w 'i ɾ	 r e p ɾ o ð u 'i ɾ 
repta	r 'e p t a	 r 'ɛ p t a 
repte	r 'e p t e	 r 'ɛ p t e 
reptes	r 'e p t e s	 r 'ɛ p t e s 
repto	r 'e p t o	 r 'ɛ p t o 
rere	r 'e ɾ e	 r 'ɛ ɾ e 
resa	r 'e z a	 r 'ɛ z a 
resclosa	r e s k l 'ɔ z a	 r e s k l 'o z a 
resen	r 'e z e n	 r 'ɛ z e n 
reso	r 'e z o	 r 'ɛ z o 
respatller	r e s p a l l 'e ɾ	 r e s p a t ʎ 'e ɾ 
respost	r e s p 'ɔ s t	 r e s p 'o s t 
ressec	r e s 'e k	 r e s 'ɛ k 
resseguida	r e s e ɣ 'i ð a	 r e s e ɣ u 'i ð a 
resseguides	r e s e ɣ 'i ð e s	 r e s e ɣ u 'i ð e s 
ressenya	r e s 'e ɲ a	 r e s 'ɛ ɲ a 
resta	r 'e s t a	 r s t a 
resten	r 'e s t e n	 r s t e n 
restes	r 'e s t e s	 r s t e s 
resto	r 'e s t o	 r s t o 
reten	r 'e t e n	 r 'ɛ t e n 
reto	r 'e t o	 r 'ɛ t o 
retre	r 'e t ɾ e	 r 'ɛ t ɾ e 
retreure	r e t ɾ 'e w ɾ e	 r e t ɾ 'ɛ w ɾ e 
reu	r 'e w	 r 'ɛ w 
reus	r 'e w s	 r 'ɛ w s 
Reus	r 'e w s	 r 'ɛ w s 
revetlla	r e v 'e l l a	 r e v 'ɛ l ʎ a 
reveure	r e v 'e w ɾ e	 r e v 'ɛ w ɾ e 
revolt	r e v 'ɔ l t	 r e v 'o l t 
Ribagorça	r i β a ɣ 'o ɾ s a	 r i β a ɣ 'ɔ ɾ s a 
riquesa	r i k 'e z a	 r i k 'ɛ z a 
roina	r 'ɔ j n a	 r 'ɔ i n a 
romanesa	r o m a n 'e z a	 r o m a n 'ɛ z a 
romanesos	r o m a n 'e z o s	 r o m a n 'ɛ z o s 
rombe	r 'o m b e	 r 'ɔ m b e 
rombes	r 'o m b e s	 r 'ɔ m b e s 
romesco	r o m 'e s k o	 r o m 'ɛ s k o 
romeu	r o m 'e w	 r o m 'ɛ w 
rompre	r 'o m p ɾ e	 r 'ɔ m p ɾ e 
ronca	r 'o ŋ k a	 r 'ɔ ŋ k a 
ronda	r 'o n d a	 r 'ɔ n d a 
rondes	r 'o n d e s	 r 'ɔ n d e s 
roquerol	r o k e ɾ 'o l	 r o k e ɾ 'ɔ l 
rosca	r 'o s k a	 r 'ɔ s k a 
rosques	r 'o s k e s	 r 'ɔ s k e s 
rossos	r 'o s o s	 r 'ɔ s o s 
rot	r 'o t	 r 'ɔ t 
rotonda	r o t 'o n d a	 r o t 'ɔ n d a 
roure	r 'o w ɾ e	 r 'ɔ w ɾ e 
rouró	r o w ɾ 'o	 r o u ɾ 'o 
rovellol	r o v e ʎ 'o l	 r o v e ʎ 'ɔ l 
ruandesa	r u a n d 'e z a	 r u a n d 'ɛ z a 
ruandesos	r u a n d 'e z o s	 r u a n d 'ɛ z o s 
rugbi	r 'u g b i	 r 'u g β i 
ruixada	r u j ʃ 'a ð a	 r i ʃ 'a ð a 
ruixades	r u j ʃ 'a ð e s	 r i ʃ 'a ð e s 
ruixar	r u j ʃ 'a ɾ	 r i ʃ 'a ɾ 
ruixat	r u j ʃ 'a t	 r i ʃ 'a t 
ruixats	r u j ʃ 'a t s	 r i ʃ 'a t s 
ruixim	r u j ʃ 'i m	 r i ʃ 'i m 
rumb	r 'u m p	 r 'u m b 
sa	s 'a	 s a 
saharià	s a a ɾ i 'a	 s a w a ɾ i 'a 
sahrauí	s a ɾ a w 'i	 s a r a w 'i 
sainet	s a j n 'e t	 s a i n 'e t 
sanefa	s a n 'e f a	 s a n 'ɛ f a 
sanglot	s a ŋ g l 'o t	 s a ŋ g l 'ɔ t 
sanguinyol	s a ŋ g i ɲ 'o l	 s a ŋ g i ɲ 'ɔ l 
sauna	s 'a w n a	 s a 'u n a 
saviesa	s a v i 'e z a	 s a v i 'ɛ z a 
sec	s 'e k	 s 'ɛ k 
seca	s 'e k a	 s 'ɛ k a 
secs	s 'e k s	 s 'ɛ k s 
seda	s 'e ð a	 s 'ɛ ð a 
sedes	s 'e ð e s	 s 'ɛ ð e s 
seduir	s e ð w 'i ɾ	 s e ð u 'i ɾ 
sega	s 'e ɣ a	 s 'ɛ ɣ a 
segle	s 'e ɣ l e	 s 'ɛ ɣ l e 
segles	s 'e ɣ l e s	 s 'ɛ ɣ l e s 
segrest	s e ɣ ɾ 'e s t	 s e ɣ ɾ 'ɛ s t 
seguici	s e ɣ 'i s i	 s e ɣ u 'i s i 
seguida	s e ɣ 'i ð a	 s e ɣ u 'i ð a 
seguides	s e ɣ 'i ð e s	 s e ɣ u 'i ð e s 
seient	s e j 'e n t	 s e i 'e n t 
seitó	s e j t 'o	 s e i t 'o 
sembla	s 'e m b l a	 s 'ɛ m b l a 
semblen	s 'e m b l e n	 s 'ɛ m b l e n 
sembles	s 'e m b l e s	 s 'ɛ m b l e s 
semblo	s 'e m b l o	 s 'ɛ m b l o 
sembra	s 'e m b ɾ a	 s 'ɛ m b ɾ a 
sembren	s 'e m b ɾ e n	 s 'ɛ m b ɾ e n 
semen	s 'e m e n	 s 'ɛ m e n 
semestre	s e m 'e s t ɾ e	 s e m 'ɛ s t ɾ e 
seminoma	s e m i n 'ɔ m a	 s e m i n 'o m a 
seminomes	s e m i n 'ɔ m e s	 s e m i n 'o m e s 
sempre	s 'e m p ɾ e	 s 'ɛ m p ɾ e 
senda	s 'e n d a	 s 'ɛ n d a 
senegalesa	s e n e ɣ a l 'e z a	 s e n e ɣ a l 'ɛ z a 
senegalesos	s e n e ɣ a l 'e z o s	 s e n e ɣ a l 'ɛ z o s 
sengles	s 'e ŋ g l e s	 s 'ɛ ŋ g l e s 
sénia	s 'e n i a	 s e n 'i a 
sens	s 'e n s	 s 'ɛ n s 
sense	s 'e n s e	 s 'ɛ n s e 
senten	s 'e n t e n	 s 'ɛ n t e n 
sento	s 'e n t o	 s 'ɛ n t o 
seny	s 'e ɲ	 s 'ɛ ɲ 
senyes	s 'e ɲ e s	 s 'ɛ ɲ e s 
senzillesa	s e n z i ʎ 'e z a	 s e n z i ʎ 'ɛ z a 
sépia	s 'e p i a	 s e p 'i a 
seques	s 'e k e s	 s 'ɛ k e s 
serp	s 'e ɾ p	 s 'ɛ ɾ p 
servei	s e ɾ v 'e j	 s e ɾ v 'ɛ i 
ses	s 'e s	 s e s 
sèsam	s 'ɛ z a m	 s e z 'a m 
setembre	s e t 'e m b ɾ e	 s e t 'ɛ m b ɾ e 
setze	s 'e d z e	 s 'ɛ d z e 
seu	s 'e w	 s 'ɛ w 
seua	s 'e w a	 s 'ɛ w a 
seure	s 'e w ɾ e	 s 'ɛ w ɾ e 
seus	s 'e w s	 s 'ɛ w s 
seva	s 'e v a	 s 'ɛ v a 
severs	s e v 'ɛ ɾ s	 s e v 'e ɾ s 
seves	s 'e v e s	 s 'ɛ v e s 
si	s 'i	 s i 
siameses	s i a m 'e z e s	 s i a m 'ɛ z e s 
siamesos	s i a m 'e z o s	 s i a m 'ɛ z o s 
síl·laba	s 'i l a β a	 s i l 'a β a 
simptomàtic	s i m t o m 'a t i k	 s i m p t o m 'a t i k 
simptomàtica	s i m t o m 'a t i k a	 s i m p t o m 'a t i k a 
simptomàtics	s i m t o m 'a t i k s	 s i m p t o m 'a t i k s 
sinagoga	s i n a ɣ 'o ɣ a	 s i n a ɣ 'ɔ ɣ a 
síndria	s 'i n d ɾ i a	 s i n d ɾ 'i a 
síndrome	s 'i n d ɾ o m e	 s i n d ɾ 'ɔ m e 
singlot	s i ŋ g l 'o t	 s i ŋ g l 'ɔ t 
sobra	s 'o β ɾ a	 s 'ɔ β ɾ a 
sobre	s 'o β ɾ e	 s 'ɔ β ɾ e 
sobta	s 'o p t a	 s 'ɔ p t a 
socs	s 'o k s	 s 'ɔ k s 
sofre	s 'o f ɾ e	 s 'ɔ f ɾ e 
solemne	s o l 'e m n e	 s o l 'ɛ m n e 
soler	s o l 'ɛ ɾ	 s o l 'e ɾ 
sòlids	s 'ɔ l i t s	 s o l i 'a s 
solos	s 'o l o s	 s 'ɔ l o s 
solquen	s 'o l k e n	 s 'ɔ l k e n 
sonda	s 'o n d a	 s 'ɔ n d a 
sondes	s 'o n d e s	 s 'ɔ n d e s 
sones	s 'ɔ n e s	 s 'o n e s 
soni	s 'ɔ n i	 s 'o n i 
sonin	s 'ɔ n i n	 s 'o n i n 
sonis	s 'ɔ n i s	 s 'o n i s 
sopa	s 'o p a	 s 'ɔ p a 
sopen	s 'o p e n	 s 'ɔ p e n 
sopes	s 'o p e s	 s 'ɔ p e s 
sorda	s 'o ɾ ð a	 s 'ɔ ɾ ð a 
sordes	s 'o ɾ ð e s	 s 'ɔ ɾ ð e s 
sordesa	s o ɾ ð 'e z a	 s o ɾ ð 'ɛ z a 
sorna	s 'o ɾ n a	 s 'ɔ ɾ n a 
sorpresa	s o ɾ p ɾ 'e z a	 s o ɾ p ɾ 'ɛ z a 
sorpreses	s o ɾ p ɾ 'e z e s	 s o ɾ p ɾ 'ɛ z e s 
sorpresos	s o ɾ p ɾ 'e z o s	 s o ɾ p ɾ 'ɛ z o s 
sort	s 'ɔ ɾ t	 s 'o ɾ t 
sostre	s 'o s t ɾ e	 s 'ɔ s t ɾ e 
sostres	s 'o s t ɾ e s	 s 'ɔ s t ɾ e s 
sostreure	s o s t ɾ 'e w ɾ e	 s o s t ɾ 'ɛ w ɾ e 
sota	s 'o t a	 s 'ɔ t a 
sotmesa	s o d m 'e z a	 s o d m 'ɛ z a 
sotmeses	s o d m 'e z e s	 s o d m 'ɛ z e s 
sotmesos	s o d m 'e z o s	 s o d m 'ɛ z o s 
sotmetre	s o d m 'e t ɾ e	 s o d m 'ɛ t ɾ e 
sous	s 'ɔ w s	 s o 'u s 
subduir	s u b d w 'i ɾ	 s u b d u 'i ɾ 
subhasta	s u β 'a s t a	 s u β u 'a s t a 
subsaharià	s u p s a a ɾ i 'a	 s u p s a w a ɾ i 'a 
suec	s u 'e k	 s u 'ɛ k 
sueca	s u 'e k a	 s u 'ɛ k a 
supero	s u p 'e ɾ o	 s u p 'ɛ ɾ o 
suport	s u p 'ɔ ɾ t	 s u p 'o ɾ t 
suspendre	s u s p 'e n d ɾ e	 s u s p 'ɛ n d ɾ e 
t'estimo	t a s t 'i m o	 t e s t 'i m o 
tabloide	t a β l 'ɔ j ð e	 t 'a β l 'ɔ 'i ð e 
tailandesa	t a j l a n d 'e z a	 t 'a j l 'a n d 'ɛ z a 
Tailàndia	t a j l 'a n d i a	 t a i l 'a n d i a 
tallarol	t a ʎ a ɾ 'o l	 t a ʎ a ɾ 'ɔ l 
tanmateix	t a m m a t 'e j ʃ	 t a n m a t 'e j ʃ 
tàrtar	t 'a ɾ t a ɾ	 t a ɾ t 'a ɾ 
Tàrtar	t 'a ɾ t a ɾ	 t a ɾ t 'a ɾ 
te	t 'e	 t e 
tecla	t 'e k l a	 t 'ɛ k l a 
tecles	t 'e k l e s	 t 'ɛ k l e s 
tecnicisme	t e g n i s 'i z m e	 t e k n i s 'i z m e 
tecnoestructura	t e g n o e s t ɾ u k t 'u ɾ a	 t e k n o e s t ɾ u k t 'u ɾ a 
teia	t 'e j a	 t 'ɛ j a 
telefoni	t e l e f 'ɔ n i	 t e l e f 'o n i 
telèfons	t e l 'ɛ f o n s	 t e l e f 'o n s 
telègraf	t e l 'ɛ ɣ ɾ a f	 t e l e ɣ ɾ 'a f 
temen	t 'e m e n	 t 'ɛ m e n 
temes	t 'e m e s	 t 'ɛ m e s 
temo	t 'e m o	 t 'ɛ m o 
tempesta	t e m p 'e s t a	 t e m p 'ɛ s t a 
templa	t 'e m p l a	 t 'ɛ m p l a 
temple	t 'e m p l e	 t 'ɛ m p l e 
temples	t 'e m p l e s	 t 'ɛ m p l e s 
temps	t 'e m s	 t 'ɛ m p s 
tempteig	t e m t 'e t ʃ	 t e m p t 'e t ʃ 
tenda	t 'e n d a	 t 'ɛ n d a 
tendes	t 'e n d e s	 t 'ɛ n d e s 
tenebra	t e n 'e β ɾ a	 t e n 'ɛ β ɾ a 
tenebres	t e n 'e β ɾ e s	 t e n 'ɛ β ɾ e s 
tenen	t 'e n e n	 t 'ɛ n e n 
tens	t 'e n s	 t 'ɛ n s 
tensa	t 'e n s a	 t 'ɛ n s a 
tenses	t 'e n s e s	 t 'ɛ n s e s 
tensos	t 'e n s o s	 t 'ɛ n s o s 
téntol	t 'e n t o l	 t e n t 'ɔ l 
Teresa	t e ɾ 'e z a	 t e ɾ 'ɛ z a 
terreny	t e r 'e ɲ	 t e r 'ɛ ɲ 
terrestre	t e r 'e s t ɾ e	 t e r 'ɛ s t ɾ e 
terrestres	t e r 'e s t ɾ e s	 t e r 'ɛ s t ɾ e s 
tes	t 'e s	 t e s 
Teseu	t e z 'ɛ w	 t e s 'ɛ w 
test	t 'e s t	 t 'ɛ s t 
testa	t 'e s t a	 t 'ɛ s t a 
testimoni	t e s t i m 'ɔ n i	 t e s t i m 'o n i 
testos	t 'e s t o s	 t 'ɛ s t o s 
tètan	t 'ɛ t a n	 t e t 'a n 
tètanus	t 'ɛ t a n u s	 t e t a n 'u s 
teu	t 'e w	 t 'ɛ w 
teula	t 'e w l a	 t 'ɛ w l a 
teus	t 'e w s	 t 'ɛ w s 
teva	t 'e v a	 t 'ɛ v a 
teves	t 'e v e s	 t 'ɛ v e s 
Texas	t 'ɛ k s a s	 t e k s 'a s 
Tirol	t i ɾ 'o l	 t i ɾ 'ɔ l 
titllada	t i l l 'a ð a	 t i t e l 'a ð a 
titllades	t i l l 'a ð e s	 t i t e l 'a ð e s 
titllar	t i l l 'a ɾ	 t i t a l 'a ɾ 
titllat	t i l l 'a t	 t i t u l 'a t 
titllats	t i l l 'a t s	 t i t u l 'a t s 
tomb	t 'o m p	 t 'o m b 
tomba	t 'o m b a	 t 'ɔ m b a 
tomben	t 'o m b e n	 t 'ɔ m b e n 
tombes	t 'o m b e s	 t 'ɔ m b e s 
tonya	t 'ɔ ɲ a	 t 'o ɲ a 
topa	t 'o p a	 t 'ɔ p a 
topants	t o p 'a n s	 t o p 'a n t s 
topen	t 'o p e n	 t 'ɔ p e n 
topo	t 'o p o	 t 'ɔ p o 
torna	t 'o ɾ n a	 t 'ɔ ɾ n a 
tornen	t 'o ɾ n e n	 t 'ɔ ɾ n e n 
tornes	t 'o ɾ n e s	 t 'ɔ ɾ n e s 
torno	t 'o ɾ n o	 t 'ɔ ɾ n o 
torpede	t o ɾ p 'e ð e	 t o ɾ p 'ɛ ð e 
torra	t 'ɔ r a	 t 'o r a 
torre	t 'o r e	 t 'ɔ r e 
tort	t 'ɔ ɾ t	 t 'o ɾ t 
tosca	t 'o s k a	 t 'ɔ s k a 
tot	t 'o t	 t 'ɔ t 
tota	t 'o t a	 t 'ɔ t a 
totes	t 'o t e s	 t 'ɔ t e s 
totxo	t 'o t ʃ o	 t 'ɔ t ʃ o 
tova	t 'o v a	 t 'ɔ v a 
toves	t 'o v e s	 t 'ɔ v e s 
traduir	t ɾ a ð w 'i ɾ	 t ɾ a ð u 'i ɾ 
trametre	t ɾ a m 'e t ɾ e	 t ɾ a m 'ɛ t ɾ e 
transmesa	t ɾ a n z m 'e z a	 t ɾ a n z m 'ɛ z a 
transmeses	t ɾ a n z m 'e z e s	 t ɾ a n z m 'ɛ z e s 
transmesos	t ɾ a n z m 'e z o s	 t ɾ a n z m 'ɛ z o s 
transmetre	t ɾ a n z m 'e t ɾ e	 t ɾ a n z m 'ɛ t ɾ e 
trapezoide	t ɾ a p e z 'ɔ j ð e	 t ɾ 'a p e z 'ɔ 'i ð e 
trec	t ɾ 'e k	 t ɾ 'ɛ k 
tren	t ɾ 'e n	 t ɾ 'ɛ n 
trenquen	t ɾ 'e ŋ k e n	 t ɾ 'ɛ ŋ k e n 
trens	t ɾ 'e n s	 t ɾ 'ɛ n s 
trepa	t ɾ 'e p a	 t ɾ 'ɛ p a 
trepes	t ɾ 'e p e s	 t ɾ 'ɛ p e s 
trepig	t ɾ e p 'i t ʃ	 t ɾ e p 'i ɣ 
tres	t ɾ 'e s	 t ɾ 'ɛ s 
tretze	t ɾ 'e d z e	 t ɾ 'ɛ d z e 
treu	t ɾ 'e w	 t ɾ 'ɛ w 
treure	t ɾ 'e w ɾ e	 t ɾ 'ɛ w ɾ e 
treus	t ɾ 'e w s	 t ɾ 'ɛ w s 
treva	t ɾ 'e v a	 t ɾ 'ɛ v a 
trilingüe	t ɾ i l 'i ŋ g w e	 t ɾ i l 'i ŋ g e 
trimestre	t ɾ i m 'e s t ɾ e	 t ɾ i m 'ɛ s t ɾ e 
trineu	t ɾ i n 'e w	 t ɾ i n 'ɛ w 
trinxeraire	t ɾ i n t ʃ e ɾ 'a j ɾ e	 t ɾ i n t ʃ e ɾ a 'i ɾ e 
tristesa	t ɾ i s t 'e z a	 t ɾ i s t 'ɛ z a 
trofeu	t ɾ o f 'e w	 t ɾ o f 'ɛ w 
Troia	t ɾ 'ɔ j a	 t ɾ o 'i a 
troica	t ɾ 'ɔ j k a	 t ɾ o 'i k a 
tromba	t ɾ 'o m b a	 t ɾ 'ɔ m b a 
trompa	t ɾ 'o m p a	 t ɾ 'ɔ m p a 
trompes	t ɾ 'o m p e s	 t ɾ 'ɔ m p e s 
troni	t ɾ 'ɔ n i	 t ɾ 'o n i 
tronin	t ɾ 'ɔ n i n	 t ɾ 'o n i n 
tronis	t ɾ 'ɔ n i s	 t ɾ 'o n i s 
tropa	t ɾ 'o p a	 t ɾ 'ɔ p a 
tropes	t ɾ 'o p e s	 t ɾ 'ɔ p e s 
truita	t ɾ w 'i t a	 t ɾ d ʒ 'i t a 
tsar	t s 'a ɾ	 a z 'a ɾ 
tsarévitx	t s a ɾ 'e v i t ʃ	 t s a ɾ e v 'i t ʃ 
txagatai	t ʃ a ɣ a t 'a j	 t ʃ a ɣ a t 'a i 
txec	t ʃ 'e k	 t ʃ 'ɛ k 
txeca	t ʃ 'e k a	 t ʃ 'ɛ k a 
txecs	t ʃ 'e k s	 t ʃ 'ɛ k s 
txeques	t ʃ 'e k e s	 t ʃ 'ɛ k e s 
ubiqüitat	u β i k w i t 'a t	 u β i k i t 'a t 
ucraïnesos	u k ɾ a i n 'e z o s	 u k ɾ a i n 'ɛ z o s 
udol	u ð 'o l	 u ð 'ɔ l 
Úmbria	'u m b ɾ i a	 u m b ɾ 'i a 
un	'u n	 u n 
únic	'u n i k	 ' u n i k 
uniforme	u n i f 'o ɾ m e	 u n i f 'ɔ ɾ m e 
uniformes	u n i f 'o ɾ m e s	 u n i f 'ɔ ɾ m e s 
univers	u n i v 'ɛ ɾ s	 u n i v 'e ɾ s 
urçol	u ɾ s 'o l	 u ɾ s 'ɔ l 
us	'u s	 u s 
usdefruit	u z ð e f ɾ w 'i t	 u z ð e f ɾ u 'i t 
Uzbekistan	u z β e k i s t 'a n	 u z β e g z i s t 'a n 
vaguista	v a ɣ 'i s t a	 v a ɣ u 'i s t a 
vailet	v a j l 'e t	 v a i l 'e t 
vainilla	v a j n 'i ʎ a	 v a i n 'i ʎ a 
vainilles	v a j n 'i ʎ e s	 v a i n 'i ʎ e s 
ve	v 'e	 v 'ɛ 
veça	v 'ɛ s a	 v 'e s a 
veda	v 'e ð a	 v 'ɛ ð a 
vellesa	v e ʎ 'e z a	 v e ʎ 'ɛ z a 
veloç	v e l 'ɔ s	 v e l 'o s 
ven	v 'e n	 v 'ɛ n 
venda	v 'e n d a	 v 'ɛ n d a 
vendre	v 'e n d ɾ e	 v 'ɛ n d ɾ e 
vens	v 'e n s	 v 'ɛ n s 
ventre	v 'e n t ɾ e	 v 'ɛ n t ɾ e 
verderol	v e ɾ ð e ɾ 'o l	 v e ɾ ð e ɾ 'ɔ l 
verds	v 'ɛ ɾ t s	 v 'ɛ ɾ i s 
vers	v 'ɛ ɾ s	 v 'e ɾ s 
ves	v 'e s	 v 'ɛ s 
vespa	v 'e s p a	 v 'ɛ s p a 
vespre	v 'e s p ɾ e	 v 'ɛ s p ɾ e 
vetlla	v 'e l l a	 v 'ɛ l ʎ a 
vetllada	v e l l 'a ð a	 v e ʎ l 'a ð a 
vetllades	v e l l 'a ð e s	 v e ʎ l 'a ð e s 
vetllar	v e l l 'a ɾ	 v e ʎ l 'a ɾ 
vetllat	v e l l 'a t	 v e ʎ l 'a t 
vetllats	v e l l 'a t s	 v e ʎ l 'a t s 
veu	v 'e w	 v 'ɛ w 
veure	v 'e w ɾ e	 v 'ɛ w ɾ e 
veure's	v 'e w ɾ e s	 v e w ɾ 'ɛ s 
veus	v 'e w s	 v 'ɛ w s 
Vicent	v i s 'ɛ n t	 v i s 'e n t 
vicesecretari	v i s e s e k ɾ e t 'a ɾ i	 v i s e z e k ɾ e t 'a ɾ i 
vienesa	v i e n 'e z a	 v i e n 'ɛ z a 
Vietnam	v i e d n 'a m	 v i e t n 'a m 
vietnamita	v i e d n a m 'i t a	 v i e t n a m 'i t a 
virrei	v i r 'e j	 v i r 'ɛ i 
viuda	v 'i w ð a	 v i 'u ð a 
volt	v 'ɔ l t	 v 'o l t 
voto	v 'o t o	 v 'ɔ t o 
vuit	v w 'i t	 v i 'i t 
vulgueu	v u l ɣ 'e w	 v u l ɣ 'ɛ w 
whisky	w 'i s k i	 a 'i s ɲ 
xai	t ʃ 'a j	 t ʃ 'a i 
Xangai	t ʃ a ŋ g 'a j	 t ʃ a ŋ g 'a i 
xarnega	t ʃ a ɾ n 'e ɣ a	 t ʃ a ɾ n 'ɛ ɣ a 
xe	t ʃ 'e	 t ʃ 'ɛ 
xec	t ʃ 'e k	 t ʃ 'ɛ k 
xecs	t ʃ 'e k s	 t ʃ 'ɛ k s 
xef	t ʃ 'e f	 t ʃ 'ɛ f 
xeic	t ʃ 'e j k	 t ʃ 'ɛ i k 
xemeneia	t ʃ e m e n 'e j a	 t ʃ e m e n e 'i a 
xerrameca	t ʃ e r a m 'e k a	 t ʃ e r a m 'ɛ k a 
xicoira	t ʃ i k 'ɔ j ɾ a	 t ʃ i k o 'i ɾ a 
xinesa	t ʃ i n 'e z a	 t ʃ i n 'ɛ z a 
xinesos	t ʃ i n 'e z o s	 t ʃ i n 'ɛ z o s 
xistorra	t ʃ i s t 'ɔ r a	 t ʃ i s t 'o r a 
xiular	t ʃ i w l 'a ɾ	 t ʃ i u l 'a ɾ 
xop	t ʃ 'o p	 t ʃ 'ɔ p 
xou	t ʃ 'ɔ w	 t ʃ 'o w 
xous	t ʃ 'ɔ w s	 t ʃ o 'u s 
yazidisme	j a z i ð 'i z m e	 k a z i ð 'i z m e 
Yukon	j u k 'o n	 u k 'o n 
zebra	z 'e β ɾ a	 z 'ɛ β ɾ a 
zero	z 'e ɾ o	 z 'ɛ ɾ o 
zirconi	z i ɾ k 'ɔ n i	 z i ɾ k 'o n i 
zoo	z 'o o	 z 'ɔ o 
zuau	z u 'a w	 a w 'a w 
de	d 'e	 d e 
que	k 'e	 k e 
la	l 'a	 l a 
i	'i	 i 
a	'a	 a 
el	'e l	 'ɛ l 
per	p 'e ɾ	 p e ɾ 
un	'u n	 u n 
en	'e n	 e n 
les	l 'e s	 l e s 
els	'e l s	 'ɛ l s 
del	d 'e l	 d e l 
amb	'a m	 'a m b 
al	'a l	 a l 
es	'e s	 e s 
El	'e l	 'ɛ l 
dels	d 'e l s	 d 'ɛ l s 
hi	'i	 i 
La	l 'a	 l a 
si	s 'i	 s i 
li	l 'i	 l i 
tot	t 'o t	 t 'ɔ t 
ja	j 'a	 d ʒ 'a 
Els	'e l s	 'ɛ l s 
A	'a	 a 
aquest	a k 'e s t	 a k 'ɛ s t 
sobre	s 'o β ɾ e	 s 'ɔ β ɾ e 
tres	t ɾ 'e s	 t ɾ 'ɛ s 
En	'e n	 e n 
Per	p 'e ɾ	 p e ɾ 
Si	s 'i	 s i 
sense	s 'e n s e	 s 'ɛ n s e 
ho	'o	 o 
temps	t 'e m s	 t 'ɛ m p s 
De	d 'e	 d e 
pel	p 'e l	 p e l 
tots	t 'o t s	 t 'ɔ t s 
aquesta	a k 'e s t a	 a k 'ɛ s t a 
entre	'e n t ɾ e	 ' a n t ɾ e 
sempre	s 'e m p ɾ e	 s 'ɛ m p ɾ e 
I	'i	 i 
he	'e	 'ɛ 
us	'u s	 u s 
cosa	k 'ɔ z a	 k 'o z a 
se	s 'e	 s e 
Un	'u n	 u n 
Les	l 'e s	 l e s 
tota	t 'o t a	 t 'ɔ t a 
mentre	m 'e n t ɾ e	 m 'ɛ n t ɾ e 
des	d 'e s	 d 'ɛ s 
Es	'e s	 e s 
feia	f 'e j a	 f 'ɛ j a 
Al	'a l	 a l 
hores	'ɔ ɾ e s	 i 'o ɾ e s 
totes	t 'o t e s	 t 'ɔ t e s 
Aquest	a k 'e s t	 a k 'ɛ s t 
coses	k 'ɔ z e s	 k 'o z e s 
Hi	'i	 i 
feina	f 'e j n a	 f 'ɛ j n a 
vuit	v w 'i t	 v i 'i t 
sembla	s 'e m b l a	 s 'ɛ m b l a 
dona	d 'ɔ n a	 d 'o n a 
tenen	t 'e n e n	 t 'ɛ n e n 
Ja	j 'a	 d ʒ 'a 
Li	l 'i	 l i 
Amb	'a m	 'a m b 
nens	n 'e n s	 n 'ɛ n s 
centre	s 'e n t ɾ e	 s 'ɛ n t ɾ e 
Aquesta	a k 'e s t a	 a k 'ɛ s t a 
sota	s 'o t a	 s 'ɔ t a 
aquests	a k 'e t s	 a k 'ɛ s t s 
ben	b 'e n	 b 'ɛ n 
zero	z 'e ɾ o	 z 'ɛ ɾ o 
pels	p 'e l s	 p 'ɛ l s 
molts	m 'o l s	 m 'o l t s 
contra	k 'o n t ɾ a	 k 'ɔ n t ɾ a 
mig	m 'i t ʃ	 m 'i k 
aquestes	a k 'e s t e s	 a k 'ɛ s t e s 
mesos	m 'e z o s	 m 'ɛ z o s 
finestra	f i n 'e s t ɾ a	 f i n 'ɛ s t ɾ a 
cotxe	k 'o t ʃ e	 k 'ɔ t ʃ e 
compte	k 'o m t e	 k 'ɔ m p t e 
Ho	'o	 o 
eren	'e ɾ e n	 'ɛ ɾ e n 
mes	m 'e s	 m 'ɛ s 
servei	s e ɾ v 'e j	 s e ɾ v 'ɛ i 
Queden	k 'e ð e n	 k 'ɛ ð e n 
tren	t ɾ 'e n	 t ɾ 'ɛ n 
mort	m 'ɔ ɾ t	 m 'o ɾ t 
metres	m 'e t ɾ e s	 m 'ɛ t ɾ e s 
forma	f 'o ɾ m a	 f 'ɔ ɾ m a 
fora	f 'ɔ ɾ a	 f 'o ɾ a 
ve	v 'e	 v 'ɛ 
nen	n 'e n	 n 'ɛ n 
llei	ʎ 'e j	 ʎ 'ɛ i 
sento	s 'e n t o	 s 'ɛ n t o 
He	'e	 'ɛ 
hora	'ɔ ɾ a	 a ɾ a 
se'n	s 'e n	 s 'ɛ n 
quants	k w 'a n s	 k w 'a n t s 
Tot	t 'o t	 t 'ɔ t 
darrere	d a r 'e ɾ e	 d a r 'ɛ ɾ e 
exemple	e g z 'e m p l e	 e g z 'ɛ m p l e 
tretze	t ɾ 'e d z e	 t ɾ 'ɛ d z e 
serveis	s e ɾ v 'e j s	 s e ɾ v 'ɛ i s 
ple	p l 'e	 p l 'ɛ 
dotze	d 'o d z e	 d 'ɔ d z e 
dones	d 'ɔ n e s	 d 'o n e s 
queda	k 'e ð a	 k 'ɛ ð a 
noi	n 'ɔ j	 n 'o i 
setze	s 'e d z e	 s 'ɛ d z e 
punts	p 'u n s	 p 'u n t s 
fort	f 'ɔ ɾ t	 f 'o ɾ t 
llengua	ʎ 'e ŋ g w a	 ʎ 'ɛ ŋ g w a 
metro	m 'e t ɾ o	 m 'ɛ t ɾ o 
segle	s 'e ɣ l e	 s 'ɛ ɣ l e 
Tots	t 'o t s	 t 'ɔ t s 
hagi	'a d ʒ i	 'ɔ d ʒ i 
crec	k ɾ 'e k	 k ɾ 'ɛ k 
cuina	k w 'i n a	 k 'u j n a 
Que	k 'e	 k e 
jove	d ʒ 'o v e	 d ʒ 'ɔ v e 
catorze	k a t 'o ɾ z e	 k a t 'ɔ ɾ z e 
Mentre	m 'e n t ɾ e	 m 'ɛ n t ɾ e 
joves	d ʒ 'o v e s	 d ʒ 'ɔ v e s 
empresa	a m p ɾ 'e z a	 a m p ɾ 'ɛ z a 
Sempre	s 'e m p ɾ e	 s 'ɛ m p ɾ e 
negre	n 'e ɣ ɾ e	 n 'ɛ ɣ ɾ e 
resta	r 'e s t a	 r s t a 
divuit	d i v w 'i t	 d i v i 'i t 
deixa	d 'e j ʃ a	 d 'ɛ j ʃ a 
boca	b 'o k a	 b 'ɔ k a 
temes	t 'e m e s	 t 'ɛ m e s 
tecla	t 'e k l a	 t 'ɛ k l a 
lletra	ʎ 'e t ɾ a	 ʎ 'ɛ t ɾ a 
centres	s 'e n t ɾ e s	 s 'ɛ n t ɾ e s 
Lleida	ʎ 'e j ð a	 ʎ e 'i ð a 
Des	d 'e s	 d 'ɛ s 
Aquests	a k 'e t s	 a k 'ɛ s t s 
tens	t 'e n s	 t 'ɛ n s 
se'ls	s 'e l s	 s 'ɛ l s 
camps	k 'a m s	 k 'a m p s 
trens	t ɾ 'e n s	 t ɾ 'ɛ n s 
rebre	r 'e β ɾ e	 r 'ɛ β ɾ e 
divendres	d i v 'e n d ɾ e s	 d i v 'ɛ n d ɾ e s 
buit	b w 'i t	 b u 'i t 
se'ns	s 'e n s	 s 'ɛ n s 
s'ho	s 'o	 s 'ɛ 
festa	f 'e s t a	 f 'ɛ s t a 
fes	f 'e s	 f 'ɛ s 
desembre	d e z 'e m b ɾ e	 d e z 'ɛ m b ɾ e 
Crec	k ɾ 'e k	 k ɾ 'ɛ k 
torna	t 'o ɾ n a	 t 'ɔ ɾ n a 
suport	s u p 'ɔ ɾ t	 s u p 'o ɾ t 
queden	k 'e ð e n	 k 'ɛ ð e n 
peixos	p 'e j ʃ o s	 p 'ɛ j ʃ o s 
l'hora	l 'ɔ ɾ a	 a 'o ɾ a 
junts	d ʒ 'u n s	 d ʒ 'u n t s 
foto	f 'o t o	 f 'ɔ t o 
Quants	k w 'a n s	 k w 'a n t s 
Pere	p 'e ɾ e	 p 'ɛ ɾ e 
setembre	s e t 'e m b ɾ e	 s e t 'ɛ m b ɾ e 
etcètera	e t s 'ɛ t e ɾ a	 a t s 'ɛ t e ɾ a 
conte	k 'o n t e	 k 'ɔ n t e 
a	'a	 a 
pensa	p 'e n s a	 p 'ɛ n s a 
me'n	m 'e n	 m 'ɛ n 
empreses	a m p ɾ 'e z e s	 a m p ɾ 'ɛ z e s 
bossa	b 'o s a	 b 'ɔ s a 
Entre	'e n t ɾ e	 ' a n t ɾ e 
pedra	p 'e ð ɾ a	 p 'ɛ ð ɾ a 
novembre	n o v 'e m b ɾ e	 n o v 'ɛ m b ɾ e 
nois	n 'ɔ j s	 n 'o i s 
moneda	m o n 'e ð a	 m o n 'ɛ ð a 
gens	d ʒ 'e n s	 d ʒ 'ɛ n s 
formes	f 'o ɾ m e s	 f 'ɔ ɾ m e s 
espai	a s p 'a j	 a s p 'a i 
cotxes	k 'o t ʃ e s	 k 'ɔ t ʃ e s 
compra	k 'o m p ɾ a	 k 'ɔ m p ɾ a 
Us	'u s	 u s 
Montse	m 'o n s e	 m 'ɔ n d z e 
penso	p 'e n s o	 p 'ɛ n s o 
negres	n 'e ɣ ɾ e s	 n 'ɛ ɣ ɾ e s 
me	m 'e	 m e 
lletres	ʎ 'e t ɾ e s	 ʎ 'ɛ t ɾ e s 
gossos	g 'o s o s	 g 'ɔ s o s 
Sembla	s 'e m b l a	 s 'ɛ m b l a 
Pel	p 'e l	 p e l 
volen	v 'o l e n	 v 'ɔ l e n 
se'm	s 'e m	 s 'ɛ m 
produir	p ɾ o ð w 'i ɾ	 p ɾ o ð u 'i ɾ 
plens	p l 'e n s	 p l 'ɛ n s 
dimecres	d i m 'e k ɾ e s	 d i m 'ɛ k ɾ e s 
Sense	s 'e n s e	 s 'ɛ n s e 
Aquestes	a k 'e s t e s	 a k 'ɛ s t e s 
veuen	v 'e w e n	 v 'ɛ w e n 
transport	t ɾ a n s p 'ɔ ɾ t	 t ɾ a n s p 'o ɾ t 
processos	p ɾ o s 'e s o s	 p ɾ o s 'ɛ s o s 
pedres	p 'e ð ɾ e s	 p 'ɛ ð ɾ e s 
membres	m 'e m b ɾ e s	 m 'ɛ m b ɾ e s 
l'havia	l a v 'i a	 ʎ a v 'i a 
desig	d e z 'i t ʃ	 d e z 'i ɣ 
Se	s 'e	 s e 
únic	'u n i k	 ' u n i k 
tempesta	t e m p 'e s t a	 t e m p 'ɛ s t a 
semblen	s 'e m b l e n	 s 'ɛ m b l e n 
seguida	s e ɣ 'i ð a	 s e ɣ u 'i ð a 
monedes	m o n 'e ð e s	 m o n 'ɛ ð e s 
fosca	f 'o s k a	 f 'ɔ s k a 
fer-ho	f 'e ɾ o	 f 'ɛ ɾ o 
entendre	a n t 'e n d ɾ e	 a n t 'ɛ n d ɾ e 
dolça	d 'o l s a	 d 'ɔ l s a 
disseny	d i s 'e ɲ	 d i s 'ɛ ɲ 
ves	v 'e s	 v 'ɛ s 
torno	t 'o ɾ n o	 t 'ɔ ɾ n o 
sistemes	s i s t 'e m e s	 s i s t 'ɛ m e s 
gest	d ʒ 'e s t	 d ʒ 'ɛ s t 
formen	f 'o ɾ m e n	 f 'ɔ ɾ m e n 
festes	f 'e s t e s	 f 'ɛ s t e s 
i	'i	 i 
vespre	v 'e s p ɾ e	 v 'ɛ s p ɾ e 
reforma	r e f 'o ɾ m a	 r e f 'ɔ ɾ m a 
quedo	k 'e ð o	 k 'ɛ ð o 
pres	p ɾ 'e s	 p ɾ 'ɛ s 
nord	n 'ɔ ɾ t	 n 'o ɾ t 
meitat	m e j t 'a t	 m e i t 'a t 
m'havia	m a v 'i a	 m e a v 'i a 
lleis	ʎ 'e j s	 ʎ 'ɛ i s 
leis	l 'e j s	 l 'ɛ i s 
hagin	'a d ʒ i n	 'ɔ d ʒ i n 
doble	d 'o β l e	 d 'ɔ β l e 
disposen	d i s p 'o z e n	 d i s p 'ɔ z e n 
Servei	s e ɾ v 'e j	 s e ɾ v 'ɛ i 
ésser	'e s e ɾ	 ' e s e ɾ 
A	'a	 a 
seca	s 'e k a	 s 'ɛ k a 
restes	r 'e s t e s	 r s t e s 
presa	p ɾ 'e z a	 p ɾ 'ɛ z a 
negra	n 'e ɣ ɾ a	 n 'ɛ ɣ ɾ a 
lluita	ʎ w 'i t a	 ʎ u 'i t a 
introduir	i n t ɾ o ð w 'i ɾ	 i n t ɾ o ð u 'i ɾ 
fer-me	f 'e ɾ m e	 f 'ɛ ɾ m e 
espais	a s p 'a j s	 a s p 'a i s 
comencen	k o m 'e n s e n	 k o m 'ɛ n s e n 
bombes	b 'o m b e s	 b 'ɔ m b e s 
Penso	p 'e n s o	 p 'ɛ n s o 
Francesc	f ɾ a n s 'e s k	 f ɾ a n s 'ɛ s k 
venen	v 'e n e n	 v 'ɛ n e n 
se'l	s 'e l	 s 'ɛ l 
s'hagi	s 'a d ʒ i	 s 'ɔ d ʒ i 
s'aixeca	s a j ʃ 'e k a	 s a j ʃ 'ɛ k a 
presenten	p ɾ e z 'e n t e n	 p ɾ e z 'ɛ n t e n 
permeten	p e ɾ m 'e t e n	 p e ɾ m 'ɛ t e n 
ordre	'o ɾ ð ɾ e	 'ɔ ɾ ð ɾ e 
fotos	f 'o t o s	 f 'ɔ t o s 
finestres	f i n 'e s t ɾ e s	 f i n 'ɛ s t ɾ e s 
feines	f 'e j n e s	 f 'ɛ j n e s 
esport	a s p 'ɔ ɾ t	 a s p 'o ɾ t 
bellesa	b e ʎ 'e z a	 b e ʎ 'ɛ z a 
ampolla	a m p 'o ʎ a	 a m p 'ɔ ʎ a 
Sento	s 'e n t o	 s 'ɛ n t o 
Guíxols	g 'i k s o l s	 g u 'i k s o l s 
Dóna'm	d 'o n a m	 d o n 'a m 
Conca	k 'o ŋ k a	 k 'ɔ ŋ k a 
terreny	t e r 'e ɲ	 t e r 'ɛ ɲ 
segles	s 'e ɣ l e s	 s 'ɛ ɣ l e s 
representen	r e p ɾ e z 'e n t e n	 r e p ɾ e z 'ɛ n t e n 
regles	r 'e ɣ l e s	 r 'ɛ ɣ l e s 
reben	r 'e β e n	 r 'ɛ β e n 
proposen	p ɾ o p 'o z e n	 p ɾ o p 'ɔ z e n 
pressupost	p ɾ e s u p 'ɔ s t	 p ɾ e s u p 'o s t 
premsa	p ɾ 'e m s a	 p ɾ 'ɛ m z a 
port	p 'ɔ ɾ t	 p 'o ɾ t 
pes	p 'e s	 p 'ɛ s 
permetre	p e ɾ m 'e t ɾ e	 p e ɾ m 'ɛ t ɾ e 
pensen	p 'e n s e n	 p 'ɛ n s e n 
naturalesa	n a t u ɾ a l 'e z a	 n a t u ɾ a l 'ɛ z a 
llargs	ʎ 'a ɾ k s	 ʎ 'a ɾ i s 
immens	i m m 'e n s	 i m m 'ɛ n s 
freda	f ɾ 'e ð a	 f ɾ 'ɛ ð a 
francesa	f ɾ a n s 'e z a	 f ɾ a n s 'ɛ z a 
comptes	k 'o m t e s	 k 'ɔ m p t e s 
cervesa	s e ɾ v 'e z a	 s e ɾ v 'ɛ z a 
caigut	k a j ɣ 'u t	 k a i ɣ 'u t 
atendre	a t 'e n d ɾ e	 a t 'ɛ n d ɾ e 
agents	a d ʒ 'e n s	 a d ʒ 'e n t s 
Totes	t 'o t e s	 t 'ɔ t e s 
Boi	b 'ɔ j	 b 'o i 
únics	'u n i k s	 ' u n i k s 
vendes	v 'e n d e s	 v 'ɛ n d e s 
tornes	t 'o ɾ n e s	 t 'ɔ ɾ n e s 
tinguessin	t i ŋ g 'e s i n	 t i ŋ g u 'ɛ s i n 
telèfons	t e l 'ɛ f o n s	 t e l e f 'o n s 
t'he	t 'e	 t 'ɛ 
rugbi	r 'u g b i	 r 'u g β i 
pren	p ɾ 'e n	 p ɾ 'ɛ n 
mots	m 'o t s	 m 'ɔ t s 
moto	m 'o t o	 m 'ɔ t o 
mot	m 'o t	 m 'ɔ t 
llest	ʎ 'e s t	 ʎ 'ɛ s t 
llengües	ʎ 'e ŋ g w e s	 ʎ 'ɛ ŋ g e s 
l'univers	l u n i v 'ɛ ɾ s	 l u n i v 'e ɾ s 
interessos	i n t e ɾ 'e s o s	 i n t e ɾ 'ɛ s o s 
fresca	f ɾ 'e s k a	 f ɾ 'ɛ s k a 
fe	f 'e	 f 'ɛ 
enmig	a m m 'i t ʃ	 a n m 'i ɣ 
contes	k 'o n t e s	 k 'ɔ n t e s 
construir	k o n s t ɾ w 'i ɾ	 k o n s t ɾ u 'i ɾ 
conduir	k o n d w 'i ɾ	 k o n d u 'i ɾ 
buida	b w 'i ð a	 b d ʒ 'i ð a 
Peso	p 'e z o	 p 'ɛ z o 
Pesa	p 'e z a	 p 'ɛ z a 
Molts	m 'o l s	 m 'o l t s 
Gandesa	g a n d 'e z a	 g a n d 'ɛ z a 
Fes	f 'e s	 f 'ɛ s 
éssers	'e s e ɾ s	  e s 'e ɾ s 
Per	p 'e ɾ	 p e ɾ 
En	'e n	 e n 
vers	v 'ɛ ɾ s	 v 'e ɾ s 
tendresa	t e n d ɾ 'e z a	 t e n d ɾ 'ɛ z a 
plataforma	p l a t a f 'o ɾ m a	 p l a t a f 'ɔ ɾ m a 
pagesos	p a d ʒ 'e z o s	 p a d ʒ 'ɛ z o s 
mestres	m 'e s t ɾ e s	 m 'ɛ s t ɾ e s 
menja	m 'e n d ʒ a	 m 'ɛ n d ʒ a 
intento	i n t 'e n t o	 i n t 'ɛ n t o 
intenten	i n t 'e n t e n	 i n t 'ɛ n t e n 
fruits	f ɾ w 'i t s	 f ɾ u 'i t s 
espardenyes	a s p a ɾ ð 'e ɲ e s	 a s p a ɾ ð 'ɛ ɲ e s 
entren	'e n t ɾ e n	 ' a n t ɾ e n 
eina	'e j n a	 d ʒ 'i n a 
currículum	k u r 'i k u l u m	 k u r i k u l 'u m 
cost	k 'ɔ s t	 k 'o s t 
corre	k 'o r e	 k 'ɔ r e 
copes	k 'o p e s	 k 'ɔ p e s 
començo	k o m 'e n s o	 k o m 'ɛ n s o 
caigui	k 'a j ɣ i	 k 'a i ɣ i 
apunts	a p 'u n s	 a p 'u n t s 
Tres	t ɾ 'e s	 t ɾ 'ɛ s 
Torna	t 'o ɾ n a	 t 'ɔ ɾ n a 
Tanmateix	t a m m a t 'e j ʃ	 t a n m a t 'e j ʃ 
Eren	'e ɾ e n	 'ɛ ɾ e n 
Compte	k 'o m t e	 k 'ɔ m p t e 
Antoni	a n t 'ɔ n i	 a n t 'o n i 
úniques	'u n i k e s	 ' u n i k e s 
única	'u n i k a	 ' u n i k a 
vivendes	v i v 'e n d e s	 v i v 'ɛ n d e s 
vivenda	v i v 'e n d a	 v i v 'ɛ n d a 
tornen	t 'o ɾ n e n	 t 'ɔ ɾ n e n 
sorpresa	s o ɾ p ɾ 'e z a	 s o ɾ p ɾ 'ɛ z a 
s'escapa	s a s k 'a p a	 s e s k 'a p a 
repte	r 'e p t e	 r 'ɛ p t e 
recompte	r e k 'o m t e	 r e k 'ɔ m p t e 
recents	r e s 'e n s	 r e s 'e n t s 
rapidesa	r a p i ð 'e z a	 r a p i ð 'ɛ z a 
queixa	k 'e j ʃ a	 k 'ɛ j ʃ a 
princesa	p ɾ i n s 'e z a	 p ɾ i n s 'ɛ z a 
poesia	p o e z 'i a	 p o e s 'i a 
pobresa	p o β ɾ 'e z a	 p o β ɾ 'ɛ z a 
plàncton	p l 'a ŋ k t o n	 p l a ŋ k t 'o n 
nego	n 'e ɣ o	 n 'ɛ ɣ o 
neboda	n e β 'o ð a	 n e β 'ɔ ð a 
lo	l 'o	 l o 
llop	ʎ 'o p	 ʎ 'ɔ p 
l'havien	l a v 'i e n	 ʎ a v 'i e n 
jersei	d ʒ e ɾ s 'e j	 d ʒ e ɾ s 'ɛ i 
intens	i n t 'e n s	 i n t 'ɛ n s 
gotes	g 'o t e s	 g 'ɔ t e s 
gota	g 'o t a	 g 'ɔ t a 
glop	g l 'o p	 g l 'ɔ p 
gallec	g a ʎ 'e k	 g a ʎ 'ɛ k 
fosques	f 'o s k e s	 f 'ɔ s k e s 
fortalesa	f o ɾ t a l 'e z a	 f o ɾ t a l 'ɛ z a 
endarrere	a n d a r 'e ɾ e	 a n d a r 'ɛ ɾ e 
encendre	a n s 'e n d ɾ e	 a n s 'ɛ n d ɾ e 
eines	'e j n e s	 'ɛ j n e s 
donen	d 'o n e n	 d 'ɔ n e n 
dimonis	d i m 'ɔ n i s	 d i m 'o n i s 
diguem-ne	d i ɣ 'e m n e	 d i ɣ u 'ɛ m n e 
deuen	d 'e w e n	 d 'ɛ w e n 
descens	d e s 'e n s	 d e s 'ɛ n s 
desa	d 'e z a	 d 'ɛ z a 
defensa	d e f 'e n s a	 d e f 'ɛ n s a 
continuï	k o n t i n 'u i	 k o n t i n 'u t 
compta	k 'o m t a	 k 'ɔ m p t a 
compro	k 'o m p ɾ o	 k 'ɔ m p ɾ o 
circuit	s i ɾ k w 'i t	 s 'i ɾ k 'u 'i t 
agenda	a d ʒ 'e n d a	 a d ʒ 'ɛ n d a 
aeroport	a e ɾ o p 'ɔ ɾ t	 a e ɾ o p 'o ɾ t 
Seguint	s e ɣ 'i n t	 s e ɣ u 'i n t 
Pineda	p i n 'e ð a	 p i n 'ɛ ð a 
Pensa	p 'e n s a	 p 'ɛ n s a 
Londres	l 'o n d ɾ e s	 l 'ɔ n d ɾ e s 
Intento	i n t 'e n t o	 i n t 'ɛ n t o 
Feia	f 'e j a	 f 'ɛ j a 
Eines	'e j n e s	 'ɛ j n e s 
Divendres	d i v 'e n d ɾ e s	 d i v 'ɛ n d ɾ e s 
per	p 'e ɾ	 p e ɾ 
ven	v 'e n	 v 'ɛ n 
txec	t ʃ 'e k	 t ʃ 'ɛ k 
tristesa	t ɾ i s t 'e z a	 t ɾ i s t 'ɛ z a 
testimonis	t e s t i m 'ɔ n i s	 t e s t i m 'o n i s 
te	t 'e	 t e 
suspendre	s u s p 'e n d ɾ e	 s u s p 'ɛ n d ɾ e 
seguint	s e ɣ 'i n t	 s e ɣ u 'i n t 
s'hagin	s 'a d ʒ i n	 s 'ɔ d ʒ i n 
s'adonessin	s a ð o n 'e s i n	 s a ð o n 'ɛ s i n 
retrobo	r e t ɾ 'o β o	 r e t ɾ 'ɔ β o 
renda	r 'e n d a	 r 'ɛ n d a 
remei	r e m 'e j	 r e m 'ɛ i 
reduir	r e ð w 'i ɾ	 r e ð u 'i ɾ 
pesca	p 'e s k a	 p 'ɛ s k a 
n'he	n 'e	 n 'ɛ 
mestre	m 'e s t ɾ e	 m 'ɛ s t ɾ e 
menjo	m 'e n d ʒ o	 m 'ɛ n d ʒ o 
membre	m 'e m b ɾ e	 m 'ɛ m b ɾ e 
mantenen	m a n t 'e n e n	 m a n t 'ɛ n e n 
lleixa	ʎ 'e j ʃ a	 ʎ 'ɛ j ʃ a 
l'hem	l 'ɛ m	 a 'e m 
grega	g ɾ 'e ɣ a	 g ɾ 'ɛ ɣ a 
foscos	f 'o s k o s	 f 'ɔ s k o s 
foren	f 'o ɾ e n	 f 'ɔ ɾ e n 
fer-nos	f 'e ɾ n o s	 f 'ɛ ɾ n o s 
fer-li	f 'e ɾ l i	 f 'ɛ ɾ l i 
esperen	a s p 'e ɾ e n	 a s p 'ɛ ɾ e n 
element	e l e m 'e n t	 ɛ l e m 'e n t 
eh	'e	 'ɛ 
dolents	d o l 'e n s	 d o l 'e n t s 
dimoni	d i m 'ɔ n i	 d i m 'o n i 
d'introduir	d i n t ɾ o ð w 'i ɾ	 d i n t ɾ o ð u 'i ɾ 
corren	k 'o r e n	 k 'ɔ r e n 
contribuents	k o n t ɾ i β u 'e n s	 k o n t ɾ i β u 'e n t s 
conec	k o n 'e k	 k o n 'ɛ k 
comparseros	k o m p a ɾ s 'e ɾ o s	 k o m p a ɾ s 'ɛ ɾ o s 
celebra	s e l 'e β ɾ a	 s e l 'ɛ β ɾ a 
caiguda	k a j ɣ 'u ð a	 k a i ɣ 'u ð a 
bàsquet	b 'a s k e t	 b a s k 'e t 
buits	b w 'i t s	 b d ʒ 'i t s 
bec	b 'e k	 b 'ɛ k 
admetre	a d m 'e t ɾ e	 a d m 'ɛ t ɾ e 
Volen	v 'o l e n	 v 'ɔ l e n 
Tens	t 'e n s	 t 'ɛ n s 
Sota	s 'o t a	 s 'ɔ t a 
Pontevedra	p o n t e v 'e ð ɾ a	 p o n t e v 'ɛ ð ɾ a 
Pels	p 'e l s	 p 'ɛ l s 
Menjo	m 'e n d ʒ o	 m 'ɛ n d ʒ o 
L'havien	l a v 'i e n	 ʎ a v 'i e n 
Espero	a s p 'e ɾ o	 a s p 'ɛ ɾ o 
Començo	k o m 'e n s o	 k o m 'ɛ n s o 
Centre	s 'e n t ɾ e	 s 'ɛ n t ɾ e 
univers	u n i v 'ɛ ɾ s	 u n i v 'e ɾ s 
transforma	t ɾ a n s f 'o ɾ m a	 t ɾ a n s f 'ɔ ɾ m a 
trametre	t ɾ a m 'e t ɾ e	 t ɾ a m 'ɛ t ɾ e 
tonto	t 'o n t o	 t 'ɔ n t o 
testimoni	t e s t i m 'ɔ n i	 t e s t i m 'o n i 
tecles	t 'e k l e s	 t 'ɛ k l e s 
te'n	t 'e n	 t 'ɛ n 
t'ho	t 'o	 t 'i 
sofre	s 'o f ɾ e	 s 'ɔ f ɾ e 
sisena	s i z 'e n a	 s i s 'e n a 
seqüeles	s e k w 'ɛ l e s	 s e k 'ɛ l e s 
seda	s 'e ð a	 s 'ɛ ð a 
sec	s 'e k	 s 'ɛ k 
sanefes	s a n 'e f e s	 s a n 'ɛ f e s 
sanefa	s a n 'e f a	 s a n 'ɛ f a 
s'accepten	s a k s 'e p t e n	 s a k s 'ɛ p t e n 
ronda	r 'o n d a	 r 'ɔ n d a 
riquesa	r i k 'e z a	 r i k 'ɛ z a 
rere	r 'e ɾ e	 r 'ɛ ɾ e 
refresco	r e f ɾ 'e s k o	 r e f ɾ 'ɛ s k o 
reformes	r e f 'o ɾ m e s	 r e f 'ɔ ɾ m e s 
recorre	r e k 'o r e	 r e k 'ɔ r e 
pàrquing	p 'a ɾ k i ŋ k	 p a ɾ k 'i ŋ k 
produint	p ɾ o ð w 'i n t	 p ɾ o ð u 'i n t 
presta	p ɾ 'e s t a	 p ɾ 'ɛ s t a 
presses	p ɾ 'e s e s	 p ɾ 'ɛ s e s 
presents	p ɾ e z 'e n s	 p ɾ e z 'e n t s 
presento	p ɾ e z 'e n t o	 p ɾ e z 'ɛ n t o 
poguessin	p o ɣ 'e s i n	 p o ɣ 'ɛ s i n 
poemes	p o 'e m e s	 p o 'ɛ m e s 
pesos	p 'e z o s	 p 'ɛ z o s 
perdre's	p 'ɛ ɾ ð ɾ e s	 p e ɾ ð ɾ 'ɛ s 
penja	p 'e n d ʒ a	 p 'ɛ n d ʒ a 
pengen	p 'e n d ʒ e n	 p 'ɛ n d ʒ e n 
passegen	p a s 'e d ʒ e n	 p a s 'ɛ d ʒ e n 
participants	p a ɾ t i s i p 'a n s	 p a ɾ t i s i p 'a n t s 
ordres	'o ɾ ð ɾ e s	 'ɔ ɾ ð ɾ e s 
omple	'o m p l e	 'ɔ m p l e 
ombres	'o m b ɾ e s	 'ɔ m b ɾ e s 
n'estava	n a s t 'a v a	 n e s t 'a v a 
mengen	m 'e n d ʒ e n	 m 'ɛ n d ʒ e n 
megues	m 'e ɣ e s	 m 'ɛ ɣ e s 
matrimoni	m a t ɾ i m 'ɔ n i	 m a t ɾ i m 'o n i 
l'hagués	l a ɣ 'e s	 ʎ a ɣ 'e s 
l'alcohol	l a l k o 'o l	 l a l k o 'a l 
immenses	i m m 'e n s e s	 i m m 'ɛ n s e s 
immensa	i m m 'e n s a	 i m m 'ɛ n s a 
haver-la	a v 'e ɾ l a	 a v 'ɛ ɾ l a 
haver-hi	a v 'e ɾ i	 a v 'ɛ ɾ i 
guants	g w 'a n s	 g w 'a n t s 
grecs	g ɾ 'e k s	 g ɾ 'ɛ k s 
grec	g ɾ 'e k	 g ɾ 'ɛ k 
golfes	g 'o l f e s	 g 'ɔ l f e s 
gespa	d ʒ 'e s p a	 g s p a 
gasoil	g a z 'ɔ j l	 g a z o 'i l 
fronts	f ɾ 'o n s	 f ɾ 'o n t s 
frescos	f ɾ 'e s k o s	 f ɾ 'ɛ s k o s 
frego	f ɾ 'e ɣ o	 f ɾ 'ɛ ɣ o 
freds	f ɾ 'e t s	 f ɾ 'ɛ d s 
francesos	f ɾ a n s 'e z o s	 f ɾ a n s 'ɛ z o s 
fotre	f 'o t ɾ e	 f 'ɔ t ɾ e 
fer-ne	f 'e ɾ n e	 f 'ɛ ɾ n e 
fer-la	f 'e ɾ l a	 f 'ɛ ɾ l a 
fem-ho	f 'e m o	 f 'ɛ m o 
feblesa	f e β l 'e z a	 f e β l 'ɛ z a 
exempts	e g z 'e m t s	 e g z 'ɛ m p t s 
estàndard	a s t 'a n d a ɾ t	 a s t a n d 'a ɾ t 
estranyesa	a s t ɾ a ɲ 'e z a	 a s t ɾ a ɲ 'ɛ z a 
estesa	a s t 'e z a	 a s t 'ɛ z a 
espongiformes	a s p o n d ʒ i f 'o ɾ m e s	 a s p o n d ʒ i f 'ɔ ɾ m e s 
escolta	a s k 'o l t a	 a s k 'ɔ l t a 
escletxa	a s k l 'e t ʃ a	 a s k l 'ɛ t ʃ a 
entrega	a n t ɾ 'e ɣ a	 a n t ɾ 'ɛ ɣ a 
entesos	a n t 'e z o s	 a n t 'ɛ z o s 
enquestes	a ŋ k 'e s t e s	 a ŋ k 'ɛ s t e s 
enquesta	a ŋ k 'e s t a	 a ŋ k 'ɛ s t a 
empremtes	a m p ɾ 'e m t e s	 a m p ɾ 'ɛ m t e s 
elèctrics	e l 'ɛ k t ɾ i k s	 e l e k t ɾ 'i k s 
dínars	d 'i n a ɾ s	 d i n 'a ɾ s 
dècada	d 'ɛ k a ð a	 d e k 'a ð a 
drapaire	d ɾ a p 'a j ɾ e	 d ɾ a p a 'i ɾ e 
digui'm	d 'i ɣ i m	 d i ɣ 'i m 
difondre	d i f 'o n d ɾ e	 d i f 'ɔ n d ɾ e 
d'hores	d 'ɔ ɾ e s	 d i 'o ɾ e s 
d'homes	d 'ɔ m e s	 d u 'o m e s 
còctels	k 'ɔ k t e l s	 k o k t 'ɛ l s 
curtcircuit	k u ɾ t s i ɾ k w 'i t	 k u ɾ t s 'i ɾ k 'u 'i t 
creua	k ɾ 'e w a	 k ɾ 'ɛ w a 
conca	k 'o ŋ k a	 k 'ɔ ŋ k a 
comte	k 'o m t e	 k 'ɔ m t e 
compren	k 'o m p ɾ e n	 k 'ɔ m p ɾ e n 
comenten	k o m 'e n t e n	 k o m 'ɛ n t e n 
colze	k 'o l z e	 k 'ɔ l z e 
ceptre	s 'e p t ɾ e	 s 'ɛ p t ɾ e 
cegues	s 'e ɣ e s	 s 'ɛ ɣ e s 
brolla	b ɾ 'o ʎ a	 b ɾ 'ɔ ʎ a 
bots	b 'o t s	 b 'ɔ t s 
bosses	b 'o s e s	 b 'ɔ s e s 
borsa	b 'o ɾ s a	 b 'ɔ ɾ s a 
borda	b 'o ɾ ð a	 b 'ɔ ɾ ð a 
bolígrafs	b o l 'i ɣ ɾ a f s	 b o l i ɣ ɾ 'a f s 
boixedes	b o j ʃ 'e ð e s	 b o j ʃ 'ɛ ð e s 
beca	b 'e k a	 b 'ɛ k a 
assumptes	a s 'u m t e s	 a s 'u m p t e s 
assumpte	a s 'u m t e	 a s 'u m p t e 
anècdotes	a n 'ɛ g d o t e s	 a n e g d 'ɔ t e s 
anglesa	a ŋ g l 'e z a	 a ŋ g l 'ɛ z a 
ampolles	a m p 'o ʎ e s	 a m p 'ɔ ʎ e s 
aimara	a j m 'a ɾ a	 a i m 'a ɾ a 
agafant-me	a ɣ a f 'a m m e	 a ɣ a f 'a n d m e 
accepto	a k s 'e p t o	 a k s 'ɛ p t o 
Verds	v 'ɛ ɾ t s	 v 'ɛ ɾ i s 
Torre	t 'o r e	 t 'ɔ r e 
Tornes	t 'o ɾ n e s	 t 'ɔ ɾ n e s 
Tenen	t 'e n e n	 t 'ɛ n e n 
Temps	t 'e m s	 t 'ɛ m p s 
Serveis	s e ɾ v 'e j s	 s e ɾ v 'ɛ i s 
Ribagorça	r i β a ɣ 'o ɾ s a	 r i β a ɣ 'ɔ ɾ s a 
Perdoni	p e ɾ ð 'ɔ n i	 p e ɾ ð 'o n i 
Noruega	n o ɾ u 'e ɣ a	 n o ɾ u 'ɛ ɣ a 
Naturalesa	n a t u ɾ a l 'e z a	 n a t u ɾ a l 'ɛ z a 
Mig	m 'i t ʃ	 m 'i k 
Me	m 'e	 m e 
Maresme	m a ɾ 'e z m e	 m a ɾ 'ɛ z m e 
Llei	ʎ 'e j	 ʎ 'ɛ i 
Güell	g w 'e ʎ	 g 'e ʎ 
Formes	f 'o ɾ m e s	 f 'ɔ ɾ m e s 
Escolta	a s k 'o l t a	 a s k 'ɔ l t a 
Eivissa	e j v 'i s a	 e i v 'i s a 
Dones	d 'ɔ n e s	 d 'o n e s 
Dimecres	d i m 'e k ɾ e s	 d i m 'ɛ k ɾ e s 
Descarrega't	d e s k a r 'e ɣ a t	 d e s k a r e ɣ 'a t 
Del	d 'e l	 d e l 
Celoni	s e l 'ɔ n i	 s e l 'o n i 
Camps	k 'a m s	 k 'a m p s 
per	p 'e ɾ	 p e ɾ 
Volen	v 'o l e n	 v 'ɔ l e n 
Hi	'i	 i 
De	d 'e	 d e 
xops	t ʃ 'o p s	 t ʃ 'ɔ p s 
vinguessis	v i ŋ g 'e s i s	 v i ŋ g u 'ɛ s i s 
vents	v 'e n s	 v 'e n t s 
vendre	v 'e n d ɾ e	 v 'ɛ n d ɾ e 
tornem-hi	t o ɾ n 'e m i	 t o ɾ n 'ɛ m i 
tenda	t 'e n d a	 t 'ɛ n d a 
seny	s 'e ɲ	 s 'ɛ ɲ 
sens	s 'e n s	 s 'ɛ n s 
seguien	s e ɣ 'i e n	 s e ɣ u 'i e n 
s'escapava	s a s k a p 'a v a	 s e s k a p 'a v a 
s'encarregarà	s a ŋ k a r e ɣ a ɾ 'a	 s e ŋ k a r e ɣ a ɾ 'a 
retorna	r e t 'o ɾ n a	 r e t 'ɔ ɾ n a 
resten	r 'e s t e n	 r s t e n 
reiterada	r e i t e ɾ 'a ð a	 r e j t e ɾ 'a ð a 
presumpte	p ɾ e z 'u m t e	 p ɾ e z 'u m p t e 
prenen	p ɾ 'e n e n	 p ɾ 'ɛ n e n 
pop	p 'o p	 p 'ɔ p 
polonesa	p o l o n 'e z a	 p o l o n 'ɛ z a 
poder-hi	p o ð 'e ɾ i	 p o ð 'ɛ ɾ i 
plaers	p l a 'ɛ ɾ s	 p l a 'e ɾ s 
pinedes	p i n 'e ð e s	 p i n 'ɛ ð e s 
pessigolles	p e s i ɣ 'o ʎ e s	 p e s i ɣ 'ɔ ʎ e s 
permesa	p e ɾ m 'e z a	 p e ɾ m 'ɛ z a 
penses	p 'e n s e s	 p 'ɛ n s e s 
pegues	p 'e ɣ e s	 p 'ɛ ɣ e s 
ombra	'o m b ɾ a	 'ɔ m b ɾ a 
oi	'ɔ j	 'o i 
nèctar	n 'ɛ k t a ɾ	 n e k t 'a ɾ 
mossec	m o s 'e k	 m o s 'ɛ k 
morro	m 'o r o	 m 'ɔ r o 
molesta	m o l 'e s t a	 m o l 'ɛ s t a 
metres	m 'e t ɾ e s	 m 'ɛ t ɾ e s 
maduresa	m a ð u ɾ 'e z a	 m a ð u ɾ 'ɛ z a 
m'havien	m a v 'i e n	 m e a v 'i e n 
l'himne	l 'i m n e	 a 'i m n e 
irrompre	i r 'o m p ɾ e	 i r 'ɔ m p ɾ e 
impresos	i m p ɾ 'e z o s	 i m p ɾ 'ɛ z o s 
honest	o n 'e s t	 o n 'ɛ s t 
himne	'i m n e	 u 'i m n e 
grotesc	g ɾ o t 'e s k	 g ɾ o t 'ɛ s k 
fruita	f ɾ w 'i t a	 f ɾ d ʒ 'i t a 
fonda	f 'o n d a	 f 'ɔ n d a 
fleca	f l 'e k a	 f l 'ɛ k a 
fer-te	f 'e ɾ t e	 f 'ɛ ɾ t e 
feble	f 'e β l e	 f 'ɛ β l e 
elefants	e l e f 'a n s	 e l e f 'a n t s 
distendre	d i s t 'e n d ɾ e	 d i s t 'ɛ n d ɾ e 
dirigents	d i ɾ i d ʒ 'e n s	 d i ɾ i d ʒ 'e n t s 
dirhams	d i ɾ 'a m s	 d i ɾ a 'a m s 
desmai	d e z m 'a j	 d e z m 'a i 
deshidratades	d e s i ð ɾ a t 'a ð e s	 d e z i ð ɾ a t 'a ð e s 
descomptes	d e s k 'o m t e s	 d e s k 'ɔ m p t e s 
descompte	d e s k 'o m t e	 d e s k 'ɔ m p t e 
depenen	d e p 'e n e n	 d e p 'ɛ n e n 
creuen	k ɾ 'e w e n	 k ɾ 'ɛ w e n 
corro	k 'o r o	 k 'ɔ r o 
copa	k 'o p a	 k 'ɔ p a 
concentren	k o n s 'e n t ɾ e n	 k o n s 'ɛ n t ɾ e n 
comprometre	k o m p ɾ o m 'e t ɾ e	 k o m p ɾ o m 'ɛ t ɾ e 
compres	k 'o m p ɾ e s	 k 'ɔ m p ɾ e s 
certesa	s e ɾ t 'e z a	 s e ɾ t 'ɛ z a 
bolonyesa	b o l o ɲ 'e z a	 b o l o ɲ 'ɛ z a 
beques	b 'e k e s	 b 'ɛ k e s 
arruinats	a r w i n 'a t s	 a r i i n 'a t s 
aquesta	a k 'e s t a	 a k 'ɛ s t a 
afronta	a f ɾ 'o n t a	 a f ɾ 'ɔ n t a 
adonar-me'n	a ð o n 'a ɾ m e n	 a ð o n a ɾ m 'ɛ n 
accepten	a k s 'e p t e n	 a k s 'ɛ p t e n 
absort	a p s 'ɔ ɾ t	 a p s 'o ɾ t 
Ui	w 'i	 ' u i 
Tota	t 'o t a	 t 'ɔ t a 
Sec	s 'e k	 s 'ɛ k 
Se'm	s 'e m	 s 'ɛ m 
Ronda	r 'o n d a	 r 'ɔ n d a 
Queda	k 'e ð a	 k 'ɛ ð a 
Port	p 'ɔ ɾ t	 p 'o ɾ t 
Nord	n 'ɔ ɾ t	 n 'o ɾ t 
Ginebra	d ʒ i n 'e β ɾ a	 d ʒ i n 'ɛ β ɾ a 
Engega	a n d ʒ 'e ɣ a	 a n d ʒ 'ɛ ɣ a 
Deixa	d 'e j ʃ a	 d 'ɛ j ʃ a 
Conec	k o n 'e k	 k o n 'ɛ k 
ítems	'i t e m s	 i t 'e m s 
àrab	'a ɾ a p	 'a ɾ a β 
que	k 'e	 k e 
quants	k w 'a n s	 k w 'a n t s 
eh	'e	 'ɛ 
Us	'u s	 u s 
Que	k 'e	 k e 
Quants	k w 'a n s	 k w 'a n t s 
La	l 'a	 l a 
En	'e n	 e n 
xopa	t ʃ 'o p a	 t ʃ 'ɔ p a 
xop	t ʃ 'o p	 t ʃ 'ɔ p 
xinesa	t ʃ i n 'e z a	 t ʃ i n 'ɛ z a 
xeics	t ʃ 'e j k s	 t ʃ e 'i k s 
xef	t ʃ 'e f	 t ʃ 'ɛ f 
xai	t ʃ 'a j	 t ʃ 'a i 
vuitens	v w i t 'e n s	 v w i t 'ɛ n s 
vodka	v 'o t k a	 v 'ɔ ð k a 
virrei	v i r 'e j	 v i r 'ɛ i 
vingueren	v i ŋ g 'e ɾ e n	 v i ŋ g 'ɛ ɾ e n 
vigents	v i d ʒ 'e n s	 v i d ʒ 'e n t s 
vespres	v 'e s p ɾ e s	 v 'ɛ s p ɾ e s 
verds	v 'ɛ ɾ t s	 v 'ɛ ɾ i s 
vendre'ns	v 'e n d ɾ e n s	 v e n d ɾ 'ɛ n s 
vendre'ls	v 'e n d ɾ e l s	 v e n d ɾ 'ɛ l s 
vellesa	v e ʎ 'e z a	 v e ʎ 'ɛ z a 
valoren	v a l 'o ɾ e n	 v a l 'ɔ ɾ e n 
validesa	v a l i ð 'e z a	 v a l i ð 'ɛ z a 
valents	v a l 'e n s	 v a l 'e n t s 
urgents	u ɾ d ʒ 'e n s	 u ɾ d ʒ 'e n t s 
uniforme	u n i f 'o ɾ m e	 u n i f 'ɔ ɾ m e 
txecs	t ʃ 'e k s	 t ʃ 'ɛ k s 
tsars	t s 'a ɾ s	 a z 'a ɾ s 
truites	t ɾ w 'i t e s	 t ɾ d ʒ 'i t e s 
truita	t ɾ w 'i t a	 t ɾ d ʒ 'i t a 
tronxos	t ɾ 'o n t ʃ o s	 t ɾ 'ɔ n t ʃ o s 
trontolla	t ɾ o n t 'o ʎ a	 t ɾ o n t 'ɔ ʎ a 
trobadoresca	t ɾ o β a ð o ɾ 'e s k a	 t ɾ o β a ð o ɾ 'ɛ s k a 
trilingües	t ɾ i l 'i ŋ g w e s	 t ɾ i l 'i ŋ g e s 
treuen	t ɾ 'e w e n	 t ɾ 'ɛ w e n 
trepig	t ɾ e p 'i t ʃ	 t ɾ e p 'i ɣ 
trepants	t ɾ e p 'a n s	 t ɾ e p 'a n t s 
trec	t ɾ 'e k	 t ɾ 'ɛ k 
trasplantessin	t ɾ a s p l a n t 'e s i n	 t ɾ a s p l a n t 'ɛ s i n 
transmetre	t ɾ a n z m 'e t ɾ e	 t ɾ a n z m 'ɛ t ɾ e 
transmeto	t ɾ a n z m 'e t o	 t ɾ a n z m 'ɛ t o 
transmetent-me	t ɾ a n z m e t 'e m m e	 t ɾ a n z m e t 'ɛ n d m e 
transmeten	t ɾ a n z m 'e t e n	 t ɾ a n z m 'ɛ t e n 
transcorre	t ɾ a n s k 'o r e	 t ɾ a n s k 'ɔ r e 
traficants	t ɾ a f i k 'a n s	 t ɾ a f i k 'a n t s 
tova	t 'o v a	 t 'ɔ v a 
totxo	t 'o t ʃ o	 t 'ɔ t ʃ o 
totes	t 'o t e s	 t 'ɔ t e s 
tot	t 'o t	 t 'ɔ t 
torre	t 'o r e	 t 'ɔ r e 
torero	t o ɾ 'e ɾ o	 t o ɾ 'ɛ ɾ o 
topen	t 'o p e n	 t 'ɔ p e n 
tomba	t 'o m b a	 t 'ɔ m b a 
tirallongues	t i ɾ a ʎ 'o ŋ g e s	 t i ɾ a ʎ 'ɔ ŋ g e s 
tirallonga	t i ɾ a ʎ 'o ŋ g a	 t i ɾ a ʎ 'ɔ ŋ g a 
tinerfenya	t i n e ɾ f 'e ɲ a	 t i n e ɾ f 'ɛ ɲ a 
testos	t 'e s t o s	 t 'ɛ s t o s 
testa	t 'e s t a	 t 'ɛ s t a 
terraqüi	t e r 'a k w i	 t e r 'a k i 
tempteig	t e m t 'e t ʃ	 t e m p t 'e t ʃ 
teclegen	t e k l 'e d ʒ e n	 t e k l 'ɛ d ʒ e n 
te'm	t 'e m	 t 'ɛ m 
te'l	t 'e l	 t 'ɛ l 
tangents	t a n d ʒ 'e n s	 t a n d ʒ 'e n t s 
t'hagis	t 'a d ʒ i s	 t 'ɔ d ʒ i s 
t'estimes	t a s t 'i m e s	 t e s t 'i m e s 
t'estima	t a s t 'i m a	 t e s t 'i m a 
t'estic	t a s t 'i k	 t e s t 'i k 
t'enyoro	t e ɲ 'o ɾ o	 t e ɲ 'ɔ ɾ o 
t'ensenyen	t a n s 'e ɲ e n	 t e n s 'ɛ ɲ e n 
t'ensenyaré	t a n s e ɲ a ɾ 'e	 t e n s e ɲ a ɾ 'e 
súpers	s 'u p e ɾ s	 s u p 'e ɾ s 
sòlids	s 'ɔ l i t s	 s o l i 'a s 
successos	s u k s 'e s o s	 s u k s 'ɛ s o s 
subministressin	s u b m i n i s t ɾ 'e s i n	 s u b m i n i s t ɾ 'ɛ s i n 
subhasta	s u β 'a s t a	 s u β u 'a s t a 
subgrup	s u b g ɾ 'u p	 s u β ɣ ɾ 'u p 
sotmetre	s o d m 'e t ɾ e	 s o d m 'ɛ t ɾ e 
sotmesos	s o d m 'e z o s	 s o d m 'ɛ z o s 
sospesen	s o s p 'e z e n	 s o s p 'ɛ z e n 
sospesa	s o s p 'e z a	 s o s p 'ɛ z a 
sorna	s 'o ɾ n a	 s 'ɔ ɾ n a 
sopes	s 'o p e s	 s 'ɔ p e s 
sopen	s 'o p e n	 s 'ɔ p e n 
sopa	s 'o p a	 s 'ɔ p a 
solemnes	s o l 'e m n e s	 s o l 'ɛ m n e s 
silvestres	s i l v 'e s t ɾ e s	 s i l v 'ɛ s t ɾ e s 
servents	s e ɾ v 'e n s	 s e ɾ v 'e n t s 
serps	s 'e ɾ p s	 s 'ɛ ɾ p s 
serp	s 'e ɾ p	 s 'ɛ ɾ p 
serens	s e ɾ 'e n s	 s e ɾ 'ɛ n s 
ser-ho	s 'e ɾ o	 s 'ɛ ɾ o 
ser-hi	s 'e ɾ i	 s 'ɛ ɾ i 
seques	s 'e k e s	 s 'ɛ k e s 
sents	s 'e n s	 s 'e n t s 
sentint-me	s e n t 'i m m e	 s e n t 'i n d m e 
senten	s 'e n t e n	 s 'ɛ n t e n 
sempre	s 'e m p ɾ e	 s 'ɛ m p ɾ e 
semblessin	s e m b l 'e s i n	 s e m b l 'ɛ s i n 
seitons	s e j t 'o n s	 s e i t 'o n s 
seduir	s e ð w 'i ɾ	 s e ð u 'i ɾ 
secs	s 'e k s	 s 'ɛ k s 
salts	s 'a l s	 s 'a l t s 
salpebra	s a l p 'e β ɾ a	 s a l p 'ɛ β ɾ a 
sahrauí	s a ɾ a w 'i	 s a r a w 'i 
s'oposen	s o p 'o z e n	 s o p 'ɔ z e n 
s'executen	s e g z e k 'u t e n	 s e k s e k 'u t e n 
s'esperava	s a s p e ɾ 'a v a	 s e s p e ɾ 'a v a 
s'espera	s a s p 'e ɾ a	 s e s p 'e ɾ a 
s'especifiquen	s a s p e s i f 'i k e n	 s e s p e s i f 'i k e n 
s'espantin	s a s p 'a n t i n	 s e s p 'a n t i n 
s'esforçava	s a s f o ɾ s 'a v a	 s e s f o ɾ s 'a v a 
s'escoltà	s a s k o l t 'a	 s e s k o l t 'a 
s'equivoquen	s e k i v 'o k e n	 s e k i v 'ɔ k e n 
s'ensenyen	s a n s 'e ɲ e n	 s e n s 'ɛ ɲ e n 
s'enlairaria	s a n l a j ɾ a ɾ 'i a	 s e n l a j ɾ a ɾ 'i a 
s'enganxen	s a ŋ g 'a n t ʃ e n	 s e ŋ g 'a n t ʃ e n 
s'endugui	s a n d 'u ɣ i	 s e n d 'u ɣ i 
s'encén	s a n s 'e n	 s e n s 'e n 
s'encarrega	s a ŋ k a r 'e ɣ a	 s e ŋ k a r 'ɛ ɣ a 
s'emporti	s a m p 'ɔ ɾ t i	 s e m p 'ɔ ɾ t i 
s'emmiralla	s a m m i ɾ 'a ʎ a	 s e m m i ɾ 'a ʎ a 
s'embolica	s a m b o l 'i k a	 s e m b o l 'i k a 
s'amaguessin	s a m a ɣ 'e s i n	 s a m a ɣ 'ɛ s i n 
s'alimenten	s a l i m 'e n t e n	 s a l i m 'ɛ n t e n 
s'aixequen	s a j ʃ 'e k e n	 s a j ʃ 'ɛ k e n 
s'adonen	s a ð 'o n e n	 s a ð 'ɔ n e n 
ruixar	r u j ʃ 'a ɾ	 r i ʃ 'a ɾ 
rotonda	r o t 'o n d a	 r o t 'ɔ n d a 
ronden	r 'o n d e n	 r 'ɔ n d e n 
ronca	r 'o ŋ k a	 r 'ɔ ŋ k a 
rodolen	r o ð 'o l e n	 r o ð 'ɔ l e n 
rodejant-ne	r o ð e d ʒ 'a n n e	 r o ð e d ʒ 'a n d n e 
riqueses	r i k 'e z e s	 r i k 'ɛ z e s 
revers	r e v 'ɛ ɾ s	 r e v 'e ɾ s 
resseguint	r e s e ɣ 'i n t	 r e s e ɣ u 'i n t 
respecto	r e s p 'e k t o	 r e s p 'ɛ k t o 
respectessin	r e s p e k t 'e s i n	 r e s p e k t 'ɛ s i n 
resen	r 'e z e n	 r 'ɛ z e n 
reptes	r 'e p t e s	 r 'ɛ p t e s 
reproduint-la	r e p ɾ o ð w 'i n l a	 r e p ɾ o ð i i n t l a 
repensar-nos-ho	r e p e n s 'a ɾ n o z o	 r e p e n s a ɾ n 'ɔ z o 
rep	r 'e p	 r 'ɛ p 
renoven	r e n 'o v e n	 r e n 'ɔ v e n 
renecs	r e n 'e k s	 r e n 'ɛ k s 
rencontre	r e ŋ k 'o n t ɾ e	 r e ŋ k 'ɔ n t ɾ e 
remescles	r e m 'e s k l e s	 r e m 'ɛ s k l e s 
reintegrament	r e i n t e ɣ ɾ a m 'e n t	 r e 'i n t 'ɛ ɣ ɾ a m 'e n t 
regla	r 'e ɣ l a	 r 'ɛ ɣ l a 
refrescants	r e f ɾ e s k 'a n s	 r e f ɾ e s k 'a n t s 
reexaminar	r e e k s a m i n 'a ɾ	 r e e g z a m i n 'a ɾ 
redemptora	r e ð e m t 'o ɾ a	 r e ð e m p t 'o ɾ a 
recorren	r e k 'o r e n	 r e k 'ɔ r e n 
reconeixent-ne	r e k o n e j ʃ 'e n n e	 r e k o n e j ʃ 'ɛ n d n e 
reconduir-lo	r e k o n d w 'i ɾ l o	 r e k 'o n d z i ɾ l o 
reconduir	r e k o n d w 'i ɾ	 r e k o n d u 'i ɾ 
recolzo	r e k 'o l z o	 r e k 'ɔ l z o 
recolza	r e k 'o l z a	 r e k 'ɔ l z a 
recents	r e s 'e n s	 r e s 'e n t s 
rec	r 'e k	 r 'ɛ k 
rebessin	r e β 'e s i n	 r e β 'ɛ s i n 
rails	r 'a j l s	 r a 'i l s 
quedes	k 'e ð e s	 k 'ɛ ð e s 
quatrecents	k w a t ɾ e s 'e n s	 k w a t ɾ e s 'e n t s 
pícnic	p 'i g n i k	 p 'i k n i k 
puresa	p u ɾ 'e z a	 p u ɾ 'ɛ z a 
proposo	p ɾ o p 'o z o	 p ɾ o p 'ɔ z o 
prometre'm	p ɾ o m 'e t ɾ e m	 p ɾ o m e t ɾ 'ɛ m 
prometre	p ɾ o m 'e t ɾ e	 p ɾ o m 'ɛ t ɾ e 
prometo	p ɾ o m 'e t o	 p ɾ o m 'ɛ t o 
promeses	p ɾ o m 'e z e s	 p ɾ o m 'ɛ z e s 
proeses	p ɾ o 'e z e s	 p ɾ o 'ɛ z e s 
preveuen	p ɾ e v 'e w e n	 p ɾ e v 'ɛ w e n 
pretesa	p ɾ e t 'e z a	 p ɾ e t 'ɛ z a 
pretendre	p ɾ e t 'e n d ɾ e	 p ɾ e t 'ɛ n d ɾ e 
presumpta	p ɾ e z 'u m t a	 p ɾ e z 'u m p t a 
prest	p ɾ 'e s t	 p ɾ 'ɛ s t 
prengueren	p ɾ e ŋ g 'e ɾ e n	 p ɾ e ŋ g 'ɛ ɾ e n 
premsa	p ɾ 'e m s a	 p ɾ 'ɛ m z a 
practicants	p ɾ a k t i k 'a n s	 p ɾ a k t i k 'a n t s 
posar-nos-hi	p o z 'a ɾ n o z i	 p o z a ɾ n 'ɔ z i 
posant-ne	p o z 'a n n e	 p o z 'a n d n e 
porta-me-les	p 'ɔ ɾ t a m e l e s	 p o ɾ t a m 'ɛ l e s 
porro	p 'o r o	 p 'ɔ r o 
popes	p 'o p e s	 p 'ɔ p e s 
poder-te	p o ð 'e ɾ t e	 p o ð 'ɛ ɾ t e 
poder-li	p o ð 'e ɾ l i	 p o ð 'ɛ ɾ l i 
poder-la	p o ð 'e ɾ l a	 p o ð 'ɛ ɾ l a 
plumero	p l u m 'e ɾ o	 p l u m 'ɛ ɾ o 
plego	p l 'e ɣ o	 p l 'ɛ ɣ o 
plega	p l 'e ɣ a	 p l 'ɛ ɣ a 
plecs	p l 'e k s	 p l 'ɛ k s 
placidesa	p l a s i ð 'e z a	 p l a s i ð 'ɛ z a 
piscines	p i s 'i n e s	 p i s k 'i n e s 
pintoresca	p i n t o ɾ 'e s k a	 p i n t o ɾ 'ɛ s k a 
petards	p e t 'a ɾ t s	 p e t 'a ɾ i s 
perpetren	p e ɾ p 'e t ɾ e n	 p e ɾ p 'ɛ t ɾ e n 
permetre'm	p e ɾ m 'e t ɾ e m	 p e ɾ m e t ɾ 'ɛ m 
permesos	p e ɾ m 'e z o s	 p e ɾ m 'ɛ z o s 
perdre-la	p 'ɛ ɾ ð ɾ e l a	 p e ɾ ð ɾ 'ɛ l a 
perdre'm	p 'ɛ ɾ ð ɾ e m	 p e ɾ ð ɾ 'ɛ m 
penjo	p 'e n d ʒ o	 p 'ɛ n d ʒ o 
penetren	p e n 'e t ɾ e n	 p e n 'ɛ t ɾ e n 
pega	p 'e ɣ a	 p 'ɛ ɣ a 
pebre	p 'e β ɾ e	 p 'ɛ β ɾ e 
patrimoni	p a t ɾ i m 'ɔ n i	 p a t ɾ i m 'o n i 
palesa	p a l 'e z a	 p a l 'ɛ z a 
oscil·la	o s 'i l a	 o s k 'i l a 
operen	o p 'e ɾ e n	 o p 'ɛ ɾ e n 
oncle	'o ŋ k l e	 'ɔ ŋ k l e 
oloro	o l 'o ɾ o	 o l 'ɔ ɾ o 
ofendre's	o f 'e n d ɾ e s	 o f e n d ɾ 'ɛ s 
oest	o 'e s t	 o 'ɛ s t 
ocupants	o k u p 'a n s	 o k u p 'a n t s 
observant-me	o p s e ɾ v 'a m m e	 o p s e ɾ v 'a n d m e 
oasi	o 'a z i	 o 'a s i 
nuesa	n u 'e z a	 n u 'ɛ z a 
netegessin	n e t e d ʒ 'e s i n	 n e t e d ʒ 'ɛ s i n 
nedes	n 'e ð e s	 n 'ɛ ð e s 
neden	n 'e ð e n	 n 'ɛ ð e n 
navega	n a v 'e ɣ a	 n a v 'ɛ ɣ a 
navarreses	n a v a r 'e z e s	 n a v a r 'ɛ z e s 
naips	n 'a j p s	 n a 'i p s 
na	n 'a	 n a 
n'està	n a s t 'a	 n e s t 'a 
n'estic	n a s t 'i k	 n e s t 'i k 
n'escoltem	n a s k o l t 'e m	 n e s k o l t 'e m 
mosso	m 'o s o	 m 'ɔ s o 
mosca	m 'o s k a	 m 'ɔ s k a 
mosaic	m o z 'a j k	 m o z 'a i k 
morses	m 'o ɾ s e s	 m 'ɔ ɾ s e s 
morros	m 'o r o s	 m 'ɔ r o s 
molest	m o l 'e s t	 m o l 'ɛ s t 
minusvalidesa	m i n u z v a l i ð 'e z a	 m i n u z v a l i ð 'ɛ z a 
migcampistes	m i k k a m p 'i s t e s	 m i ɣ k a m p 'i s t e s 
metros	m 'e t ɾ o s	 m 'ɛ t ɾ o s 
metre	m 'e t ɾ e	 m 'ɛ t ɾ e 
mestra	m 'e s t ɾ a	 m 'ɛ s t ɾ a 
mescles	m 'e s k l e s	 m 'ɛ s k l e s 
marxessin	m a ɾ t ʃ 'e s i n	 m a ɾ t ʃ 'ɛ s i n 
marcint-me	m a ɾ s 'i m m e	 m a ɾ s 'i n d m e 
manxec	m a n t ʃ 'e k	 m a n t ʃ 'ɛ k 
manifesta	m a n i f 'e s t a	 m a n i f 'ɛ s t a 
malalts	m a l 'a l s	 m a l 'a l t s 
malaguenya	m a l a ɣ 'e ɲ a	 m a l a ɣ 'ɛ ɲ a 
madrileny	m a ð ɾ i l 'e ɲ	 m a ð ɾ i l 'ɛ ɲ 
ma	m 'a	 m a 
m'hagis	m 'a d ʒ i s	 m 'ɔ d ʒ i s 
lletra	ʎ 'e t ɾ a	 ʎ 'ɛ t ɾ a 
llesta	ʎ 'e s t a	 ʎ 'ɛ s t a 
lleopards	ʎ e o p 'a ɾ t s	 ʎ e o p 'a ɾ i s 
llenço	ʎ 'e n s o	 ʎ 'ɛ n s o 
llenya	ʎ 'e ɲ a	 ʎ 'ɛ ɲ a 
llengües	ʎ 'e ŋ g w e s	 ʎ 'ɛ ŋ g e s 
llencen	ʎ 'e n s e n	 ʎ 'ɛ n s e n 
llegendes	ʎ e d ʒ 'e n d e s	 ʎ e d ʒ 'ɛ n d e s 
llambordes	ʎ a m b 'o ɾ ð e s	 ʎ a m b 'ɔ ɾ ð e s 
lepra	l 'e p ɾ a	 l 'ɛ p ɾ a 
lamento	l a m 'e n t o	 l a m 'ɛ n t o 
l'àlgebra	l 'a l d ʒ e β ɾ a	 l 'a d ʒ e β ɾ a 
l'harmònica	l a ɾ m 'ɔ n i k a	 ʎ a ɾ m 'ɔ n i k a 
l'algebraic	l a l d ʒ e β ɾ 'a j k	 l a l d ʒ e β ɾ 'a i k 
l'Univers	l u n i v 'ɛ ɾ s	 l u n i v 'e ɾ s 
l'Antoni	l a n t 'ɔ n i	 l a n t 'o n i 
justificants	d ʒ u s t i f i k 'a n s	 d ʒ u s t i f i k 'a n t s 
jueva	d ʒ u 'e v a	 d ʒ u 'ɛ v a 
japonesos	d ʒ a p o n 'e z o s	 d ʒ a p o n 'ɛ z o s 
jamaicans	d ʒ a m a j k 'a n s	 d ʒ a m a i k 'a n s 
irlandesa	i ɾ l a n d 'e z a	 i ɾ l a n d 'ɛ z a 
intèrpret	i n t 'ɛ ɾ p ɾ e t	 i n t e ɾ p ɾ 'e t 
intrínsecs	i n t ɾ 'i n s e k s	 i n t ɾ i n s 'e k s 
introduir-lo	i n t ɾ o ð w 'i ɾ l o	 i n t ɾ o ð i 'i ɾ l o 
interrompre	i n t e r 'o m p ɾ e	 i n t e r 'ɔ m p ɾ e 
interessin	i n t e ɾ 'e s i n	 i n t e ɾ 'ɛ s i n 
intensos	i n t 'e n s o s	 i n t 'ɛ n s o s 
intensa	i n t 'e n s a	 i n t 'ɛ n s a 
ingresses	i ŋ g ɾ 'e s e s	 i ŋ g ɾ 'ɛ s e s 
impresa	i m p ɾ 'e z a	 i m p ɾ 'ɛ z a 
import	i m p 'ɔ ɾ t	 i m p 'o ɾ t 
idoni	i ð 'ɔ n i	 i ð 'o n i 
híbrid	'i β ɾ i t	 i β ɾ i t 
hostesses	o s t 'e s e s	 o s t 'ɛ s e s 
hora	'ɔ ɾ a	 a ɾ a 
hongaresos	o ŋ g a ɾ 'e z o s	 o ŋ g a ɾ 'ɛ z o s 
himnes	'i m n e s	 u 'i m n e s 
haguessis	a ɣ 'e s i s	 a ɣ 'ɛ s i s 
haguessin	a ɣ 'e s i n	 a ɣ 'ɛ s i n 
hagis	'a d ʒ i s	 'ɔ d ʒ i s 
guinda	g 'i n d a	 g w 'i n d a 
guetos	g 'e t o s	 g 'ɛ t o s 
guanyant-me	g w a ɲ 'a m m e	 g w a ɲ 'a n d m e 
guacamais	g w a k a m 'a j s	 g w a k a m 'a i s 
grinyolen	g ɾ i ɲ 'o l e n	 g ɾ i ɲ 'ɔ l e n 
greixos	g ɾ 'e j ʃ o s	 g ɾ 'ɛ j ʃ o s 
golfo	g 'o l f o	 g 'ɔ l f o 
gestos	d ʒ 'e s t o s	 d ʒ 'ɛ s t o s 
gesta	d ʒ 'e s t a	 d ʒ 'ɛ s t a 
generen	d ʒ e n 'e ɾ e n	 d ʒ e n 'ɛ ɾ e n 
gemecs	d ʒ e m 'e k s	 d ʒ e m 'ɛ k s 
gemec	d ʒ e m 'e k	 d ʒ e m 'ɛ k 
gallega	g a ʎ 'e ɣ a	 g a ʎ 'ɛ ɣ a 
galleda	g a ʎ 'e ð a	 g a ʎ 'ɛ ð a 
gairell	g a j ɾ 'e ʎ	 g a i ɾ 'e ʎ 
fèlids	f 'ɛ l i t s	 f e l i 'a s 
futbolí	f u d b o l 'i	 f u t b o l 'i 
fuita	f w 'i t a	 f 'u j t a 
fruit	f ɾ w 'i t	 f ɾ u 'i t 
fresc	f ɾ 'e s k	 f ɾ 'ɛ s k 
freqüents	f ɾ e k w 'e n s	 f ɾ e k 'e n t s 
freqüentava	f ɾ e k w e n t 'a v a	 f ɾ e k e n t 'a v a 
freqüent	f ɾ e k w 'e n t	 f ɾ e k 'e n t 
frens	f ɾ 'e n s	 f ɾ 'ɛ n s 
frega	f ɾ 'e ɣ a	 f ɾ 'ɛ ɣ a 
fredes	f ɾ 'e ð e s	 f ɾ 'ɛ ð e s 
frec	f ɾ 'e k	 f ɾ 'ɛ k 
franceses	f ɾ a n s 'e z e s	 f ɾ a n s 'ɛ z e s 
fots	f 'o t s	 f 'ɔ t s 
fotre-li	f 'o t ɾ e l i	 f o t ɾ 'ɛ l i 
foteses	f o t 'e z e s	 f o t 'ɛ z e s 
fot	f 'o t	 f 'ɔ t 
fluïdesa	f l u i ð 'e z a	 f l u i ð 'ɛ z a 
fluixesa	f l u j ʃ 'e z a	 f l u j ʃ 'ɛ z a 
fluir	f l w 'i ɾ	 f l u 'i ɾ 
fletxes	f l 'e t ʃ e s	 f l 'ɛ t ʃ e s 
fletxa	f l 'e t ʃ a	 f l 'ɛ t ʃ a 
fiquessin	f i k 'e s i n	 f i k 'ɛ s i n 
finestra	f i n 'e s t ɾ a	 f i n 'ɛ s t ɾ a 
fermesa	f e ɾ m 'e z a	 f e ɾ m 'ɛ z a 
fer-vos	f 'e ɾ v o s	 f 'ɛ ɾ v o s 
fer-lo	f 'e ɾ l o	 f 'ɛ ɾ l o 
fer-hi	f 'e ɾ i	 f 'ɛ ɾ i 
fent-lo	f 'e n l o	 f 'ɛ n d l o 
fen	f 'e n	 f 'ɛ n 
feixos	f 'e j ʃ o s	 f 'ɛ j ʃ o s 
fatxendes	f a t ʃ 'e n d e s	 f a t ʃ 'ɛ n d e s 
extrems	e k s t ɾ 'e m s	 e k s t ɾ 'ɛ m s 
extremenya	e k s t ɾ e m 'e ɲ a	 e k s t ɾ e m 'ɛ ɲ a 
extensa	e k s t 'e n s a	 e k s t 'ɛ n s a 
extens	e k s t 'e n s	 e k s t 'ɛ n s 
expliquessin	e k s p l i k 'e s i n	 e k s p l i k 'ɛ s i n 
explicant-me	e k s p l i k 'a m m e	 e k s p l i k 'a n d m e 
explicant-los	e k s p l i k 'a n l o s	 e k s p l i k 'a n d l o s 
exemples	e g z 'e m p l e s	 e g z 'ɛ m p l e s 
etc	'e t k	 'ɛ t k 
estómac	a s t 'o m a k	 a s t o m 'a k 
estupideses	a s t u p i ð 'e z e s	 a s t u p i ð 'ɛ z e s 
estudiïn	a s t u ð 'i i n	 a s t u ð i 'i n 
estris	'ɛ s t ɾ i s	 a s t ɾ i s 
estrenyent-me	a s t ɾ e ɲ 'e m m e	 a s t ɾ e ɲ 'ɛ n d m e 
estepa	a s t 'e p a	 a s t 'ɛ p a 
esport	a s p 'ɔ ɾ t	 a s p 'o ɾ t 
espessos	a s p 'e s o s	 a s p 'ɛ s o s 
espero	a s p 'e ɾ o	 a s p 'ɛ ɾ o 
esperessis	a s p e ɾ 'e s i s	 a s p e ɾ 'ɛ s i s 
esperessin	a s p e ɾ 'e s i n	 a s p e ɾ 'ɛ s i n 
esperant-los	a s p e ɾ 'a n l o s	 a s p e ɾ 'a n d l o s 
esment	a z m 'e n t	 e z m 'e n t 
esgrogueït	a z ɣ ɾ o ɣ e 'i t	 a z ɣ ɾ o ɣ u e 'i t 
esglai	a z ɣ l 'a j	 a z ɣ l 'a i 
escrivint-te	a s k ɾ i v 'i n t e	 a s k ɾ i v 'i n t t e 
escombra	a s k 'o m b ɾ a	 a s k 'ɔ m b ɾ a 
escolto	a s k 'o l t o	 a s k 'ɔ l t o 
escoltes	a s k 'o l t e s	 a s k 'ɔ l t e s 
escoceses	a s k o s 'e z e s	 a s k o s 'ɛ z e s 
escaigui	a s k 'a j ɣ i	 a s k 'a i ɣ i 
esbufega	a z β u f 'e ɣ a	 a z β u f 'ɛ ɣ a 
entendre'n	a n t 'e n d ɾ e n	 a n t e n d ɾ 'ɛ n 
engego	a n d ʒ 'e ɣ o	 a n d ʒ 'ɛ ɣ o 
engega	a n d ʒ 'e ɣ a	 a n d ʒ 'ɛ ɣ a 
endreço	a n d ɾ 'e s o	 a n d ɾ 'ɛ s o 
encesa	a n s 'e z a	 a n s 'ɛ z a 
empesquen	a m p 'e s k e n	 a m p 'ɛ s k e n 
emborratxant-me	a m b o r a t ʃ 'a m m e	 a m b o r a t ʃ 'a n d m e 
elèctrica	e l 'ɛ k t ɾ i k a	 e l e k t ɾ 'i k a 
elàstic	e l 'a s t i k	 a l 'a s t i k 
dèficits	d 'ɛ f i s i t s	 d e f i s 'i t s 
donessin	d o n 'e s i n	 d o n 'ɛ s i n 
donant-nos	d o n 'a n n o s	 d o n 'a n d n o s 
dobla	d 'o β l a	 d 'ɔ β l a 
distribuir	d i s t ɾ i β w 'i ɾ	 d i s t ɾ i β u 'i ɾ 
distreuen	d i s t ɾ 'e w e n	 d i s t ɾ 'ɛ w e n 
disposo	d i s p 'o z o	 d i s p 'ɔ z o 
discrepo	d i s k ɾ 'e p o	 d i s k ɾ 'ɛ p o 
digueren	d i ɣ 'e ɾ e n	 d i ɣ 'ɛ ɾ e n 
dibuixant-me	d i β u j ʃ 'a m m e	 d i β u j ʃ 'a n d m e 
detesto	d e t 'e s t o	 d e t 'ɛ s t o 
destruir	d e s t ɾ w 'i ɾ	 d e s t ɾ u 'i ɾ 
destresa	d e s t ɾ 'e z a	 d e s t ɾ 'ɛ z a 
desordres	d e z 'o ɾ ð ɾ e s	 d e z 'ɔ ɾ ð ɾ e s 
desordre	d e z 'o ɾ ð ɾ e	 d e z 'ɔ ɾ ð ɾ e 
desigs	d e z 'i t ʃ s	 d e z 'i d ʒ s 
desfer-li	d e s f 'e ɾ l i	 d e s f 'ɛ ɾ l i 
descarreguen	d e s k a r 'e ɣ e n	 d e s k a r 'ɛ ɣ e n 
demanar-nos-ho	d e m a n 'a ɾ n o z o	 d e m a n a ɾ n 'ɔ z o 
deltaic	d e l t 'a j k	 d e l t 'a i k 
delinqüents	d e l i ŋ k w 'e n s	 d e l i ŋ k 'e n t s 
deixessin	d e j ʃ 'e s i n	 d e j ʃ 'ɛ s i n 
deixant-me	d e j ʃ 'a m m e	 d e j ʃ 'a n d m e 
deixa't	d 'e j ʃ a t	 d e j ʃ 'a t 
deixa'm	d 'e j ʃ a m	 d e j ʃ 'a m 
defenses	d e f 'e n s e s	 d e f 'ɛ n s e s 
decep	d e s 'e p	 d e s 'ɛ p 
danesos	d a n 'e z o s	 d a n 'ɛ z o s 
damisel·la	d a m i z 'ɛ l a	 d a m i s 'ɛ l a 
d'àrab	d 'a ɾ a p	 d 'a ɾ a β 
d'intèrpret	d i n t 'ɛ ɾ p ɾ e t	 d i n t e ɾ p ɾ 'e t 
d'exotisme	d e g z o t 'i z m e	 d e k s o t 'i z m e 
d'anècdotes	d a n 'ɛ g d o t e s	 d a n e g d 'ɔ t e s 
d'alts	d 'a l s	 d 'a l t s 
d'alcohol	d a l k o 'o l	 d a l k o 'a l 
d'afeitar	d a f e j t 'a ɾ	 d a f e i t 'a ɾ 
d'adults	d a ð 'u l s	 d a ð 'u l t s 
d'Eivissa	d e j v 'i s a	 d e i v 'i s a 
cònjuge	k 'ɔ n d ʒ u d ʒ e	 k o n d ʒ 'u d ʒ e 
còmplices	k 'ɔ m p l i s e s	 k o m p l 'i s e s 
cuida	k w 'i ð a	 k d ʒ 'i ð a 
créixens	k ɾ 'e j ʃ e n s	 k ɾ e j ʃ 'e n s 
cromos	k ɾ 'o m o s	 k ɾ 'ɔ m o s 
creïn	k ɾ 'e i n	 k ɾ e 'i n 
cremes	k ɾ 'e m e s	 k ɾ 'ɛ m e s 
cremen	k ɾ 'e m e n	 k ɾ 'ɛ m e n 
creessin	k ɾ e 'e s i n	 k ɾ e 'ɛ s i n 
credo	k ɾ 'e ð o	 k ɾ 'ɛ ð o 
covards	k o v 'a ɾ t s	 k o v 'a ɾ i s 
cosa	k 'ɔ z a	 k 'o z a 
controlo	k o n t ɾ 'o l o	 k o n t ɾ 'ɔ l o 
contribuir	k o n t ɾ i β w 'i ɾ	 k o n t ɾ i β u 'i ɾ 
continuessin	k o n t i n u 'e s i n	 k o n t i n u 'ɛ s i n 
contesto	k o n t 'e s t o	 k o n t 'ɛ s t o 
contenen	k o n t 'e n e n	 k o n t 'ɛ n e n 
construint	k o n s t ɾ w 'i n t	 k o n s t ɾ u 'i n t 
consta	k 'o n s t a	 k 'ɔ n s t a 
considero	k o n s i ð 'e ɾ o	 k o n s i ð 'ɛ ɾ o 
conseqüents	k o n s e k w 'e n s	 k o n s e k 'e n t s 
conseqüent	k o n s e k w 'e n t	 k o n s e k 'e n t 
conques	k 'o ŋ k e s	 k 'ɔ ŋ k e s 
condemna	k o n d 'e m n a	 k o n d 'ɛ m n a 
comptem	k o m t 'e m	 k o m p t 'e m 
compresa	k o m p ɾ 'e z a	 k o m p ɾ 'ɛ z a 
comprenen	k o m p ɾ 'e n e n	 k o m p ɾ 'ɛ n e n 
completa-la	k o m p l 'e t a l a	 k o m p l e t 'a l a 
comparsero	k o m p a ɾ s 'e ɾ o	 k o m p a ɾ s 'ɛ ɾ o 
cometre	k o m 'e t ɾ e	 k o m 'ɛ t ɾ e 
col·legues	k o l 'e ɣ e s	 k o l 'ɛ ɣ e s 
coloraines	k o l o ɾ 'a j n e s	 k o l o ɾ 'a i n e s 
cofoi	k o f 'ɔ j	 k o f 'o i 
coco	k 'o k o	 k 'ɔ k o 
cobren	k 'o β ɾ e n	 k 'ɔ β ɾ e n 
centígrads	s e n t 'i ɣ ɾ a t s	 s e n t i ɣ ɾ 'a ð s 
cents	s 'e n s	 s 'e n t s 
celebren	s e l 'e β ɾ e n	 s e l 'ɛ β ɾ e n 
cec	s 'e k	 s 'ɛ k 
cartaginesos	k a ɾ t a d ʒ i n 'e z o s	 k a ɾ t a d ʒ i n 'ɛ z o s 
carrego	k a r 'e ɣ o	 k a r 'ɛ ɣ o 
caribenya	k a ɾ i β 'e ɲ a	 k a ɾ i β 'ɛ ɲ a 
cards	k 'a ɾ t s	 k 'a ɾ i s 
carai	k a ɾ 'a j	 k a ɾ 'a i 
capmàs	k a b m 'a s	 k a p m 'a s 
capbussar	k a b b u s 'a ɾ	 k a p b u s 'a ɾ 
cants	k 'a n s	 k 'a n t s 
caigudes	k a j ɣ 'u ð e s	 k a i ɣ 'u ð e s 
búnquers	b 'u ŋ k e ɾ s	 b u ŋ k 'e ɾ s 
bàdminton	b 'a d m i n t o n	 b a d m i n t 'o n 
brots	b ɾ 'o t s	 b ɾ 'ɔ t s 
brollen	b ɾ 'o ʎ e n	 b ɾ 'ɔ ʎ e n 
bot	b 'o t	 b 'ɔ t 
borden	b 'o ɾ ð e n	 b 'ɔ ɾ ð e n 
bombolles	b o m b 'o ʎ e s	 b o m b 'ɔ ʎ e s 
bolquen	b 'o l k e n	 b 'ɔ l k e n 
boirina	b o j ɾ 'i n a	 b o i ɾ 'i n a 
bodegues	b o ð 'e ɣ e s	 b o ð 'ɛ ɣ e s 
beuen	b 'e w e n	 b 'ɛ w e n 
bes	b 'e s	 b 'ɛ s 
berenen	b e ɾ 'e n e n	 b e ɾ 'ɛ n e n 
atribuir-ho	a t ɾ i β w 'i ɾ o	 a t ɾ i β u i ɾ 'ɔ 
atesa	a t 'e z a	 a t 'ɛ z a 
assímptotes	a s 'i m t o t e s	 a s 'i m p t o t e s 
assaigs	a s 'a t ʃ s	 a s 'a i s 
assaborint-ne	a s a β o ɾ 'i n n e	 a s a β o ɾ 'i n d n e 
asimètrica	a s i m 'ɛ t ɾ i k a	 a z i m 'ɛ t ɾ i k a 
arribessin	a r i β 'e s i n	 a r i β 'ɛ s i n 
arregla	a r 'e ɣ l a	 a r 'ɛ ɣ l a 
aqüífer	a k w 'i f e ɾ	 a k 'i f e ɾ 
aproven	a p ɾ 'o v e n	 a p ɾ 'ɔ v e n 
apretar-me-les	a p ɾ e t 'a ɾ m e l e s	 a p ɾ e t a ɾ m 'ɛ l e s 
aportessin	a p o ɾ t 'e s i n	 a p o ɾ t 'ɛ s i n 
aparegueren	a p a ɾ e ɣ 'e ɾ e n	 a p a ɾ e ɣ 'ɛ ɾ e n 
anècdota	a n 'ɛ g d o t a	 a n e g d 'ɔ t a 
anguiles	a ŋ g 'i l e s	 a ŋ g u 'i l e s 
anessin	a n 'e s i n	 a n 'ɛ s i n 
alts	'a l s	 'a l t s 
alteren	a l t 'e ɾ e n	 a l t 'ɛ ɾ e n 
algebraic	a l d ʒ e β ɾ 'a j k	 a l d ʒ e β ɾ 'a i k 
alegre	a l 'e ɣ ɾ e	 a l 'ɛ ɣ ɾ e 
aixeco	a j ʃ 'e k o	 a j ʃ 'ɛ k o 
aixeca	a j ʃ 'e k a	 a j ʃ 'ɛ k a 
agrupa'ls	a ɣ ɾ 'u p a l s	 a ɣ ɾ u p 'a l s 
agrair-li	a ɣ ɾ a 'i ɾ l i	 a ɣ ɾ 'a i ɾ l i 
agafessin	a ɣ a f 'e s i n	 a ɣ a f 'ɛ s i n 
afecten	a f 'e k t e n	 a f 'ɛ k t e n 
adults	a ð 'u l s	 a ð 'u l t s 
adornen	a ð 'o ɾ n e n	 a ð 'ɔ ɾ n e n 
adequa	a ð 'e k w a	 a ð 'ɛ k w a 
aconsellen	a k o n s 'e ʎ e n	 a k o n s 'ɛ ʎ e n 
aconseguir-la	a k o n s e ɣ 'i ɾ l a	 a k o n s e ɣ u 'i ɾ l a 
aconseguint	a k o n s e ɣ 'i n t	 a k o n s e ɣ u 'i n t 
a	'a	 a 
Zürich	z u ɾ 'i k	 a w ɾ 'i k o 
Zagreb	z a ɣ ɾ 'e p	 z a ɣ ɾ 'ɛ p 
Xop	t ʃ 'o p	 t ʃ 'ɔ p 
Vicent	v i s 'ɛ n t	 v i s 'e n t 
Verneda	v e ɾ n 'e ð a	 v e ɾ n 'ɛ ð a 
Ve	v 'e	 v 'ɛ 
Vailets	v a j l 'e t s	 v a i l 'e t s 
Vaduz	v a ð 'u z	 v a ð 'u t 
Unesco	u n 'e s k o	 u n 'ɛ s k o 
Trodheim	t ɾ o ð 'e j m	 t ɾ o ð 'ɛ i m 
Trec	t ɾ 'e k	 t ɾ 'ɛ k 
Transport	t ɾ a n s p 'ɔ ɾ t	 t ɾ a n s p 'o ɾ t 
Tort	t 'ɔ ɾ t	 t 'o ɾ t 
Torno	t 'o ɾ n o	 t 'ɔ ɾ n o 
Thyssen	t 'i s e n	 t ɲ s 'ɛ n 
Te'n	t 'e n	 t 'ɛ n 
Te	t 'e	 t e 
Taipei	t a j p 'e j	 t a i p 'ɛ i 
T'ho	t 'o	 t 'i 
T'estimo	t a s t 'i m o	 t e s t 'i m o 
Sobre	s 'o β ɾ e	 s 'ɔ β ɾ e 
Sistemes	s i s t 'e m e s	 s i s t 'ɛ m e s 
Setze	s 'e d z e	 s 'ɛ d z e 
Serveis	s e ɾ v 'e j s	 s e ɾ v 'ɛ i s 
Selvas	s 'ɛ l v a s	 s e l v 'a s 
Se'l	s 'e l	 s 'ɛ l 
S'ho	s 'o	 s 'ɛ 
S'entén	s a n t 'e n	 s e n t 'e n 
S'embarquen	s a m b 'a ɾ k e n	 s e m b 'a ɾ k e n 
Rossellonesa	r o s e ʎ o n 'e z a	 r o s e ʎ o n 'ɛ z a 
Rodolen	r o ð 'o l e n	 r o ð 'ɔ l e n 
Remei	r e m 'e j	 r e m 'ɛ i 
Reintegrament	r e i n t e ɣ ɾ a m 'e n t	 r e 'i n t 'ɛ ɣ ɾ a m 'e n t 
Quedo	k 'e ð o	 k 'ɛ ð o 
Pladellorens	p l a ð e ʎ o ɾ 'e n s	 p l a ð e ʎ o ɾ 'ɛ n s 
Pingu	p 'i ŋ g u	 p 'i ŋ g w 
Perecamps	p e ɾ e k 'a m s	 p e ɾ e k 'a m p s 
Parpelleja	p a ɾ p e ʎ 'ɛ d ʒ a	 p a ɾ p e ʎ 'e d ʒ a 
Ordre	'o ɾ ð ɾ e	 'ɔ ɾ ð ɾ e 
Omple	'o m p l e	 'ɔ m p l e 
Nois	n 'ɔ j s	 n 'o i s 
Nogueira	n o ɣ 'e j ɾ a	 n o ɣ e 'i ɾ a 
Navega	n a v 'e ɣ a	 n a v 'ɛ ɣ a 
Nairobi	n a j ɾ 'ɔ β i	 n a i ɾ 'ɔ β i 
N'estripa	n a s t ɾ 'i p a	 n e s t ɾ 'i p a 
Munich	m u n 'i k	 m u n 'i s i 
Mossos	m 'o s o s	 m 'ɔ s o s 
Montseny	m o n s 'e ɲ	 m o n s 'ɛ ɲ 
Mesa	m 'e z a	 m 'ɛ z a 
Menja	m 'e n d ʒ a	 m 'ɛ n d ʒ a 
Marsellesa	m a ɾ s e ʎ 'e z a	 m a ɾ s e ʎ 'ɛ z a 
Légolas	l 'e ɣ o l a s	 l e ɣ o l 'a s 
Lo	l 'o	 l o 
Lluch	ʎ 'u k	 ʎ 'u k o 
Llevo	ʎ 'e v o	 ʎ 'ɛ v o 
Lisboa	l i z β 'o a	 l i z β 'ɔ a 
L'amiguisme	l a m i ɣ 'i z m e	 l a m i ɣ u 'i z m e 
L'Antoni	l a n t 'ɔ n i	 l a n t 'o n i 
Kinkel	k i ŋ k 'ɛ l	 d ʒ i n e 'ɛ l 
Killilea	k i ʎ i l 'e a	 s i ʎ i l 'e a 
Kenya	k 'e ɲ a	 k 'ɛ ɲ a 
Jofre	d ʒ 'o f ɾ e	 d ʒ 'ɔ f ɾ e 
Jeroni	d ʒ e ɾ 'ɔ n i	 d ʒ e ɾ 'o n i 
Jensen	d ʒ 'e n s e n	 d ʒ 'ɛ n s e n 
Ibarretxe	i β a r 'e t ʃ e	 i β a r 'ɛ t ʃ e 
Hug	'u k	 'a t ʃ 
Horta	'ɔ ɾ t a	 i ɾ t a 
Günther	g w n t 'e ɾ	 g u n t 'e ɾ 
Francesa	f ɾ a n s 'e z a	 f ɾ a n s 'ɛ z a 
Fluir	f l w 'i ɾ	 f l u 'i ɾ 
Floraina	f l o ɾ 'a j n a	 f l o ɾ a 'i n a 
Finestres	f i n 'e s t ɾ e s	 f i n 'ɛ s t ɾ e s 
Festes	f 'e s t e s	 f 'ɛ s t e s 
Festa	f 'e s t a	 f 'ɛ s t a 
Fent-ho	f 'e n t o	 f 'ɛ n t o 
Explica'ls	e k s p l 'i k a l s	 e k s p l i k 'a l s 
Espera'm	a s p 'e ɾ a m	 a s p e ɾ 'a m 
Escolta'm	a s k 'o l t a m	 a s k o l t 'a m 
Entren	'e n t ɾ e n	 ' a n t ɾ e n 
Elisenda	e l i z 'e n d a	 ɛ l i s 'ɛ n d a 
Elisabet	e l i z a β 'e t	 ɛ l i z a β 'e t 
Eindhoven	e j n d 'o v e n	 e 'i n d e v e n 
Ebre	'e β ɾ e	 'ɛ β ɾ e 
Ebre	'e β ɾ e	 'ɛ β ɾ e 
Disminuir	d i z m i n w 'i ɾ	 d i z m i n u 'i ɾ 
Diguem-ne	d i ɣ 'e m n e	 d i ɣ u 'ɛ m n e 
Detroit	d e t ɾ 'ɔ j t	 d e t ɾ o 'i t 
Darrere	d a r 'e ɾ e	 d a r 'ɛ ɾ e 
Cuina	k w 'i n a	 k 'u j n a 
Copia-la	k o p 'i a l a	 k o p i 'a l a 
Copa	k 'o p a	 k 'ɔ p a 
Construir	k o n s t ɾ w 'i ɾ	 k o n s t ɾ u 'i ɾ 
Consta	k 'o n s t a	 k 'ɔ n s t a 
Comptes	k 'o m t e s	 k 'ɔ m p t e s 
Compta	k 'o m t a	 k 'ɔ m p t a 
Comparseros	k o m p a ɾ s 'e ɾ o s	 k o m p a ɾ s 'ɛ ɾ o s 
Chirac	t ʃ i ɾ 'a k	 s i ɾ 'a k 
Cheng	t ʃ 'e ŋ k	 s 'ɛ ŋ g 
Carreras	k a r 'e ɾ a s	 k a r e ɾ 'a s 
Carnero	k a ɾ n 'e ɾ o	 k a ɾ n 'ɛ ɾ o 
Bohigas	b o 'i ɣ a s	 b o i ɣ 'a s 
Boeing	b o 'e j ŋ k	 b o e 'i ŋ k 
Bodes	b 'o ð e s	 b 'ɔ ð e s 
Bec	b 'e k	 b 'ɛ k 
Avisa'm	a v 'i z a m	 a v i z 'a m 
Aixeca	a j ʃ 'e k a	 a j ʃ 'ɛ k a 
Ai	'a j	 'a i 
Agenda	a d ʒ 'e n d a	 a d ʒ 'ɛ n d a 
Acosta't	a k 'ɔ s t a t	 a k o s t 'a t 
el	'e l	 'ɛ l 
carrega	k a r 'e ɣ a	 k a r 'ɛ ɣ a 
amb	'a m	 'a m b 
oi	'ɔ j	 'o i 
es	'e s	 e s 
el	'e l	 'ɛ l 
a	'a	 a 
Totes	t 'o t e s	 t 'ɔ t e s 
Si	s 'i	 s i 
N'està	n a s t 'a	 n e s t 'a 
Li	l 'i	 l i 
Ja	j 'a	 d ʒ 'a 
I	'i	 i 
Ho	'o	 o 
He	'e	 'ɛ 
Aquesta	a k 'e s t a	 a k 'ɛ s t a 
que	k 'e	 k e 
hi	'i	 i 
Si	s 'i	 s i 
Queda	k 'e ð a	 k 'ɛ ð a 
Ja	j 'a	 d ʒ 'a 
I	'i	 i 
He	'e	 'ɛ 
Compte	k 'o m t e	 k 'ɔ m p t e 
Amb	'a m	 'a m b 
zero	z 'e ɾ o	 z 'ɛ ɾ o 
xilens	t ʃ i l 'e n s	 t ʃ i l 'ɛ n s 
xerrameca	t ʃ e r a m 'e k a	 t ʃ e r a m 'ɛ k a 
xecs	t ʃ 'e k s	 t ʃ 'ɛ k s 
vuit	v w 'i t	 v i 'i t 
veto	v 'e t o	 v 'ɛ t o 
vendre'n	v 'e n d ɾ e n	 v e n d ɾ 'ɛ n 
venda	v 'e n d a	 v 'ɛ n d a 
ullals	u ʎ 'a l s	 u ʎ 'a s 
udol	u ð 'o l	 u ð 'ɔ l 
túnels	t 'u n e l s	 t u n 'ɛ l s 
txeca	t ʃ 'e k a	 t ʃ 'ɛ k a 
tropes	t ɾ 'o p e s	 t ɾ 'ɔ p e s 
treva	t ɾ 'e v a	 t ɾ 'ɛ v a 
trenquen	t ɾ 'e ŋ k e n	 t ɾ 'ɛ ŋ k e n 
tests	t 'e s t s	 t 'ɛ s t s 
temple	t 'e m p l e	 t 'ɛ m p l e 
tempestes	t e m p 'e s t e s	 t e m p 'ɛ s t e s 
tanquessin	t a ŋ k 'e s i n	 t a ŋ k 'ɛ s i n 
t'esquincen	t a s k 'i n s e n	 t e s k 'i n s e n 
t'espaviles	t a s p a v 'i l e s	 t e s p a v 'i l e s 
t'espantis	t a s p 'a n t i s	 t e s p 'a n t i s 
t'aixeques	t a j ʃ 'e k e s	 t a j ʃ 'ɛ k e s 
símbols	s 'i m b o l s	 s i m b 'ɔ l s 
sys	s 'i s	 s s 
suspens	s u s p 'e n s	 s u s p 'ɛ n s 
suec	s u 'e k	 s u 'ɛ k 
serenos	s e ɾ 'e n o s	 s e ɾ 'ɛ n o s 
semen	s 'e m e n	 s 'ɛ m e n 
seguides	s e ɣ 'i ð e s	 s e ɣ u 'i ð e s 
segles	s 'e ɣ l e s	 s 'ɛ ɣ l e s 
s'opta	s 'o p t a	 s 'ɔ p t a 
s'exposa	s e k s p 'ɔ z a	 s e k s p 'o z a 
s'executa	s e g z e k 'u t a	 s e k s e k 'u t a 
s'esmuny	s a z m 'u ɲ	 s e z m 'u ɲ 
s'escriguin	s a s k ɾ 'i ɣ i n	 s e s k ɾ 'i ɣ i n 
s'escindís	s a s i n d 'i s	 s e s i n d 'i s 
s'escampa	s a s k 'a m p a	 s e s k 'a m p a 
s'entenien	s a n t e n 'i e n	 s e n t e n 'i e n 
s'encongia	s a ŋ k o n d ʒ 'i a	 s e ŋ k o n d ʒ 'i a 
s'encarregaria	s a ŋ k a r e ɣ a ɾ 'i a	 s e ŋ k a r e ɣ a ɾ 'i a 
s'encallava	s a ŋ k a ʎ 'a v a	 s e ŋ k a ʎ 'a v a 
s'aboquen	s a β 'o k e n	 s a β 'ɔ k e n 
rústega	r 'u s t e ɣ a	 r u s t 'e ɣ a 
ruixats	r u j ʃ 'a t s	 r i ʃ 'a t s 
romanesa	r o m a n 'e z a	 r o m a n 'ɛ z a 
retrec	r e t ɾ 'e k	 r e t ɾ 'ɛ k 
ressort	r e s 'ɔ ɾ t	 r e s 'o ɾ t 
reproduir	r e p ɾ o ð w 'i ɾ	 r e p ɾ o ð u 'i ɾ 
rentessin	r e n t 'e s i n	 r e n t 'ɛ s i n 
remeten	r e m 'e t e n	 r e m 'ɛ t e n 
rellevants	r e ʎ e v 'a n s	 r e ʎ e v 'a n t s 
refreda	r e f ɾ 'e ð a	 r e f ɾ 'ɛ ð a 
provoquen	p ɾ o v 'o k e n	 p ɾ o v 'ɔ k e n 
protesto	p ɾ o t 'e s t o	 p ɾ o t 'ɛ s t o 
protesta	p ɾ o t 'e s t a	 p ɾ o t 'ɛ s t a 
promig	p ɾ o m 'i t ʃ	 p ɾ o m 'i d ʒ 
promig	p ɾ o m 'i t ʃ	 p ɾ o m 'i d ʒ 
promesa	p ɾ o m 'e z a	 p ɾ o m 'ɛ z a 
progressos	p ɾ o ɣ ɾ 'e s o s	 p ɾ o ɣ ɾ 'ɛ s o s 
pretenen	p ɾ e t 'e n e n	 p ɾ e t 'ɛ n e n 
presumptes	p ɾ e z 'u m t e s	 p ɾ e z 'u m p t e s 
presos	p ɾ 'e z o s	 p ɾ 'ɛ z o s 
presentessin	p ɾ e z e n t 'e s i n	 p ɾ e z e n t 'ɛ s i n 
presenta-me'l	p ɾ e z 'e n t a m e l	 p ɾ e z e n t a m 'ɛ l 
precoç	p ɾ e k 'ɔ s	 p ɾ e k 'o s 
portessin	p o ɾ t 'e s i n	 p o ɾ t 'ɛ s i n 
polze	p 'o l z e	 p 'ɔ l z e 
ple	p l 'e	 p l 'ɛ 
picotegen	p i k o t 'e d ʒ e n	 p i k o t 'ɛ d ʒ e n 
peto	p 'e t o	 p 'ɛ t o 
permeses	p e ɾ m 'e z e s	 p e ɾ m 'ɛ z e s 
perdre'n	p 'ɛ ɾ ð ɾ e n	 p e ɾ ð ɾ 'ɛ n 
orquestra	o ɾ k 'e s t ɾ a	 o ɾ k 'ɛ s t ɾ a 
orgulls	o ɾ ɣ 'u ʎ s	 ɔ ɾ ɣ 'u ʎ s 
opten	'o p t e n	 'ɔ p t e n 
omplen	'o m p l e n	 'ɔ m p l e n 
numero	n u m 'e ɾ o	 n u m 'ɛ ɾ o 
noblesa	n o β l 'e z a	 n o β l 'ɛ z a 
n'estan	n a s t 'a n	 n e s t 'a n 
n'anessin	n a n 'e s i n	 n a n 'ɛ s i n 
n'Edgard	n e d g 'a ɾ t	 n e ð ɣ 'a ɾ t 
motos	m 'o t o s	 m 'ɔ t o s 
montesa	m o n t 'e z a	 m o n t 'ɛ z a 
mirant-ne	m i ɾ 'a n n e	 m i ɾ 'a n d n e 
milloren	m i ʎ 'o ɾ e n	 m i ʎ 'ɔ ɾ e n 
mescla	m 'e s k l a	 m 'ɛ s k l a 
mantega	m a n t 'e ɣ a	 m a n t 'ɛ ɣ a 
maleint-me	m a l e 'i m m e	 m a l 'ɛ i n d m e 
maharajàs	m a a ɾ a d ʒ 'a s	 m a w a ɾ a d ʒ 'a s 
maduixer	m a ð u j ʃ 'e ɾ	 m a ð u i ʃ 'e ɾ 
lucidesa	l u s i ð 'e z a	 l u s i ð 'ɛ z a 
lluiten	ʎ w 'i t e n	 ʎ 'u i t e n 
lluir	ʎ w 'i ɾ	 ʎ u 'i ɾ 
llestos	ʎ 'e s t o s	 ʎ 'ɛ s t o s 
llesques	ʎ 'e s k e s	 ʎ 'ɛ s k e s 
llebre	ʎ 'e β ɾ e	 ʎ 'ɛ β ɾ e 
llampants	ʎ a m p 'a n s	 ʎ a m p 'a n t s 
lents	l 'e n s	 l 'e n t s 
l'anècdota	l a n 'ɛ g d o t a	 l a n e g d 'ɔ t a 
jazz	d ʒ 'a s	 d ʒ 'a z i 
interpreto	i n t e ɾ p ɾ 'e t o	 i n t e ɾ p ɾ 'ɛ t o 
insolvents	i n s o l v 'e n s	 i n s o l v 'e n t s 
ingressos	i ŋ g ɾ 'e s o s	 i ŋ g ɾ 'ɛ s o s 
incloent-hi	i ŋ k l o 'e n t i	 i ŋ k l o 'ɛ n t i 
hàgim	'a d ʒ i m	 'ɔ d ʒ i m 
guèiser	g 'ɛ j z e ɾ	 g 'ɛ i z e ɾ 
gresca	g ɾ 'e s k a	 g ɾ 'ɛ s k a 
glops	g l 'o p s	 g l 'ɔ p s 
ginebra	d ʒ i n 'e β ɾ a	 d ʒ i n 'ɛ β ɾ a 
gemma	d ʒ 'e m m a	 d ʒ 'ɛ m m a 
futbolística	f u d b o l 'i s t i k a	 f u t b o l 'i s t i k a 
futbolistes	f u d b o l 'i s t e s	 f u t b o l 'i s t e s 
fregues	f ɾ 'e ɣ e s	 f ɾ 'ɛ ɣ e s 
fondre's	f 'o n d ɾ e s	 f o n d ɾ 'ɛ s 
fluida	f l w 'i ð a	 f l s 'i ð a 
fixa't	f 'i k s a t	 f i k s 'a t 
fessin	f 'e s i n	 f 'ɛ s i n 
fer-los	f 'e ɾ l o s	 f 'ɛ ɾ l o s 
fer-les	f 'e ɾ l e s	 f 'ɛ ɾ l e s 
fent-los	f 'e n l o s	 f 'ɛ n d l o s 
fent-la	f 'e n l a	 f 'ɛ n t l a 
feina	f 'e j n a	 f 'ɛ j n a 
febre	f 'e β ɾ e	 f 'ɛ β ɾ e 
febles	f 'e β l e s	 f 'ɛ β l e s 
extremes	e k s t ɾ 'e m e s	 e k s t ɾ 'ɛ m e s 
exemple	e g z 'e m p l e	 e g z 'ɛ m p l e 
excessos	e k s 'e s o s	 e k s 'ɛ s o s 
etc	'e t k	 'ɛ t k 
estupidesa	a s t u p i ð 'e z a	 a s t u p i ð 'ɛ z a 
estrateg	a s t ɾ a t 'e k	 a s t ɾ a t 'ɛ g 
esperdenyes	a s p e ɾ ð 'e ɲ e s	 a s p e ɾ ð 'ɛ ɲ e s 
eso	'e s o	 'ɛ z o 
escolten	a s k 'o l t e n	 a s k 'ɔ l t e n 
entendre'l	a n t 'e n d ɾ e l	 a n t e n d ɾ 'ɛ l 
ensenyen	a n s 'e ɲ e n	 a n s 'ɛ ɲ e n 
engegar-ho	a n d ʒ e ɣ 'a ɾ o	 a n d ʒ e ɣ 'a ɾ e 
enganxant-ne	a ŋ g a n t ʃ 'a n n e	 a ŋ g a n t ʃ 'a n d n e 
ene	'e n e	 'ɛ n e 
endarrere	a n d a r 'e ɾ e	 a n d a r 'ɛ ɾ e 
encesos	a n s 'e z o s	 a n s 'ɛ z o s 
empeny	a m p 'e ɲ	 a m p 'ɛ ɲ 
ego	'e ɣ o	 'ɛ ɣ o 
dutxant-me	d u t ʃ 'a m m e	 d u t ʃ 'a n d m e 
duresa	d u ɾ 'e z a	 d u ɾ 'ɛ z a 
dolços	d 'o l s o s	 d 'ɔ l s o s 
distribuir-la	d i s t ɾ i β w 'i ɾ l a	 d i s t ɾ i β i 'i ɾ l a 
discorre	d i s k 'o r e	 d i s k 'ɔ r e 
devoro	d e v 'o ɾ o	 d e v 'ɔ ɾ o 
despeses	d e s p 'e z e s	 d e s p 'ɛ z e s 
despesa	d e s p 'e z a	 d e s p 'ɛ z a 
deshonest	d e s o n 'e s t	 d e z o n 'ɛ s t 
desfer-me	d e s f 'e ɾ m e	 d e s f 'ɛ ɾ m e 
desdobla	d e z ð 'o β l a	 d e z ð 'ɔ β l a 
desapareguessin	d e z a p a ɾ e ɣ 'e s i n	 d e z a p a ɾ e ɣ 'ɛ s i n 
deixem-ho	d e j ʃ 'e m o	 d e j ʃ 'ɛ m o 
deduir	d e ð w 'i ɾ	 d e ð u 'i ɾ 
dec	d 'e k	 d 'ɛ k 
d'oasi	d o 'a z i	 d o 'a s i 
cuiro	k w 'i ɾ o	 k 'u j ɾ o 
creï	k ɾ 'e i	 k ɾ 'ɛ i 
coses	k 'ɔ z e s	 k 'o z e s 
contrincants	k o n t ɾ i ŋ k 'a n s	 k o n t ɾ i ŋ k 'a n t s 
contempla	k o n t 'e m p l a	 k o n t 'ɛ m p l a 
consideren	k o n s i ð 'e ɾ e n	 k o n s i ð 'ɛ ɾ e n 
conduint	k o n d w 'i n t	 k o n d u 'i n t 
comptant	k o m t 'a n t	 k o m p t 'a n t 
comprovi'l	k o m p ɾ 'ɔ v i l	 k o m p ɾ o v 'i l 
compost	k o m p 'ɔ s t	 k o m p 'o s t 
cometen	k o m 'e t e n	 k o m 'ɛ t e n 
cega	s 'e ɣ a	 s 'ɛ ɣ a 
carreguen	k a r 'e ɣ e n	 k a r 'ɛ ɣ e n 
calb	k 'a l p	 k 'a l i 
caiguts	k a j ɣ 'u t s	 k a i ɣ 'u t s 
caiguin	k 'a j ɣ i n	 k 'a i ɣ i n 
cabirol	k a β i ɾ 'o l	 k a β i ɾ 'ɔ l 
bomba	b 'o m b a	 b 'ɔ m b a 
bistecs	b i s t 'e k s	 b i s t 'ɛ k s 
be	b 'e	 b 'ɛ 
atendre'l	a t 'e n d ɾ e l	 a t e n d ɾ 'ɛ l 
ascens	a s 'e n s	 a s 'ɛ n s 
arruinada	a r w i n 'a ð a	 a r i i n 'a ð a 
arenga	a ɾ 'e ŋ g a	 a ɾ 'ɛ ŋ g a 
aplec	a p l 'e k	 a p l 'ɛ k 
almívar	a l m 'i v a ɾ	 a l m i v 'a ɾ 
afronten	a f ɾ 'o n t e n	 a f ɾ 'ɔ n t e n 
advoquen	a d v 'o k e n	 a d v 'ɔ k e n 
adolescents	a ð o l e s 'e n s	 a ð o l e s 'e n t s 
actuïn	a k t 'u i n	 a k t u 'i n 
Virrei	v i r 'e j	 v i r 'ɛ i 
Verds	v 'ɛ ɾ t s	 v 'ɛ ɾ i s 
Teresa	t e ɾ 'e z a	 t e ɾ 'ɛ z a 
Telefónica	t e l e f 'o n i k a	 t e l e f o n 'i k a 
Sens	s 'e n s	 s 'ɛ n s 
Se'n	s 'e n	 s 'ɛ n 
S'endinsen	s a n d 'i n s e n	 s e n d 'i n s e n 
S'aixeca	s a j ʃ 'e k a	 s a j ʃ 'ɛ k a 
Ruth	r 'u t	 r 'u t i 
Remeno	r e m 'e n o	 r e m 'ɛ n o 
Presa	p ɾ 'e z a	 p ɾ 'ɛ z a 
Plataforma	p l a t a f 'o ɾ m a	 p l a t a f 'ɔ ɾ m a 
Parisien	p a ɾ i z 'i e n	 p a ɾ i s 'i e n 
Nen	n 'e n	 n 'ɛ n 
N'Édgar	n 'e d g a ɾ	 n e d ɣ 'a ɾ 
N'he	n 'e	 n 'ɛ 
N'està	n a s t 'a	 n e s t 'a 
Montevideo	m o n t e v i ð 'e o	 m o n t e v i ð 'ɛ o 
Mestre	m 'e s t ɾ e	 m 'ɛ s t ɾ e 
Mes	m 'e s	 m 'ɛ s 
Líban	l 'i β a n	 l i β 'a n 
Lègolas	l 'ɛ ɣ o l a s	 l e ɣ o l 'a s 
Le	l 'e	 l 'ɛ 
L'hora	l 'ɔ ɾ a	 a 'o ɾ a 
Janeiro	d ʒ a n 'e j ɾ o	 d ʒ a n e 'i ɾ o 
Hèlsinki	'ɛ l s i ŋ k i	 'a l s i n i 
Huc	'u k	 'a k 
Hisenda	i z 'e n d a	 i s 'ɛ n d a 
Grenoble	g ɾ e n 'o β l e	 g ɾ e n 'ɔ β l e 
Folch	f 'o l k	 f 'o l s e 
Endreço	a n d ɾ 'e s o	 a n d ɾ 'ɛ s o 
Dona'm	d 'ɔ n a m	 d o n 'a m 
Deixem-ho	d e j ʃ 'e m o	 d e j ʃ 'ɛ m o 
Contra	k 'o n t ɾ a	 k 'ɔ n t ɾ a 
Contesta	k o n t 'e s t a	 k o n t 'ɛ s t a 
Compto	k 'o m t o	 k 'ɔ m p t o 
Carrega	k a r 'e ɣ a	 k a r 'ɛ ɣ a 
COCO	k 'o k o	 k 'ɔ k o 
Ben	b 'e n	 b 'ɛ n 
Beirut	b e j ɾ 'u t	 b e i ɾ 'u t 
Acosta-t'hi	a k 'ɔ s t a t i	 a k o s t 'a t i 
