alcoià	a l k o j 'a
Alcoià	a l k o j 'a
angoixa	a ŋ g 'o j ʃ a
angoixada	a ŋ g o j ʃ 'a ð a
angoixades	a ŋ g o j ʃ 'a ð e s
angoixant	a ŋ g o j ʃ 'a n t
angoixar	a ŋ g o j ʃ 'a ɾ
angoixat	a ŋ g o j ʃ 'a t
angoixats	a ŋ g o j ʃ 'a t s
angoixós	a ŋ g o j ʃ 'o s
boiar	b o j 'a ɾ
boicotejada	b o j k o t e d ʒ 'a ð a
boicotejades	b o j k o t e d ʒ 'a ð e s
boicotejar	b o j k o t e d ʒ 'a ɾ
boicotejat	b o j k o t e d ʒ 'a t
boicotejats	b o j k o t e d ʒ 'a t s
boirina	b o j ɾ 'i n a
boirós	b o j ɾ 'o s
boirum	b o j ɾ 'u m
boix	b 'o j ʃ
boixac	b o j ʃ 'a k
boixerica	b o j ʃ e ɾ 'i k a
boixerola	b o j ʃ e ɾ 'ɔ l a
broix	b ɾ 'o j ʃ
coiot	k o j 'ɔ t
coix	k 'o j ʃ
coixejada	k o j ʃ e d ʒ 'a ð a
coixejades	k o j ʃ e d ʒ 'a ð e s
coixejar	k o j ʃ e d ʒ 'a ɾ
coixejat	k o j ʃ e d ʒ 'a t
coixejats	k o j ʃ e d ʒ 'a t s
coixí	k o j ʃ 'i
emboirar	a m b o j ɾ 'a ɾ
encoixinar	a ŋ k o j ʃ i n 'a ɾ
encoixir	a ŋ k o j ʃ 'i ɾ
Foix	f 'o j ʃ
joier	d ʒ o j 'e ɾ
joieria	d ʒ o j e ɾ 'i a
joiós	d ʒ o j 'o s
Moià	m o j 'a
moix	m 'o j ʃ
moixaina	m o j ʃ 'a j n a
moixama	m o j ʃ 'a m a
moixí	m o j ʃ 'i
moixina	m o j ʃ 'i n a
moixó	m o j ʃ 'o
noieta	n o j 'e t a
toix	t 'o j ʃ
troià	t ɾ o j 'a
coixí	k o j ʃ 'i
boixedes	b o j ʃ 'e ð e s
moix	m 'o j ʃ
coixa	k 'o j ʃ a
boirum	b o j ɾ 'u m
boirina	b o j ɾ 'i n a
angoixós	a ŋ g o j ʃ 'o s
angoixa	a ŋ g 'o j ʃ a
Boix	b 'o j ʃ
moixetes	m o j ʃ 'e t e s
encoixinades	a ŋ k o j ʃ i n 'a ð e s
angoixosos	a ŋ g o j ʃ 'o z o s
