abaixa	a β 'a j ʃ a
abaixà	a β a j ʃ 'a
abaixada	a β a j ʃ 'a ð a
abaixades	a β a j ʃ 'a ð e s
abaixant	a β a j ʃ 'a n t
abaixar	a β a j ʃ 'a ɾ
abaixarà	a β a j ʃ a ɾ 'a
abaixaran	a β a j ʃ a ɾ 'a n
abaixaràs	a β a j ʃ a ɾ 'a s
abaixaré	a β a j ʃ a ɾ 'e
abaixàrem	a β a j ʃ 'a ɾ e m
abaixaren	a β a j ʃ 'a ɾ e n
abaixares	a β a j ʃ 'a ɾ e s
abaixàreu	a β a j ʃ 'a ɾ e w
abaixaria	a β a j ʃ a ɾ 'i a
abaixaríem	a β a j ʃ a ɾ 'i e m
abaixarien	a β a j ʃ a ɾ 'i e n
abaixaries	a β a j ʃ a ɾ 'i e s
abaixaríeu	a β a j ʃ a ɾ 'i e w
abaixat	a β a j ʃ 'a t
abaixats	a β a j ʃ 'a t s
abaixava	a β a j ʃ 'a v a
abaixàvem	a β a j ʃ 'a v e m
abaixaven	a β a j ʃ 'a v e n
abaixaves	a β a j ʃ 'a v e s
abaixàveu	a β a j ʃ 'a v e w
abaixen	a β 'a j ʃ e n
abaixes	a β 'a j ʃ e s
abaixés	a β a j ʃ 'e s
abaixéssim	a β a j ʃ 'e s i m
abaixéssiu	a β a j ʃ 'e s i w
abaixi	a β 'a j ʃ i
abaixí	a β a j ʃ 'i
abaixin	a β 'a j ʃ i n
abaixis	a β 'a j ʃ i s
abaixo	a β 'a j ʃ o
abellaire	a β e ʎ 'a j ɾ e
Acaia	a k 'a j a
Adelaida	a ð e l 'a j ð a
afaiçonar	a f a j s o n 'a ɾ
afaitada	a f a j t 'a ð a
afaitades	a f a j t 'a ð e s
afaitar	a f a j t 'a ɾ
afaitat	a f a j t 'a t
afaitats	a f a j t 'a t s
ai	'a j
aiatol·là	a j a t o l 'a
Àiax	'a j a k s
aidada	a j ð 'a ð a
aidades	a j ð 'a ð e s
aidant	a j ð 'a n t
aidar	a j ð 'a ɾ
aidat	a j ð 'a t
aidats	a j ð 'a t s
Aina	'a j n a
aire	'a j ɾ e
airejar	a j ɾ e d ʒ 'a ɾ
airejós	a j ɾ e d ʒ 'o s
aires	'a j ɾ e s
aixà	a j ʃ 'a
aixada	a j ʃ 'a ð a
aixades	a j ʃ 'a ð e s
aixafada	a j ʃ a f 'a ð a
aixafades	a j ʃ a f 'a ð e s
aixafaguitarres	a j ʃ a f a ɣ i t 'a r e s
aixafant	a j ʃ a f 'a n t
aixafar	a j ʃ a f 'a ɾ
aixafat	a j ʃ a f 'a t
aixafats	a j ʃ a f 'a t s
aixana	a j ʃ 'a n a
aixaragallar	a j ʃ a ɾ a ɣ a ʎ 'a ɾ
aixatar	a j ʃ a t 'a ɾ
aixecada	a j ʃ e k 'a ð a
aixecades	a j ʃ e k 'a ð e s
aixecament	a j ʃ e k a m 'e n t
aixecar	a j ʃ e k 'a ɾ
aixecat	a j ʃ e k 'a t
aixecats	a j ʃ e k 'a t s
aixella	a j ʃ 'e ʎ a
aixeta	a j ʃ 'e t a
així	a j ʃ 'i
aixina	a j ʃ 'i n a
aixís	a j ʃ 'i s
això	a j ʃ 'ɔ
aixopluc	a j ʃ o p l 'u k
Alboraia	a l β o ɾ 'a j a
algebraic	a l d ʒ e β ɾ 'a j k
Altai	a l t 'a j
altaic	a l t 'a j k
amainada	a m a j n 'a ð a
amainades	a m a j n 'a ð e s
amainant	a m a j n 'a n t
amainar	a m a j n 'a ɾ
amainat	a m a j n 'a t
amainats	a m a j n 'a t s
ambaixada	a m b a j ʃ 'a ð a
ambaixades	a m b a j ʃ 'a ð e s
ambaixador	a m b a j ʃ a ð 'o ɾ
apaivagada	a p a j v a ɣ 'a ð a
apaivagades	a p a j v a ɣ 'a ð e s
apaivagant	a p a j v a ɣ 'a n t
apaivagar	a p a j v a ɣ 'a ɾ
apaivagat	a p a j v a ɣ 'a t
apaivagats	a p a j v a ɣ 'a t s
arcaic	a ɾ k 'a j k
arcaica	a ɾ k 'a j k a
arcaics	a ɾ k 'a j k s
arcaiques	a ɾ k 'a j k e s
atalaiar	a t a l a j 'a ɾ
atraient	a t ɾ a j 'e n t
bai	b 'a j
baia	b 'a j a
baietó	b a j e t 'o
baila	b 'a j l a
baix	b 'a j ʃ
baixa	b 'a j ʃ a
baixada	b a j ʃ 'a ð a
baixades	b a j ʃ 'a ð e s
baixamar	b a j ʃ a m 'a ɾ
baixant	b a j ʃ 'a n t
baixar	b a j ʃ 'a ɾ
baixat	b a j ʃ 'a t
baixats	b a j ʃ 'a t s
baixíssim	b a j ʃ 'i s i m
baixista	b a j ʃ 'i s t a
baixistes	b a j ʃ 'i s t e s
baixos	b 'a j ʃ o s
balaix	b a l 'a j ʃ
barrinaire	b a r i n 'a j ɾ e
bastaix	b a s t 'a j ʃ
becaina	b e k 'a j n a
becaines	b e k 'a j n e s
biaix	b i 'a j ʃ
Biscaia	b i s k 'a j a
Blai	b l 'a j
boletaire	b o l e t 'a j ɾ e
botzinaire	b o d z i n 'a j ɾ e
caiac	k a j 'a k
caient	k a j 'e n t
caiguda	k a j ɣ 'u ð a
caigudes	k a j ɣ 'u ð e s
caigut	k a j ɣ 'u t
caiguts	k a j ɣ 'u t s
Caire	k 'a j ɾ e
caire	k 'a j ɾ e
caires	k 'a j ɾ e s
caironada	k a j ɾ o n 'a ð a
caironades	k a j ɾ o n 'a ð e s
caironat	k a j ɾ o n 'a t
caironats	k a j ɾ o n 'a t s
caiuc	k a j 'u k
caixa	k 'a j ʃ a
caixabanc	k a j ʃ a β 'a ŋ k
caixer	k a j ʃ 'e ɾ
caixes	k 'a j ʃ e s
Caixmir	k a j ʃ m 'i ɾ
caixmir	k a j ʃ m 'i ɾ
caixubi	k a j ʃ 'u β i
calaix	k a l 'a j ʃ
calaixos	k a l 'a j ʃ o s
carcaix	k a ɾ k 'a j ʃ
cardaire	k a ɾ ð 'a j ɾ e
carrilaire	k a r i l 'a j ɾ e
carronyaire	k a r o ɲ 'a j ɾ e
ciberespai	s i β e ɾ e s p 'a j
ciberespais	s i β e ɾ e s p 'a j s
Cirenaica	s i ɾ e n 'a j k a
cupaire	k u p 'a j ɾ e
cupaires	k u p 'a j ɾ e s
daina	d 'a j n a
daixò	d a j ʃ 'ɔ
daixonses	d a j ʃ 'ɔ n s e s
dansaire	d a n s 'a j ɾ e
dansaires	d a n s 'a j ɾ e s
desmai	d e z m 'a j
desmaiar	d e z m a j 'a ɾ
dolçaina	d o l s 'a j n a
drapaire	d ɾ a p 'a j ɾ e
embaietar	a m b a j e t 'a ɾ
empait	a m p 'a j t
empaitar	a m p a j t 'a ɾ
encaix	a ŋ k 'a j ʃ
encaixada	a ŋ k a j ʃ 'a ð a
encaixades	a ŋ k a j ʃ 'a ð e s
encaixar	a ŋ k a j ʃ 'a ɾ
encaixat	a ŋ k a j ʃ 'a t
encaixats	a ŋ k a j ʃ 'a t s
enlairament	a n l a j ɾ a m 'e n t
enlaire	a n l 'a j ɾ e
escairada	a s k a j ɾ 'a ð a
escairades	a s k a j ɾ 'a ð e s
escairar	a s k a j ɾ 'a ɾ
escairat	a s k a j ɾ 'a t
escairats	a s k a j ɾ 'a t s
escaire	a s k 'a j ɾ e
esglai	a z ɣ l 'a j
esglaiada	a z ɣ l a j 'a ð a
esglaiades	a z ɣ l a j 'a ð e s
esglaiar	a z ɣ l a j 'a ɾ
esglaiat	a z ɣ l a j 'a t
esglaiats	a z ɣ l a j 'a t s
esmaixada	a z m a j ʃ 'a ð a
esmaixar	a z m a j ʃ 'a ɾ
espai	a s p 'a j
espaiador	a s p a j a ð 'o ɾ
espaiar	a s p a j 'a ɾ
espaiat	a s p a j 'a t
espaiós	a s p a j 'o s
espais	a s p 'a j s
esplai	a s p l 'a j
esplaiada	a s p l a j 'a ð a
esplaiades	a s p l a j 'a ð e s
esplaiar	a s p l a j 'a ɾ
esplaiat	a s p l a j 'a t
esplaiats	a s p l a j 'a t s
esquaix	a s k w 'a j ʃ
estai	a s t 'a j
faisà	f a j z 'a
faixa	f 'a j ʃ a
festaire	f e s t 'a j ɾ e
flairada	f l a j ɾ 'a ð a
flairades	f l a j ɾ 'a ð e s
flairar	f l a j ɾ 'a ɾ
flairat	f l a j ɾ 'a t
flairats	f l a j ɾ 'a t s
flaire	f l 'a j ɾ e
flairós	f l a j ɾ 'o s
flaix	f l 'a j ʃ
fotovoltaic	f o t o v o l t 'a j k
fotovoltaica	f o t o v o l t 'a j k a
fotovoltaics	f o t o v o l t 'a j k s
fotovoltaiques	f o t o v o l t 'a j k e s
gai	g 'a j
gaia	g 'a j a
gaiata	g a j 'a t a
gaiato	g a j 'a t o
gaies	g 'a j e s
gaire	g 'a j ɾ e
gairebé	g a j ɾ e β 'e
gaires	g 'a j ɾ e s
gaita	g 'a j t a
gaiter	g a j t 'e ɾ
galindaina	g a l i n d 'a j n a
galindaines	g a l i n d 'a j n e s
guai	g w 'a j
guaiaba	g w a j 'a β a
Guaiana	g w a j 'a n a
guaita	g w 'a j t a
guaità	g w a j t 'a
guaitar	g w a j t 'a ɾ
guaitat	g w a j t 'a t
guaito	g w 'a j t o
guaixar	g w a j ʃ 'a ɾ
guixaire	g i ʃ 'a j ɾ e
Haia	'a j a
Hainan	a j n 'a n
Hainaut	a j n 'a w t
Haití	a j t 'i
haixix	a j ʃ 'i ʃ
hebraic	e β ɾ 'a j k
hiperespai	i p e ɾ e s p 'a j
hiperespais	i p e ɾ e s p 'a j s
iaia	j 'a j a
iaies	j 'a j e s
iaio	j 'a j o
incaic	i ŋ k 'a j k
jamai	d ʒ a m 'a j
Jamaica	d ʒ a m 'a j k a
joguinaire	d ʒ o ɣ i n 'a j ɾ e
juntaire	d ʒ u n t 'a j ɾ e
kàiser	k 'a j z e ɾ
Laia	l 'a j a
laic	l 'a j k
laica	l 'a j k a
laiques	l 'a j k e s
llangardaix	ʎ a ŋ g a ɾ ð 'a j ʃ
mai	m 'a j
maia	m 'a j a
maial	m a j 'a l
maies	m 'a j e s
maimó	m a j m 'o
mainada	m a j n 'a ð a
maixella	m a j ʃ 'e ʎ a
malai	m a l 'a j
malaia	m a l 'a j a
malaies	m a l 'a j e s
malais	m a l 'a j s
malaisi	m a l 'a j z i
Malàisia	m a l 'a j z i a
malgaix	m a l ɣ 'a j ʃ
marraix	m a r 'a j ʃ
marraixa	m a r 'a j ʃ a
matajaia	m a t a d ʒ 'a j a
minaire	m i n 'a j ɾ e
minairó	m i n a j ɾ 'o
moixaina	m o j ʃ 'a j n a
mosaic	m o z 'a j k
mossegaire	m o s e ɣ 'a j ɾ e
nàiada	n 'a j a ð a
naip	n 'a j p
naixement	n a j ʃ e m 'e n t
naixença	n a j ʃ 'e n s a
nàixer	n 'a j ʃ e ɾ
pailó	p a j l 'o
paio	p 'a j o
paiol	p a j 'o l
pairal	p a j ɾ 'a l
paixà	p a j ʃ 'a
palaia	p a l 'a j a
papagai	p a p a ɣ 'a j
papaia	p a p 'a j a
parlaire	p a ɾ l 'a j ɾ e
parlotaire	p a ɾ l o t 'a j ɾ e
pescaire	p e s k 'a j ɾ e
preufetaire	p ɾ e w f e t 'a j ɾ e
rabassaire	r a β a s 'a j ɾ e
rai	r 'a j
rail	r 'a j l
raima	r 'a j m a
rapinyaire	r a p i ɲ 'a j ɾ e
rebaix	r e β 'a j ʃ
rebaixa	r e β 'a j ʃ a
rebaixada	r e β a j ʃ 'a ð a
rebaixades	r e β a j ʃ 'a ð e s
rebaixador	r e β a j ʃ a ð 'o ɾ
rebaixar	r e β a j ʃ 'a ɾ
rebaixat	r e β a j ʃ 'a t
rebaixats	r e β a j ʃ 'a t s
recaiguda	r e k a j ɣ 'u ð a
recaigudes	r e k a j ɣ 'u ð e s
renaixement	r e n a j ʃ e m 'e n t
Renaixença	r e n a j ʃ 'e n s a
renaixentista	r e n a j ʃ e n t 'i s t a
renyaire	r e ɲ 'a j ɾ e
rimaia	r i m 'a j a
rondallaire	r o n d a ʎ 'a j ɾ e
rondinaire	r o n d i n 'a j ɾ e
ronsejaire	r o n s e d ʒ 'a j ɾ e
sainet	s a j n 'e t
salsitxaire	s a l s i t ʃ 'a j ɾ e
somorgollaire	s o m o ɾ ɣ o ʎ 'a j ɾ e
soscaire	s o s k 'a j ɾ e
tabacaire	t a β a k 'a j ɾ e
tailandesa	t a j l a n d 'e z a
Tailàndia	t a j l 'a n d i a
talaia	t a l 'a j a
terrissaire	t e r i s 'a j ɾ e
torraina	t o r 'a j n a
trinxeraire	t ɾ i n t ʃ e ɾ 'a j ɾ e
txagatai	t ʃ a ɣ a t 'a j
vailet	v a j l 'e t
vainilla	v a j n 'i ʎ a
vainilles	v a j n 'i ʎ e s
vaire	v 'a j ɾ e
vairescut	v a j ɾ e s k 'u t
vaiverejar	v a j v e ɾ e d ʒ 'a ɾ
vaixell	v a j ʃ 'e ʎ
vaixella	v a j ʃ 'e ʎ a
vistaire	v i s t 'a j ɾ e
xai	t ʃ 'a j
xaira	t ʃ 'a j ɾ a
Xangai	t ʃ a ŋ g 'a j
Zaire	z 'a j ɾ e
això	a j ʃ 'ɔ
mai	m 'a j
així	a j ʃ 'i
gairebé	g a j ɾ e β 'e
Això	a j ʃ 'ɔ
gaire	g 'a j ɾ e
baix	b 'a j ʃ
baixar	b a j ʃ 'a ɾ
Baix	b 'a j ʃ
espai	a s p 'a j
l'aire	l 'a j ɾ e
caixa	k 'a j ʃ a
Així	a j ʃ 'i
Mai	m 'a j
baixa	b 'a j ʃ a
gaires	g 'a j ɾ e s
espais	a s p 'a j s
d'això	d a j ʃ 'ɔ
caixes	k 'a j ʃ e s
s'aixeca	s a j ʃ 'e k a
aire	'a j ɾ e
calaix	k a l 'a j ʃ
caigut	k a j ɣ 'u t
Gairebé	g a j ɾ e β 'e
enlaire	a n l 'a j ɾ e
baixos	b 'a j ʃ o s
baixes	b 'a j ʃ e s
d'aire	d 'a j ɾ e
caigui	k 'a j ɣ i
vaixell	v a j ʃ 'e ʎ
rebaixes	r e β 'a j ʃ e s
baixant	b a j ʃ 'a n t
aixecar	a j ʃ e k 'a ɾ
calaixera	k a l a j ʃ 'e ɾ a
caiguda	k a j ɣ 'u ð a
baixi	b 'a j ʃ i
baixen	b 'a j ʃ e n
naixement	n a j ʃ e m 'e n t
drapaire	d ɾ a p 'a j ɾ e
calaixos	k a l 'a j ʃ o s
baixada	b a j ʃ 'a ð a
aimara	a j m 'a ɾ a
Caixa	k 'a j ʃ a
Baixa	b 'a j ʃ a
Abaixa	a β 'a j ʃ a
rebaixar	r e β a j ʃ 'a ɾ
rebaixa	r e β 'a j ʃ a
desmai	d e z m 'a j
baixà	b a j ʃ 'a
aixequem	a j ʃ e k 'e m
L'aire	l 'a j ɾ e
xai	t ʃ 'a j
vaixells	v a j ʃ 'e ʎ s
tulaines	t u l 'a j n e s
s'enlairaria	s a n l a j ɾ a ɾ 'i a
s'aixequen	s a j ʃ 'e k e n
s'aixecà	s a j ʃ e k 'a
s'aixecava	s a j ʃ e k 'a v a
renaixentistes	r e n a j ʃ e n t 'i s t e s
rails	r 'a j l s
nàixer	n 'a j ʃ e ɾ
naixés	n a j ʃ 'e s
naixent	n a j ʃ 'e n t
naips	n 'a j p s
mosaic	m o z 'a j k
maixella	m a j ʃ 'e ʎ a
l'ambaixada	l a m b a j ʃ 'a ð a
l'algebraic	l a l d ʒ e β ɾ 'a j k
jamaicà	d ʒ a m a j k 'a
jamaicans	d ʒ a m a j k 'a n s
guaix	g w 'a j ʃ
guacamais	g w a k a m 'a j s
gairell	g a j ɾ 'e ʎ
flaire	f l 'a j ɾ e
faixa	f 'a j ʃ a
esglai	a z ɣ l 'a j
escaigui	a s k 'a j ɣ i
deltaic	d e l t 'a j k
d'aixafar-me	d a j ʃ a f 'a ɾ m e
coloraines	k o l o ɾ 'a j n e s
carai	k a ɾ 'a j
calaixets	k a l a j ʃ 'e t s
caixer	k a j ʃ 'e ɾ
caigudes	k a j ɣ 'u ð e s
caic	k 'a j k
blocaires	b l o k 'a j ɾ e s
baixo	b 'a j ʃ o
baixista	b a j ʃ 'i s t a
baixem	b a j ʃ 'e m
baixaven	b a j ʃ 'a v e n
baixava	b a j ʃ 'a v a
baixats	b a j ʃ 'a t s
baixat	b a j ʃ 'a t
baixaria	b a j ʃ a ɾ 'i a
baixarem	b a j ʃ a ɾ 'e m
baixar-les	b a j ʃ 'a ɾ l e s
algebraic	a l d ʒ e β ɾ 'a j k
així	a j ʃ 'i
aixopluc	a j ʃ o p l 'u k
aixecàrem	a j ʃ e k 'a ɾ e m
aixeco	a j ʃ 'e k o
aixecant-li	a j ʃ e k 'a n l i
aixecant	a j ʃ e k 'a n t
aixecada	a j ʃ e k 'a ð a
aixeca	a j ʃ 'e k a
aixafar	a j ʃ a f 'a ɾ
aida	'a j ð a
abaixà	a β a j ʃ 'a
Vailets	v a j l 'e t s
Taipei	t a j p 'e j
Renaixença	r e n a j ʃ 'e n s a
Renaixement	r e n a j ʃ e m 'e n t
Naixement	n a j ʃ e m 'e n t
Nairobi	n a j ɾ 'ɔ β i
Lovaina	l o v 'a j n a
Jamaica	d ʒ a m 'a j k a
Floraina	f l o ɾ 'a j n a
D'això	d a j ʃ 'ɔ
Calaixos	k a l 'a j ʃ o s
Baixos	b 'a j ʃ o s
Aixeca	a j ʃ 'e k a
Ai	'a j
Abaixo	a β 'a j ʃ o
terrissaires	t e r i s 'a j ɾ e s
t'aixeques	t a j ʃ 'e k e s
naixem	n a j ʃ 'e m
flaixos	f l 'a j ʃ o s
encaixar	a ŋ k a j ʃ 'a ɾ
dançaire	d a n s 'a j ɾ e
daina	d 'a j n a
caiguts	k a j ɣ 'u t s
caiguin	k 'a j ɣ i n
aixoplugat	a j ʃ o p l u ɣ 'a t
aixecat	a j ʃ e k 'a t
aixecar-me	a j ʃ e k 'a ɾ m e
aixafant	a j ʃ a f 'a n t
S'aixeca	s a j ʃ 'e k a
Baixes	b 'a j ʃ e s
bei	b 'ɛ j
guèiser	g 'ɛ j z e ɾ
proteic	p ɾ o t 'ɛ j k
coneixi	k o n 'ɛ j ʃ i
guèiser	g 'ɛ j z e ɾ
absents	a p s 'e n s
adolescents	a ð o l e s 'e n s
agents	a d ʒ 'e n s
arguments	a ɾ ɣ u m 'e n s
armaments	a ɾ m a m 'e n s
comandaments	k o m a n d a m 'e n s
compartiments	k o m p a ɾ t i m 'e n s
comportaments	k o m p o ɾ t a m 'e n s
constituents	k o n s t i t u 'e n s
continents	k o n t i n 'e n s
contingents	k o n t i n d ʒ 'e n s
contribuents	k o n t ɾ i β u 'e n s
corrents	k o r 'e n s
corresponents	k o r e s p o n 'e n s
fluorescents	f l u o ɾ e s 'e n s
insolents	i n s o l 'e n s
insurgents	i n s u ɾ d ʒ 'e n s
presidents	p ɾ e z i ð 'e n s
diferents	d i f e ɾ 'e n s
moments	m o m 'e n s
documents	d o k u m 'e n s
elements	e l e m 'e n s
sentiments	s e n t i m 'e n s
moviments	m o v i m 'e n s
dents	d 'e n s
corresponents	k o r e s p o n 'e n s
agents	a d ʒ 'e n s
aliments	a l i m 'e n s
pensaments	p e n s a m 'e n s
recents	r e s 'e n s
monuments	m o n u m 'e n s
transparents	t ɾ a n s p a ɾ 'e n s
intents	i n t 'e n s
dolents	d o l 'e n s
corrents	k o r 'e n s
contribuents	k o n t ɾ i β u 'e n s
atents	a t 'e n s
segments	s e g m 'e n s
sediments	s e ð i m 'e n s
presents	p ɾ e z 'e n s
jaciments	d ʒ a s i m 'e n s
fragments	f ɾ a g m 'e n s
establiments	a s t a β l i m 'e n s
esdeveniments	a z ð e v e n i m 'e n s
coneixements	k o n e j ʃ e m 'e n s
compartiments	k o m p a ɾ t i m 'e n s
aprenents	a p ɾ e n 'e n s
ajuntaments	a d ʒ u n t a m 'e n s
vents	v 'e n s
sorprenents	s o ɾ p ɾ e n 'e n s
independents	i n d e p e n d 'e n s
existents	e g z i s t 'e n s
estaments	a s t a m 'e n s
encreuaments	a ŋ k ɾ e w a m 'e n s
dirigents	d i ɾ i d ʒ 'e n s
accidents	a k s i ð 'e n s
vigents	v i d ʒ 'e n s
valents	v a l 'e n s
urgents	u ɾ d ʒ 'e n s
tractaments	t ɾ a k t a m 'e n s
tangents	t a n d ʒ 'e n s
servents	s e ɾ v 'e n s
sents	s 'e n s
referents	r e f e ɾ 'e n s
recents	r e s 'e n s
quatrecents	k w a t ɾ e s 'e n s
punyents	p u ɲ 'e n s
procedents	p ɾ o s e ð 'e n s
pretendents	p ɾ e t e n d 'e n s
plantejaments	p l a n t e d ʒ a m 'e n s
pertinents	p e ɾ t i n 'e n s
pertanyents	p e ɾ t a ɲ 'e n s
permanents	p e ɾ m a n 'e n s
pendents	p e n d 'e n s
patiments	p a t i m 'e n s
pagaments	p a ɣ a m 'e n s
miraments	m i ɾ a m 'e n s
ments	m 'e n s
medicaments	m e ð i k a m 'e n s
laments	l a m 'e n s
incoherents	i ŋ k o e ɾ 'e n s
incidents	i n s i ð 'e n s
impediments	i m p e ð i m 'e n s
freqüents	f ɾ e k w 'e n s
experiments	e k s p e ɾ i m 'e n s
documents	d o k u m 'e n s
despreniments	d e s p ɾ e n i m 'e n s
delinqüents	d e l i ŋ k w 'e n s
corresponents	k o r e s p o n 'e n s
conseqüents	k o n s e k w 'e n s
complements	k o m p l e m 'e n s
coincidents	k o i n s i ð 'e n s
coherents	k o e ɾ 'e n s
cents	s 'e n s
avorriments	a v o r i m 'e n s
assistents	a s i s t 'e n s
arguments	a ɾ ɣ u m 'e n s
apropaments	a p ɾ o p a m 'e n s
antecedents	a n t e s e ð 'e n s
afloraments	a f l o ɾ a m 'e n s
abocaments	a β o k a m 'e n s
Esdeveniments	a z ð e v e n i m 'e n s
Elements	e l e m 'e n s
Documents	d o k u m 'e n s
Desplaçaments	d e s p l a s a m 'e n s
Coneixements	k o n e j ʃ e m 'e n s
Complements	k o m p l e m 'e n s
vinents	v i n 'e n s
remordiments	r e m o ɾ ð i m 'e n s
procediments	p ɾ o s e ð i m 'e n s
potents	p o t 'e n s
lents	l 'e n s
insolvents	i n s o l v 'e n s
increments	i ŋ k ɾ e m 'e n s
contundents	k o n t u n d 'e n s
contents	k o n t 'e n s
començaments	k o m e n s a m 'e n s
combatents	k o m b a t 'e n s
assentaments	a s e n t a m 'e n s
adolescents	a ð o l e s 'e n s
abaixéssiu	a β a j ʃ 'e s i w
abastéssiu	a β a s t 'e s i w
abdicatiu	a b d i k a t 'i w
ablatiu	a β l a t 'i w
ablatius	a β l a t 'i w s
abortiu	a β o ɾ t 'i w
abortius	a β o ɾ t 'i w s
abrasiu	a β ɾ a z 'i w
abusiu	a β u z 'i w
abusius	a β u z 'i w s
acabéssiu	a k a β 'e s i w
actiu	a k t 'i w
actriu	a k t ɾ 'i w
actrius	a k t ɾ 'i w s
acudiu	a k u ð 'i w
acumulatiu	a k u m u l a t 'i w
acusatiu	a k u z a t 'i w
acusatius	a k u z a t 'i w s
additiu	a d d i t 'i w
additius	a d d i t 'i w s
adhesiu	a ð e z 'i w
adiu	a ð 'i w
adius	a ð 'i w s
administratiu	a d m i n i s t ɾ a t 'i w
adoptiu	a ð o p t 'i w
adoptius	a ð o p t 'i w s
adscriure	a t s k ɾ 'i w ɾ e
afectiu	a f e k t 'i w
afectius	a f e k t 'i w s
afirmatiu	a f i ɾ m a t 'i w
afirmatius	a f i ɾ m a t 'i w s
agressiu	a ɣ ɾ e s 'i w
agressius	a ɣ ɾ e s 'i w s
al·latiu	a l a t 'i w
al·lusiu	a l u z 'i w
al·lusius	a l u z 'i w s
alternatiu	a l t e ɾ n a t 'i w
alternatius	a l t e ɾ n a t 'i w s
altiu	a l t 'i w
altius	a l t 'i w s
améssiu	a m 'e s i w
aperitiu	a p e ɾ i t 'i w
aperitius	a p e ɾ i t 'i w s
aprensiu	a p ɾ e n s 'i w
aproximatiu	a p ɾ o k s i m a t 'i w
aquàrium	a k w 'a ɾ i w m
arxiu	a ɾ t ʃ 'i w
arxius	a ɾ t ʃ 'i w s
assassinéssiu	a s a s i n 'e s i w
assistiu	a s i s t 'i w
associatiu	a s o s i a t 'i w
associatius	a s o s i a t 'i w s
atractiu	a t ɾ a k t 'i w
atreviu	a t ɾ e v 'i w
aversiu	a v e ɾ s 'i w
avortiu	a v o ɾ t 'i w
baciu	b a s 'i w
badiu	b a ð 'i w
Beatriu	b e a t ɾ 'i w
bisectrius	b i z e k t ɾ 'i w s
briu	b ɾ 'i w
caliu	k a l 'i w
captiu	k a p t 'i w
captius	k a p t 'i w s
caritatiu	k a ɾ i t a t 'i w
caritatius	k a ɾ i t a t 'i w s
cicatriu	s i k a t ɾ 'i w
cicatrius	s i k a t ɾ 'i w s
ciuró	s i w ɾ 'o
ciurons	s i w ɾ 'o n s
ciutadà	s i w t a ð 'a
ciutadana	s i w t a ð 'a n a
ciutadanes	s i w t a ð 'a n e s
ciutadania	s i w t a ð a n 'i a
ciutadans	s i w t a ð 'a n s
ciutadella	s i w t a ð 'e ʎ a
Ciutadella	s i w t a ð 'e ʎ a
ciutat	s i w t 'a t
ciutats	s i w t 'a t s
cobriu	k o β ɾ 'i w
coexistiu	k o e g z i s t 'i w
coincidiu	k o i n s i ð 'i w
col·lectiu	k o l e k t 'i w
col·lectius	k o l e k t 'i w s
commemoratiu	k o m m e m o ɾ a t 'i w
commemoratius	k o m m e m o ɾ a t 'i w s
comparatiu	k o m p a ɾ a t 'i w
comparatius	k o m p a ɾ a t 'i w s
competitiu	k o m p e t i t 'i w
competitius	k o m p e t i t 'i w s
compulsiu	k o m p u l s 'i w
compulsius	k o m p u l s 'i w s
comunicatiu	k o m u n i k a t 'i w
comunicatius	k o m u n i k a t 'i w s
conatiu	k o n a t 'i w
conatius	k o n a t 'i w s
conclusiu	k o ŋ k l u z 'i w
conclusius	k o ŋ k l u z 'i w s
conductiu	k o n d u k t 'i w
conductius	k o n d u k t 'i w s
connotatiu	k o n n o t a t 'i w
constitutiu	k o n s t i t u t 'i w
contemplatiu	k o n t e m p l a t 'i w
cooperatiu	k o o p e ɾ a t 'i w
corporatiu	k o ɾ p o ɾ a t 'i w
corporatius	k o ɾ p o ɾ a t 'i w s
cotoliu	k o t o l 'i w
creatiu	k ɾ e a t 'i w
creatius	k ɾ e a t 'i w s
cultiu	k u l t 'i w
cultius	k u l t 'i w s
curatiu	k u ɾ a t 'i w
curatius	k u ɾ a t 'i w s
cursiu	k u ɾ s 'i w
deceptiu	d e s e p t 'i w
deceptius	d e s e p t 'i w s
decidiu	d e s i ð 'i w
decisiu	d e s i z 'i w
decisius	d e s i z 'i w s
decoratiu	d e k o ɾ a t 'i w
defensiu	d e f e n s 'i w
defensius	d e f e n s 'i w s
definitiu	d e f i n i t 'i w
definiu	d e f i n 'i w
degeneratiu	d e d ʒ e n e ɾ a t 'i w
degeneratius	d e d ʒ e n e ɾ a t 'i w s
delictiu	d e l i k t 'i w
delictius	d e l i k t 'i w s
desaprensiu	d e z a p ɾ e n s 'i w
descriptiu	d e s k ɾ i p t 'i w
descriure	d e s k ɾ 'i w ɾ e
despectiu	d e s p e k t 'i w
destructiu	d e s t ɾ u k t 'i w
detectiu	d e t e k t 'i w
digestiu	d i d ʒ e s t 'i w
digestius	d i d ʒ e s t 'i w s
dirimiu	d i ɾ i m 'i w
dispositiu	d i s p o z i t 'i w
dispositius	d i s p o z i t 'i w s
distintiu	d i s t i n t 'i w
distintius	d i s t i n t 'i w s
diu	d 'i w
diumenge	d i w m 'e n d ʒ e
dius	d 'i w s
dividiu	d i v i ð 'i w
donatiu	d o n a t 'i w
educatiu	e ð u k a t 'i w
efectiu	e f e k t 'i w
efectius	e f e k t 'i w s
electiu	e l e k t 'i w
electius	e l e k t 'i w s
eludiu	e l u ð 'i w
elusiu	e l u z 'i w
elusius	e l u z 'i w s
emotiu	e m o t 'i w
emotius	e m o t 'i w s
emperadriu	a m p e ɾ a ð ɾ 'i w
emperadrius	a m p e ɾ a ð ɾ 'i w s
escorrentiu	a s k o r e n t 'i w
escriure	a s k ɾ 'i w ɾ e
especulatiu	a s p e k u l a t 'i w
especulatius	a s p e k u l a t 'i w s
esportiu	a s p o ɾ t 'i w
esquiu	a s k 'i w
estiu	a s t 'i w
estiuada	a s t i w 'a ð a
estiuades	a s t i w 'a ð e s
estiuar	a s t i w 'a ɾ
estiuat	a s t i w 'a t
estiuats	a s t i w 'a t s
estiueig	a s t i w 'e t ʃ
estiuejada	a s t i w e d ʒ 'a ð a
estiuejades	a s t i w e d ʒ 'a ð e s
estiuejar	a s t i w e d ʒ 'a ɾ
estiuejat	a s t i w e d ʒ 'a t
estiuejats	a s t i w e d ʒ 'a t s
estiuenc	a s t i w 'e ŋ k
evasiu	e v a z 'i w
evasius	e v a z 'i w s
exclusiu	e k s k l u z 'i w
exclusius	e k s k l u z 'i w s
executiu	e g z e k u t 'i w
exhaustiu	e g z a w s t 'i w
exhaustius	e g z a w s t 'i w s
expletiu	e k s p l e t 'i w
explicatiu	e k s p l i k a t 'i w
explicatius	e k s p l i k a t 'i w s
explosiu	e k s p l o z 'i w
explosius	e k s p l o z 'i w s
expositiu	e k s p o z i t 'i w
expositius	e k s p o z i t 'i w s
expressiu	e k s p ɾ e s 'i w
extensiu	e k s t e n s 'i w
extensius	e k s t e n s 'i w s
festiu	f e s t 'i w
figuratiu	f i ɣ u ɾ a t 'i w
figuratius	f i ɣ u ɾ a t 'i w s
formatiu	f o ɾ m a t 'i w
formatius	f o ɾ m a t 'i w s
fricatiu	f ɾ i k a t 'i w
fugitiu	f u d ʒ i t 'i w
fugitius	f u d ʒ i t 'i w s
furtiu	f u ɾ t 'i w
furtius	f u ɾ t 'i w s
garantiu	g a ɾ a n t 'i w
gasiu	g a z 'i w
genitiu	d ʒ e n i t 'i w
genitius	d ʒ e n i t 'i w s
griu	g ɾ 'i w
gustatiu	g u s t a t 'i w
hàgiu	'a d ʒ i w
hiperactiu	i p e ɾ a k t 'i w
hiperactius	i p e ɾ a k t 'i w s
hipogriu	i p o ɣ ɾ 'i w
imaginatiu	i m a d ʒ i n a t 'i w
imitatiu	i m i t a t 'i w
imitatius	i m i t a t 'i w s
impediu	i m p e ð 'i w
imperatiu	i m p e ɾ a t 'i w
imperatius	i m p e ɾ a t 'i w s
impulsiu	i m p u l s 'i w
impulsius	i m p u l s 'i w s
inactiu	i n a k t 'i w
incentiu	i n s e n t 'i w
incisiu	i n s i z 'i w
incisius	i n s i z 'i w s
inclusiu	i ŋ k l u z 'i w
indicatiu	i n d i k a t 'i w
indicatius	i n d i k a t 'i w s
inexpressiu	i n e k s p ɾ e s 'i w
inscriure	i n s k ɾ 'i w ɾ e
instintiu	i n s t i n t 'i w
instintius	i n s t i n t 'i w s
instructiu	i n s t ɾ u k t 'i w
instructius	i n s t ɾ u k t 'i w s
intempestiu	i n t e m p e s t 'i w
intempestius	i n t e m p e s t 'i w s
intensiu	i n t e n s 'i w
interrogatiu	i n t e r o ɣ a t 'i w
intransitiu	i n t ɾ a n s i t 'i w
intransitius	i n t ɾ a n s i t 'i w s
intrusiu	i n t ɾ u z 'i w
intuïtiu	i n t u i t 'i w
lasciu	l a s 'i w
legislatiu	l e d ʒ i z l a t 'i w
lleixiu	ʎ e j ʃ 'i w
lliura	ʎ 'i w ɾ a
lliurada	ʎ i w ɾ 'a ð a
lliurades	ʎ i w ɾ 'a ð e s
lliurament	ʎ i w ɾ a m 'e n t
lliurar	ʎ i w ɾ 'a ɾ
lliurat	ʎ i w ɾ 'a t
lliurats	ʎ i w ɾ 'a t s
lliure	ʎ 'i w ɾ e
manxiula	m a n t ʃ 'i w l a
Màrius	m 'a ɾ i w s
massiu	m a s 'i w
matriu	m a t ɾ 'i w
meretriu	m e ɾ e t ɾ 'i w
míldiu	m 'i l d i w
motiu	m o t 'i w
motriu	m o t ɾ 'i w
motrius	m o t ɾ 'i w s
multiplicatiu	m u l t i p l i k a t 'i w
multiplicatius	m u l t i p l i k a t 'i w s
nabiu	n a β 'i w
nadiu	n a ð 'i w
nadius	n a ð 'i w s
nariu	n a ɾ 'i w
natiu	n a t 'i w
natius	n a t 'i w s
negatiu	n e ɣ a t 'i w
negatius	n e ɣ a t 'i w s
niu	n 'i w
nociu	n o s 'i w
nominatiu	n o m i n a t 'i w
nominatius	n o m i n a t 'i w s
normatiu	n o ɾ m a t 'i w
normatius	n o ɾ m a t 'i w s
objectiu	o b d ʒ e k t 'i w
obsessiu	o p s e s 'i w
obsessius	o p s e s 'i w s
ofeguéssiu	o f e ɣ 'e s i w
ofensiu	o f e n s 'i w
ofensius	o f e n s 'i w s
oliu	o l 'i w
ombriu	o m b ɾ 'i w
operatiu	o p e ɾ a t 'i w
opressiu	o p ɾ e s 'i w
pandemònium	p a n d e m 'ɔ n i w m
parentiu	p a ɾ e n t 'i w
parléssiu	p a ɾ l 'e s i w
passiu	p a s 'i w
passius	p a s 'i w s
pejoratiu	p e d ʒ o ɾ a t 'i w
pejoratius	p e d ʒ o ɾ a t 'i w s
pensatiu	p e n s a t 'i w
perdiu	p e ɾ ð 'i w
performatiu	p e ɾ f o ɾ m a t 'i w
permissiu	p e ɾ m i s 'i w
persuasiu	p e ɾ s u a z 'i w
piu	p 'i w
piuar	p i w 'a ɾ
piulada	p i w l 'a ð a
piular	p i w l 'a ɾ
Pius	p 'i w s
positiu	p o z i t 'i w
possessiu	p o s e s 'i w
preferiu	p ɾ e f e ɾ 'i w
preguntéssiu	p ɾ e ɣ u n t 'e s i w
preparatiu	p ɾ e p a ɾ a t 'i w
presumptiu	p ɾ e z u m t 'i w
preventiu	p ɾ e v e n t 'i w
preventius	p ɾ e v e n t 'i w s
primitiu	p ɾ i m i t 'i w
procliu	p ɾ o k l 'i w
procuréssiu	p ɾ o k u ɾ 'e s i w
productiu	p ɾ o ð u k t 'i w
progressiu	p ɾ o ɣ ɾ e s 'i w
provocatiu	p ɾ o v o k a t 'i w
puniu	p u n 'i w
purgatiu	p u ɾ ɣ a t 'i w
purgatius	p u ɾ ɣ a t 'i w s
putatiu	p u t a t 'i w
putatius	p u t a t 'i w s
qualitatiu	k w a l i t a t 'i w
quantitatiu	k w a n t i t a t 'i w
quantitatius	k w a n t i t a t 'i w s
queviures	k e v 'i w ɾ e s
reactiu	r e a k t 'i w
receptiu	r e s e p t 'i w
recessiu	r e s e s 'i w
recitatiu	r e s i t a t 'i w
recreatiu	r e k ɾ e a t 'i w
reflexiu	r e f l e k s 'i w
refractiu	r e f ɾ a k t 'i w
regadiu	r e ɣ a ð 'i w
regressiu	r e ɣ ɾ e s 'i w
relatiu	r e l a t 'i w
repetitiu	r e p e t i t 'i w
repressiu	r e p ɾ e s 'i w
reproductiu	r e p ɾ o ð u k t 'i w
reproductius	r e p ɾ o ð u k t 'i w s
repulsiu	r e p u l s 'i w
respectiu	r e s p e k t 'i w
reuniu	r e u n 'i w
reviure	r e v 'i w ɾ e
riu	r 'i w
riuada	r i w 'a ð a
riure	r 'i w ɾ e
selectiu	s e l e k t 'i w
sensitiu	s e n s i t 'i w
somriure	s o m ɾ 'i w ɾ e
subjectiu	s u b d ʒ e k t 'i w
subjuntiu	s u b d ʒ u n t 'i w
subscriure	s u p s k ɾ 'i w ɾ e
substantiu	s u p s t a n t 'i w
substantius	s u p s t a n t 'i w s
successiu	s u k s e s 'i w
successius	s u k s e s 'i w s
tamariu	t a m a ɾ 'i w
televisiu	t e l e v i z 'i w
teniu	t e n 'i w
transcriure	t ɾ a n s k ɾ 'i w ɾ e
treslliures	t ɾ e z ʎ 'i w ɾ e s
triumf	t ɾ 'i w m f
triumvirat	t ɾ i w m v i ɾ 'a t
uniu	u n 'i w
variu	v a ɾ 'i w
varius	v a ɾ 'i w s
vegetatiu	v e d ʒ e t a t 'i w
venjatiu	v e n d ʒ a t 'i w
viu	v 'i w
viuda	v 'i w ð a
viudo	v 'i w ð o
viure	v 'i w ɾ e
vius	v 'i w s
vocatiu	v o k a t 'i w
xiulada	t ʃ i w l 'a ð a
xiulades	t ʃ i w l 'a ð e s
xiulador	t ʃ i w l a ð 'o ɾ
xiular	t ʃ i w l 'a ɾ
xiulat	t ʃ i w l 'a t
xiulats	t ʃ i w l 'a t s
xiulet	t ʃ i w l 'e t
diuen	d 'i w e n
viuen	v 'i w e n
Diuen	d 'i w e n
riuen	r 'i w e n
riuada	r i w 'a ð a
diuen	d 'i w e n
estiuenca	a s t i w 'e ŋ k a
Viuen	v 'i w e n
asímptota	a z 'i m t o t a
assumpte	a s 'u m t e
assumptes	a s 'u m t e s
atemptada	a t e m t 'a ð a
atemptades	a t e m t 'a ð e s
atemptant	a t e m t 'a n t
atemptat	a t e m t 'a t
atemptats	a t e m t 'a t s
compta	k 'o m t a
comptabilitat	k o m t a β i l i t 'a t
comptables	k o m t 'a β l e s
comptada	k o m t 'a ð a
comptades	k o m t 'a ð e s
comptador	k o m t a ð 'o ɾ
comptadoria	k o m t a ð o ɾ 'i a
comptar	k o m t 'a ɾ
comptat	k o m t 'a t
comptats	k o m t 'a t s
compte	k 'o m t e
compten	k 'o m t e n
comptes	k 'o m t e s
compto	k 'o m t o
descompte	d e s k 'o m t e
exempt	e g z 'e m t
exemptar	e g z e m t 'a ɾ
incomptable	i ŋ k o m t 'a β l e
presumpta	p ɾ e z 'u m t a
presumpte	p ɾ e z 'u m t e
presumptiu	p ɾ e z u m t 'i w
recomptada	r e k o m t 'a ð a
recomptades	r e k o m t 'a ð e s
recomptar	r e k o m t 'a ɾ
recompte	r e k 'o m t e
símptoma	s 'i m t o m a
simptomàtic	s i m t o m 'a t i k
simptomàtica	s i m t o m 'a t i k a
simptomàtics	s i m t o m 'a t i k s
temptació	t e m t a s i 'o
temptada	t e m t 'a ð a
temptades	t e m t 'a ð e s
temptar	t e m t 'a ɾ
temptat	t e m t 'a t
temptats	t e m t 'a t s
tempteig	t e m t 'e t ʃ
compte	k 'o m t e
comptes	k 'o m t e s
Compte	k 'o m t e
recompte	r e k 'o m t e
compta	k 'o m t a
exempts	e g z 'e m t s
descomptat	d e s k o m t 'a t
assumptes	a s 'u m t e s
assumpte	a s 'u m t e
presumpte	p ɾ e z 'u m t e
l'atemptat	l a t e m t 'a t
descomptes	d e s k 'o m t e s
descompte	d e s k 'o m t e
comptar	k o m t 'a ɾ
tempteig	t e m t 'e t ʃ
temptats	t e m t 'a t s
redemptora	r e ð e m t 'o ɾ a
presumpta	p ɾ e z 'u m t a
comptem	k o m t 'e m
assímptotes	a s 'i m t o t e s
Comptes	k 'o m t e s
Compta	k 'o m t a
Compte	k 'o m t e
presumptes	p ɾ e z 'u m t e s
comptar-lo	k o m t 'a ɾ l o
comptant	k o m t 'a n t
comptables	k o m t 'a β l e s
comptabilitat	k o m t a β i l i t 'a t
atemptat	a t e m t 'a t
Compto	k 'o m t o
alcoià	a l k o j 'a
Alcoià	a l k o j 'a
angoixa	a ŋ g 'o j ʃ a
angoixada	a ŋ g o j ʃ 'a ð a
angoixades	a ŋ g o j ʃ 'a ð e s
angoixant	a ŋ g o j ʃ 'a n t
angoixar	a ŋ g o j ʃ 'a ɾ
angoixat	a ŋ g o j ʃ 'a t
angoixats	a ŋ g o j ʃ 'a t s
angoixós	a ŋ g o j ʃ 'o s
boiar	b o j 'a ɾ
boicotejada	b o j k o t e d ʒ 'a ð a
boicotejades	b o j k o t e d ʒ 'a ð e s
boicotejar	b o j k o t e d ʒ 'a ɾ
boicotejat	b o j k o t e d ʒ 'a t
boicotejats	b o j k o t e d ʒ 'a t s
boirina	b o j ɾ 'i n a
boirós	b o j ɾ 'o s
boirum	b o j ɾ 'u m
boix	b 'o j ʃ
boixac	b o j ʃ 'a k
boixerica	b o j ʃ e ɾ 'i k a
boixerola	b o j ʃ e ɾ 'ɔ l a
broix	b ɾ 'o j ʃ
coiot	k o j 'ɔ t
coix	k 'o j ʃ
coixejada	k o j ʃ e d ʒ 'a ð a
coixejades	k o j ʃ e d ʒ 'a ð e s
coixejar	k o j ʃ e d ʒ 'a ɾ
coixejat	k o j ʃ e d ʒ 'a t
coixejats	k o j ʃ e d ʒ 'a t s
coixí	k o j ʃ 'i
emboirar	a m b o j ɾ 'a ɾ
encoixinar	a ŋ k o j ʃ i n 'a ɾ
encoixir	a ŋ k o j ʃ 'i ɾ
Foix	f 'o j ʃ
joier	d ʒ o j 'e ɾ
joieria	d ʒ o j e ɾ 'i a
joiós	d ʒ o j 'o s
Moià	m o j 'a
moix	m 'o j ʃ
moixaina	m o j ʃ 'a j n a
moixama	m o j ʃ 'a m a
moixí	m o j ʃ 'i
moixina	m o j ʃ 'i n a
moixó	m o j ʃ 'o
noieta	n o j 'e t a
toix	t 'o j ʃ
troià	t ɾ o j 'a
coixí	k o j ʃ 'i
boixedes	b o j ʃ 'e ð e s
moix	m 'o j ʃ
coixa	k 'o j ʃ a
boirum	b o j ɾ 'u m
boirina	b o j ɾ 'i n a
angoixós	a ŋ g o j ʃ 'o s
angoixa	a ŋ g 'o j ʃ a
Boix	b 'o j ʃ
moixetes	m o j ʃ 'e t e s
encoixinades	a ŋ k o j ʃ i n 'a ð e s
angoixosos	a ŋ g o j ʃ 'o z o s
aqüicultura	a k w i k u l t 'u ɾ a
buidada	b w i ð 'a ð a
buidades	b w i ð 'a ð e s
buidar	b w i ð 'a ɾ
buidat	b w i ð 'a t
buidats	b w i ð 'a t s
buidor	b w i ð 'o ɾ
buirac	b w i ɾ 'a k
construiria	k o n s t ɾ w i ɾ 'i a
cuidada	k w i ð 'a ð a
cuidades	k w i ð 'a ð e s
cuidar	k w i ð 'a ɾ
cuidares	k w i ð 'a ɾ e s
cuidaria	k w i ð a ɾ 'i a
cuidat	k w i ð 'a t
cuidats	k w i ð 'a t s
cuidava	k w i ð 'a v a
cuidem	k w i ð 'e m
cuinada	k w i n 'a ð a
cuinades	k w i n 'a ð e s
cuinar	k w i n 'a ɾ
cuinat	k w i n 'a t
cuinats	k w i n 'a t s
cuiner	k w i n 'e ɾ
cuirassa	k w i ɾ 'a s a
cuirassar	k w i ɾ a s 'a ɾ
cuirassat	k w i ɾ a s 'a t
cuitada	k w i t 'a ð a
cuitades	k w i t 'a ð e s
cuitar	k w i t 'a ɾ
cuitat	k w i t 'a t
cuitats	k w i t 'a t s
fruiterar	f ɾ w i t e ɾ 'a ɾ
instruiria	i n s t ɾ w i ɾ 'i a
lluiria	ʎ w i ɾ 'i a
lluitada	ʎ w i t 'a ð a
lluitades	ʎ w i t 'a ð e s
lluitador	ʎ w i t a ð 'o ɾ
lluitant	ʎ w i t 'a n t
lluitar	ʎ w i t 'a ɾ
lluitat	ʎ w i t 'a t
lluitats	ʎ w i t 'a t s
ubiqüitat	u β i k w i t 'a t
vuitada	v w i t 'a ð a
vuitanta	v w i t 'a n t a
vuitanta	v w i t 'a n t a
lluitar	ʎ w i t 'a ɾ
lluitava	ʎ w i t 'a v a
lluitador	ʎ w i t a ð 'o ɾ
cuidar	k w i ð 'a ɾ
arruinats	a r w i n 'a t s
vuitens	v w i t 'e n s
vuitena	v w i t 'e n a
terraqüi	t e r 'a k w i
produirà	p ɾ o ð w i ɾ 'a
produiran	p ɾ o ð w i ɾ 'a n
lluirà	ʎ w i ɾ 'a
divuitena	d i v w i t 'e n a
cuirassada	k w i ɾ a s 'a ð a
cuinés	k w i n 'e s
cuinera	k w i n 'e ɾ a
cuinaria	k w i n a ɾ 'i a
cuinar-la	k w i n 'a ɾ l a
cuinar	k w i n 'a ɾ
cuidava	k w i ð 'a v a
cuidant	k w i ð 'a n t
contribuiria	k o n t ɾ i β w i ɾ 'i a
construirà	k o n s t ɾ w i ɾ 'a
buidor	b w i ð 'o ɾ
buidar-la	b w i ð 'a ɾ l a
afruitat	a f ɾ w i t 'a t
produiria	p ɾ o ð w i ɾ 'i a
lluitaven	ʎ w i t 'a v e n
cuinats	k w i n 'a t s
cuidés	k w i ð 'e s
buidant	b w i ð 'a n t
arruinada	a r w i n 'a ð a

