notificació	n o t i f i k a s i 'o	n o t i f i k a s i 'o
batxillerat	b a t ʃ i ʎ e ɾ 'a t	b a t ʃ i ʎ e ɾ 'a t
santificar	s a n t i f i k 'a ɾ	s a n t i f i k 'a ɾ
esdevingudes	a z ð e v i ŋ g 'u ð e s	a z ð e v i ŋ g 'u ð e s
francofonia	f ɾ a ŋ k o f o n 'i a	f ɾ a ŋ k o f o n 'i a
notat	n o t 'a t	n o t 'a t
concretats	k o ŋ k ɾ e t 'a t s	k o ŋ k ɾ e t 'a t s
aparença	a p a ɾ 'e n s a	a p a ɾ 'e n s a
executada	e g z e k u t 'a ð a	e g z e k u t 'a ð a
barrades	b a r 'a ð e s	b a r 'a ð e s
raciocinació	r a s i o s i n a s i 'o	r a s i o s i n a s i 'o
estada	a s t 'a ð a	a s t 'a ð a
enigmàtic	e n i g m 'a t i k	e n i g m 'a t i k
duna	d 'u n a	d 'u n a
recolzada	r e k o l z 'a ð a	r e k o l z 'a ð a
vertader	v e ɾ t a ð 'e ɾ	v e ɾ t a ð 'e ɾ
concretat	k o ŋ k ɾ e t 'a t	k o ŋ k ɾ e t 'a t
departit	d e p a ɾ t 'i t	d e p a ɾ t 'i t
publicar-la	p u β l i k 'a ɾ l a	p u β l i k 'a ɾ l a
pantomima	p a n t o m 'i m a	p a n t o m 'i m a
senabre	s e n 'a β ɾ e	s e n 'a β ɾ e
admirable	a d m i ɾ 'a β l e	a d m i ɾ 'a β l e
vinícola	v i n 'i k o l a	v i n 'i k o l a
can	k 'a n	k 'a n
serològics	s e ɾ o l 'ɔ d ʒ i k s	s e ɾ o l 'ɔ d ʒ i k s
preparats	p ɾ e p a ɾ 'a t s	p ɾ e p a ɾ 'a t s
visat	v i z 'a t	v i z 'a t
pericó	p e ɾ i k 'o	p e ɾ i k 'o
recull	r e k 'u ʎ	r e k 'u ʎ
eslora	a z l 'o ɾ a	a z l 'o ɾ a
trobar	t ɾ o β 'a ɾ	t ɾ o β 'a ɾ
fen	f 'e n	f 'e n
fallat	f a ʎ 'a t	f a ʎ 'a t
Tenim	t e n 'i m	t e n 'i m
escuterista	a s k u t e ɾ 'i s t a	a s k u t e ɾ 'i s t a
multava	m u l t 'a v a	m u l t 'a v a
ocupaven	o k u p 'a v e n	o k u p 'a v e n
abastaria	a β a s t a ɾ 'i a	a β a s t a ɾ 'i a
quedàrem	k e ð 'a ɾ e m	k e ð 'a ɾ e m
aristocràtiques	a ɾ i s t o k ɾ 'a t i k e s	a ɾ i s t o k ɾ 'a t i k e s
gentilici	d ʒ e n t i l 'i s i	d ʒ e n t i l 'i s i
arpejada	a ɾ p e d ʒ 'a ð a	a ɾ p e d ʒ 'a ð a
s'habilitarà	s a β i l i t a ɾ 'a	s a β i l i t a ɾ 'a
Insistir	i n s i s t 'i ɾ	i n s i s t 'i ɾ
domestica	d o m e s t 'i k a	d o m e s t 'i k a
filòsof	f i l 'ɔ z o f	f i l 'ɔ z o f
rearrencades	r e a r e ŋ k 'a ð e s	r e a r e ŋ k 'a ð e s
massiu	m a s 'i w	m a s 'i w
derruït	d e r u 'i t	d e r u 'i t
llucana	ʎ u k 'a n a	ʎ u k 'a n a
foll	f 'o ʎ	f 'o ʎ
punter	p u n t 'e ɾ	p u n t 'e ɾ
cobrir	k o β ɾ 'i ɾ	k o β ɾ 'i ɾ
alquímica	a l k 'i m i k a	a l k 'i m i k a
voluntari	v o l u n t 'a ɾ i	v o l u n t 'a ɾ i
inconsiderat	i ŋ k o n s i ð e ɾ 'a t	i ŋ k o n s i ð e ɾ 'a t
eivissenc	e j v i s 'e ŋ k	e j v i s 'e ŋ k
enjardinats	a n d ʒ a ɾ ð i n 'a t s	a n d ʒ a ɾ ð i n 'a t s
assistit	a s i s t 'i t	a s i s t 'i t
emotives	e m o t 'i v e s	e m o t 'i v e s
exportar	e k s p o ɾ t 'a ɾ	e k s p o ɾ t 'a ɾ
emparat	a m p a ɾ 'a t	a m p a ɾ 'a t
constatares	k o n s t a t 'a ɾ e s	k o n s t a t 'a ɾ e s
gramaticals	g ɾ a m a t i k 'a l s	g ɾ a m a t i k 'a l s
externs	e k s t 'ɛ ɾ n s	e k s t 'ɛ ɾ n s
construccions	k o n s t ɾ u k s i 'o n s	k o n s t ɾ u k s i 'o n s
justificable	d ʒ u s t i f i k 'a β l e	d ʒ u s t i f i k 'a β l e
directori	d i ɾ e k t 'ɔ ɾ i	d i ɾ e k t 'ɔ ɾ i
desbrossades	d e z β ɾ o s 'a ð e s	d e z β ɾ o s 'a ð e s
tacó	t a k 'o	t a k 'o
Bòsnia	b 'ɔ z n i a	b 'ɔ z n i a
llaminadura	ʎ a m i n a ð 'u ɾ a	ʎ a m i n a ð 'u ɾ a
excusa	e k s k 'u z a	e k s k 'u z a
preníem	p ɾ e n 'i e m	p ɾ e n 'i e m
alienaria	a l i e n a ɾ 'i a	a l i e n a ɾ 'i a
fonològic	f o n o l 'ɔ d ʒ i k	f o n o l 'ɔ d ʒ i k
algonquí	a l ɣ o ŋ k 'i	a l ɣ o ŋ k 'i
banalitat	b a n a l i t 'a t	b a n a l i t 'a t
tomballar	t o m b a ʎ 'a ɾ	t o m b a ʎ 'a ɾ
pejorativa	p e d ʒ o ɾ a t 'i v a	p e d ʒ o ɾ a t 'i v a
retuts	r e t 'u t s	r e t 'u t s
feixisme	f e j ʃ 'i z m e	f e j ʃ 'i z m e
àneda	'a n e ð a	'a n e ð a
terrenal	t e r e n 'a l	t e r e n 'a l
Cató	k a t 'o	k a t 'o
intradós	i n t ɾ a ð 'o s	i n t ɾ a ð 'o s
celles	s 'e ʎ e s	s 'e ʎ e s
brindes	b ɾ 'i n d e s	b ɾ 'i n d e s
aniquilar	a n i k i l 'a ɾ	a n i k i l 'a ɾ
decanta	d e k 'a n t a	d e k 'a n t a
dolents	d o l 'e n s	d o l 'e n s
criatures	k ɾ i a t 'u ɾ e s	k ɾ i a t 'u ɾ e s
francesos	f ɾ a n s 'e z o s	f ɾ a n s 'e z o s
pellucar	p e ʎ u k 'a ɾ	p e ʎ u k 'a ɾ
meravelles	m e ɾ a v 'e ʎ e s	m e ɾ a v 'e ʎ e s
França	f ɾ 'a n s a	f ɾ 'a n s a
obstètric	o p s t 'ɛ t ɾ i k	o p s t 'ɛ t ɾ i k
aules	'a w l e s	'a w l e s
jamaicà	d ʒ a m a j k 'a	d ʒ a m a j k 'a
somicar	s o m i k 'a ɾ	s o m i k 'a ɾ
sardanejar	s a ɾ ð a n e d ʒ 'a ɾ	s a ɾ ð a n e d ʒ 'a ɾ
tram	t ɾ 'a m	t ɾ 'a m
arada	a ɾ 'a ð a	a ɾ 'a ð a
quedaven	k e ð 'a v e n	k e ð 'a v e n
demostrat	d e m o s t ɾ 'a t	d e m o s t ɾ 'a t
regalimats	r e ɣ a l i m 'a t s	r e ɣ a l i m 'a t s
l'article	l a ɾ t 'i k l e	l a ɾ t 'i k l e
bonítol	b o n 'i t o l	b o n 'i t o l
viure	v 'i w ɾ e	v 'i w ɾ e
naufragada	n a w f ɾ a ɣ 'a ð a	n a w f ɾ a ɣ 'a ð a
esmenar	a z m e n 'a ɾ	a z m e n 'a ɾ
mordaces	m o ɾ ð 'a s e s	m o ɾ ð 'a s e s
passi	p 'a s i	p 'a s i
espigada	a s p i ɣ 'a ð a	a s p i ɣ 'a ð a
mancats	m a ŋ k 'a t s	m a ŋ k 'a t s
quedat	k e ð 'a t	k e ð 'a t
creat	k ɾ e 'a t	k ɾ e 'a t
abeurar	a β e w ɾ 'a ɾ	a β e w ɾ 'a ɾ
boina	b 'ɔ j n a	b 'ɔ j n a
hiperònims	i p e ɾ 'ɔ n i m s	i p e ɾ 'ɔ n i m s
originari	o ɾ i d ʒ i n 'a ɾ i	o ɾ i d ʒ i n 'a ɾ i
s'alça	s 'a l s a	s 'a l s a
sucat	s u k 'a t	s u k 'a t
espuri	a s p 'u ɾ i	a s p 'u ɾ i
salar	s a l 'a ɾ	s a l 'a ɾ
brutalitats	b ɾ u t a l i t 'a t s	b ɾ u t a l i t 'a t s
fregall	f ɾ e ɣ 'a ʎ	f ɾ e ɣ 'a ʎ
menor	m e n 'o ɾ	m e n 'o ɾ
reclamada	r e k l a m 'a ð a	r e k l a m 'a ð a
alarma	a l 'a ɾ m a	a l 'a ɾ m a
masclista	m a s k l 'i s t a	m a s k l 'i s t a
axiomàtics	a k s i o m 'a t i k s	a k s i o m 'a t i k s
birmans	b i ɾ m 'a n s	b i ɾ m 'a n s
forjats	f o ɾ d ʒ 'a t s	f o ɾ d ʒ 'a t s
erris	'ɛ r i s	'ɛ r i s
facilitar	f a s i l i t 'a ɾ	f a s i l i t 'a ɾ
mòmia	m 'ɔ m i a	m 'ɔ m i a
antropòfoba	a n t ɾ o p 'ɔ f o β a	a n t ɾ o p 'ɔ f o β a
avenir	a v e n 'i ɾ	a v e n 'i ɾ
bipedisme	b i p e ð 'i z m e	b i p e ð 'i z m e
propòsit	p ɾ o p 'ɔ z i t	p ɾ o p 'ɔ z i t
nins	n 'i n s	n 'i n s
lírica	l 'i ɾ i k a	l 'i ɾ i k a
ridícul	r i ð 'i k u l	r i ð 'i k u l
venerat	v e n e ɾ 'a t	v e n e ɾ 'a t
precisa	p ɾ e s 'i z a	p ɾ e s 'i z a
cursats	k u ɾ s 'a t s	k u ɾ s 'a t s
vibra	v 'i β ɾ a	v 'i β ɾ a
laborat	l a β o ɾ 'a t	l a β o ɾ 'a t
anterioritat	a n t e ɾ i o ɾ i t 'a t	a n t e ɾ i o ɾ i t 'a t
seducció	s e ð u k s i 'o	s e ð u k s i 'o
retractilar	r e t ɾ a k t i l 'a ɾ	r e t ɾ a k t i l 'a ɾ
cony	k 'o ɲ	k 'o ɲ
retirades	r e t i ɾ 'a ð e s	r e t i ɾ 'a ð e s
diaconat	d i a k o n 'a t	d i a k o n 'a t
xuclada	t ʃ u k l 'a ð a	t ʃ u k l 'a ð a
exclusius	e k s k l u z 'i w s	e k s k l u z 'i w s
subgegant	s u b d ʒ e ɣ 'a n t	s u b d ʒ e ɣ 'a n t
llevares	ʎ e v 'a ɾ e s	ʎ e v 'a ɾ e s
desarreglada	d e z a r e ɣ l 'a ð a	d e z a r e ɣ l 'a ð a
impur	i m p 'u ɾ	i m p 'u ɾ
rodis	r 'ɔ ð i s	r 'ɔ ð i s
desintegrava	d e z i n t e ɣ ɾ 'a v a	d e z i n t e ɣ ɾ 'a v a
pròstata	p ɾ 'ɔ s t a t a	p ɾ 'ɔ s t a t a
bagatel·la	b a ɣ a t 'ɛ l a	b a ɣ a t 'ɛ l a
datada	d a t 'a ð a	d a t 'a ð a
batraci	b a t ɾ 'a s i	b a t ɾ 'a s i
consideracions	k o n s i ð e ɾ a s i 'o n s	k o n s i ð e ɾ a s i 'o n s
vibrar	v i β ɾ 'a ɾ	v i β ɾ 'a ɾ
passiu	p a s 'i w	p a s 'i w
partits	p a ɾ t 'i t s	p a ɾ t 'i t s
Barcelona	b a ɾ s e l 'o n a	b a ɾ s e l 'o n a
carmins	k a ɾ m 'i n s	k a ɾ m 'i n s
ricí	r i s 'i	r i s 'i
irremeiable	i r e m e j 'a β l e	i r e m e j 'a β l e
trombòtic	t ɾ o m b 'ɔ t i k	t ɾ o m b 'ɔ t i k
rebregada	r e β ɾ e ɣ 'a ð a	r e β ɾ e ɣ 'a ð a
airejar	a j ɾ e d ʒ 'a ɾ	a j ɾ e d ʒ 'a ɾ
pornogràfics	p o ɾ n o ɣ ɾ 'a f i k s	p o ɾ n o ɣ ɾ 'a f i k s
ajupit	a d ʒ u p 'i t	a d ʒ u p 'i t
cobert	k o β 'ɛ ɾ t	k o β 'ɛ ɾ t
subdural	s u b d u ɾ 'a l	s u b d u ɾ 'a l
reescalfó	r e e s k a l f 'o	r e e s k a l f 'o
renétes	r e n 'e t e s	r e n 'e t e s
llum	ʎ 'u m	ʎ 'u m
patrocinades	p a t ɾ o s i n 'a ð e s	p a t ɾ o s i n 'a ð e s
mostri	m 'ɔ s t ɾ i	m 'ɔ s t ɾ i
mínimes	m 'i n i m e s	m 'i n i m e s
destripada	d e s t ɾ i p 'a ð a	d e s t ɾ i p 'a ð a
prosòdia	p ɾ o z 'ɔ ð i a	p ɾ o z 'ɔ ð i a
dispars	d i s p 'a ɾ s	d i s p 'a ɾ s
importava	i m p o ɾ t 'a v a	i m p o ɾ t 'a v a
porró	p o r 'o	p o r 'o
reelegida	r e e l e d ʒ 'i ð a	r e e l e d ʒ 'i ð a
esbrossar	a z β ɾ o s 'a ɾ	a z β ɾ o s 'a ɾ
consolidats	k o n s o l i ð 'a t s	k o n s o l i ð 'a t s
bombejat	b o m b e d ʒ 'a t	b o m b e d ʒ 'a t
perpetuares	p e ɾ p e t u 'a ɾ e s	p e ɾ p e t u 'a ɾ e s
camussa	k a m 'u s a	k a m 'u s a
macarrons	m a k a r 'o n s	m a k a r 'o n s
bilingüisme	b i l i ŋ g w 'i z m e	b i l i ŋ g w 'i z m e
ascendència	a s e n d 'ɛ n s i a	a s e n d 'ɛ n s i a
disseminada	d i s e m i n 'a ð a	d i s e m i n 'a ð a
teratogènic	t e ɾ a t o d ʒ 'ɛ n i k	t e ɾ a t o d ʒ 'ɛ n i k
cosac	k o z 'a k	k o z 'a k
seleccionades	s e l e k s i o n 'a ð e s	s e l e k s i o n 'a ð e s
Lèxic	l 'ɛ k s i k	l 'ɛ k s i k
digestiu	d i d ʒ e s t 'i w	d i d ʒ e s t 'i w
estímuls	a s t 'i m u l s	a s t 'i m u l s
mantindran	m a n t i n d ɾ 'a n	m a n t i n d ɾ 'a n
bonir	b o n 'i ɾ	b o n 'i ɾ
capturar	k a p t u ɾ 'a ɾ	k a p t u ɾ 'a ɾ
escatologia	a s k a t o l o d ʒ 'i a	a s k a t o l o d ʒ 'i a
valgudes	v a l ɣ 'u ð e s	v a l ɣ 'u ð e s
penedit	p e n e ð 'i t	p e n e ð 'i t
Potent	p o t 'e n t	p o t 'e n t
advenir	a d v e n 'i ɾ	a d v e n 'i ɾ
polsegosa	p o l s e ɣ 'o z a	p o l s e ɣ 'o z a
alabat	a l a β 'a t	a l a β 'a t
japonesos	d ʒ a p o n 'e z o s	d ʒ a p o n 'e z o s
batut	b a t 'u t	b a t 'u t
nuca	n 'u k a	n 'u k a
curta	k 'u ɾ t a	k 'u ɾ t a
telefonades	t e l e f o n 'a ð e s	t e l e f o n 'a ð e s
apuntat	a p u n t 'a t	a p u n t 'a t
erri	'ɛ r i	'ɛ r i
negada	n e ɣ 'a ð a	n e ɣ 'a ð a
vegueries	v e ɣ e ɾ 'i e s	v e ɣ e ɾ 'i e s
mussola	m u s 'ɔ l a	m u s 'ɔ l a
visqui	v 'i s k i	v 'i s k i
Morir	m o ɾ 'i ɾ	m o ɾ 'i ɾ
portar	p o ɾ t 'a ɾ	p o ɾ t 'a ɾ
destil·lada	d e s t i l 'a ð a	d e s t i l 'a ð a
encertar	a n s e ɾ t 'a ɾ	a n s e ɾ t 'a ɾ
observadora	o p s e ɾ v a ð 'o ɾ a	o p s e ɾ v a ð 'o ɾ a
Estarem	a s t a ɾ 'e m	a s t a ɾ 'e m
privades	p ɾ i v 'a ð e s	p ɾ i v 'a ð e s
bocarruda	b o k a r 'u ð a	b o k a r 'u ð a
equació	e k w a s i 'o	e k w a s i 'o
agrònoma	a ɣ ɾ 'ɔ n o m a	a ɣ ɾ 'ɔ n o m a
d'aspecte	d a s p 'ɛ k t e	d a s p 'ɛ k t e
gamba	g 'a m b a	g 'a m b a
Boll	b 'o ʎ	b 'o ʎ
abastéssim	a β a s t 'e s i m	a β a s t 'e s i m
juràssic	d ʒ u ɾ 'a s i k	d ʒ u ɾ 'a s i k
inicis	i n 'i s i s	i n 'i s i s
deixà	d e j ʃ 'a	d e j ʃ 'a
complerta	k o m p l 'ɛ ɾ t a	k o m p l 'ɛ ɾ t a
impedit	i m p e ð 'i t	i m p e ð 'i t
teclejant	t e k l e d ʒ 'a n t	t e k l e d ʒ 'a n t
clergues	k l 'ɛ ɾ ɣ e s	k l 'ɛ ɾ ɣ e s
cometia	k o m e t 'i a	k o m e t 'i a
destructible	d e s t ɾ u k t 'i β l e	d e s t ɾ u k t 'i β l e
enllestir	a n ʎ e s t 'i ɾ	a n ʎ e s t 'i ɾ
arrogant	a r o ɣ 'a n t	a r o ɣ 'a n t
orals	o ɾ 'a l s	o ɾ 'a l s
acreditar	a k ɾ e ð i t 'a ɾ	a k ɾ e ð i t 'a ɾ
corona	k o ɾ 'o n a	k o ɾ 'o n a
dilatada	d i l a t 'a ð a	d i l a t 'a ð a
l'adequada	l a ð e k w 'a ð a	l a ð e k w 'a ð a
golf	g 'o l f	g 'o l f
postulada	p o s t u l 'a ð a	p o s t u l 'a ð a
disfrutats	d i s f ɾ u t 'a t s	d i s f ɾ u t 'a t s
esquerperia	a s k e ɾ p e ɾ 'i a	a s k e ɾ p e ɾ 'i a
desbrossà	d e z β ɾ o s 'a	d e z β ɾ o s 'a
universitari	u n i v e ɾ s i t 'a ɾ i	u n i v e ɾ s i t 'a ɾ i
calavera	k a l a v 'e ɾ a	k a l a v 'e ɾ a
àmnica	'a m n i k a	'a m n i k a
afectades	a f e k t 'a ð e s	a f e k t 'a ð e s
externes	e k s t 'ɛ ɾ n e s	e k s t 'ɛ ɾ n e s
quedaràs	k e ð a ɾ 'a s	k e ð a ɾ 'a s
sensual	s e n s u 'a l	s e n s u 'a l
manx	m 'a n t ʃ	m 'a n t ʃ
xicra	t ʃ 'i k ɾ a	t ʃ 'i k ɾ a
afillar	a f i ʎ 'a ɾ	a f i ʎ 'a ɾ
passejades	p a s e d ʒ 'a ð e s	p a s e d ʒ 'a ð e s
votades	v o t 'a ð e s	v o t 'a ð e s
cartes	k 'a ɾ t e s	k 'a ɾ t e s
àlgides	'a l d ʒ i ð e s	'a l d ʒ i ð e s
premiades	p ɾ e m i 'a ð e s	p ɾ e m i 'a ð e s
curses	k 'u ɾ s e s	k 'u ɾ s e s
retenir	r e t e n 'i ɾ	r e t e n 'i ɾ
fabricats	f a β ɾ i k 'a t s	f a β ɾ i k 'a t s
encaputxat	a ŋ k a p u t ʃ 'a t	a ŋ k a p u t ʃ 'a t
jònics	d ʒ 'ɔ n i k s	d ʒ 'ɔ n i k s
estrat	a s t ɾ 'a t	a s t ɾ 'a t
greixó	g ɾ e j ʃ 'o	g ɾ e j ʃ 'o
pel·lícules	p e l 'i k u l e s	p e l 'i k u l e s
patrocina	p a t ɾ o s 'i n a	p a t ɾ o s 'i n a
perruquera	p e r u k 'e ɾ a	p e r u k 'e ɾ a
embutxacades	a m b u t ʃ a k 'a ð e s	a m b u t ʃ a k 'a ð e s
tinguí	t i ŋ g 'i	t i ŋ g 'i
formant	f o ɾ m 'a n t	f o ɾ m 'a n t
cromatismes	k ɾ o m a t 'i z m e s	k ɾ o m a t 'i z m e s
estrenats	a s t ɾ e n 'a t s	a s t ɾ e n 'a t s
escarxofats	a s k a ɾ t ʃ o f 'a t s	a s k a ɾ t ʃ o f 'a t s
màniga	m 'a n i ɣ a	m 'a n i ɣ a
actuo	a k t 'u o	a k t 'u o
Cursos	k 'u ɾ s o s	k 'u ɾ s o s
encaminats	a ŋ k a m i n 'a t s	a ŋ k a m i n 'a t s
quilla	k 'i ʎ a	k 'i ʎ a
cínic	s 'i n i k	s 'i n i k
legitimat	l e d ʒ i t i m 'a t	l e d ʒ i t i m 'a t
reuniu	r e u n 'i w	r e u n 'i w
colonoscopi	k o l o n o s k 'ɔ p i	k o l o n o s k 'ɔ p i
l'una	l 'u n a	l 'u n a
inserció	i n s e ɾ s i 'o	i n s e ɾ s i 'o
despertà	d e s p e ɾ t 'a	d e s p e ɾ t 'a
alfòndec	a l f 'ɔ n d e k	a l f 'ɔ n d e k
fundadors	f u n d a ð 'o ɾ s	f u n d a ð 'o ɾ s
oliver	o l i v 'e ɾ	o l i v 'e ɾ
comprarà	k o m p ɾ a ɾ 'a	k o m p ɾ a ɾ 'a
eixarmar	e j ʃ a ɾ m 'a ɾ	e j ʃ a ɾ m 'a ɾ
batre	b 'a t ɾ e	b 'a t ɾ e
carcaix	k a ɾ k 'a j ʃ	k a ɾ k 'a j ʃ
depressió	d e p ɾ e s i 'o	d e p ɾ e s i 'o
insulto	i n s 'u l t o	i n s 'u l t o
repetia	r e p e t 'i a	r e p e t 'i a
pandèmia	p a n d 'ɛ m i a	p a n d 'ɛ m i a
avivar	a v i v 'a ɾ	a v i v 'a ɾ
ira	'i ɾ a	'i ɾ a
perfumats	p e ɾ f u m 'a t s	p e ɾ f u m 'a t s
canalla	k a n 'a ʎ a	k a n 'a ʎ a
conspiracions	k o n s p i ɾ a s i 'o n s	k o n s p i ɾ a s i 'o n s
Medir	m e ð 'i ɾ	m e ð 'i ɾ
va	v 'a	v 'a
d'individus	d i n d i v 'i ð u s	d i n d i v 'i ð u s
flotades	f l o t 'a ð e s	f l o t 'a ð e s
aparegut	a p a ɾ e ɣ 'u t	a p a ɾ e ɣ 'u t
rull	r 'u ʎ	r 'u ʎ
favull	f a v 'u ʎ	f a v 'u ʎ
mul	m 'u l	m 'u l
ambientades	a m b i e n t 'a ð e s	a m b i e n t 'a ð e s
repúbliques	r e p 'u β l i k e s	r e p 'u β l i k e s
càtedres	k 'a t e ð ɾ e s	k 'a t e ð ɾ e s
accés	a k s 'e s	a k s 'e s
adonat	a ð o n 'a t	a ð o n 'a t
buscant	b u s k 'a n t	b u s k 'a n t
alauita	a l a w 'i t a	a l a w 'i t a
bobinada	b o β i n 'a ð a	b o β i n 'a ð a
xerrant	t ʃ e r 'a n t	t ʃ e r 'a n t
persistits	p e ɾ s i s t 'i t s	p e ɾ s i s t 'i t s
pillarda	p i ʎ 'a ɾ ð a	p i ʎ 'a ɾ ð a
ajaguts	a d ʒ a ɣ 'u t s	a d ʒ a ɣ 'u t s
faldiller	f a l d i ʎ 'e ɾ	f a l d i ʎ 'e ɾ
venerades	v e n e ɾ 'a ð e s	v e n e ɾ 'a ð e s
treballa	t ɾ e β 'a ʎ a	t ɾ e β 'a ʎ a
desbloquejades	d e z β l o k e d ʒ 'a ð e s	d e z β l o k e d ʒ 'a ð e s
sala	s 'a l a	s 'a l a
brasiler	b ɾ a z i l 'e ɾ	b ɾ a z i l 'e ɾ
artefactes	a ɾ t e f 'a k t e s	a ɾ t e f 'a k t e s
descarregades	d e s k a r e ɣ 'a ð e s	d e s k a r e ɣ 'a ð e s
admires	a d m 'i ɾ e s	a d m 'i ɾ e s
caiguts	k a j ɣ 'u t s	k a j ɣ 'u t s
caminat	k a m i n 'a t	k a m i n 'a t
preocupada	p ɾ e o k u p 'a ð a	p ɾ e o k u p 'a ð a
empipada	a m p i p 'a ð a	a m p i p 'a ð a
tossut	t o s 'u t	t o s 'u t
valgut	v a l ɣ 'u t	v a l ɣ 'u t
quètxup	k 'ɛ t ʃ u p	k 'ɛ t ʃ u p
morfina	m o ɾ f 'i n a	m o ɾ f 'i n a
fornicació	f o ɾ n i k a s i 'o	f o ɾ n i k a s i 'o
intrigada	i n t ɾ i ɣ 'a ð a	i n t ɾ i ɣ 'a ð a
Actual	a k t u 'a l	a k t u 'a l
adaptador	a ð a p t a ð 'o ɾ	a ð a p t a ð 'o ɾ
primitiva	p ɾ i m i t 'i v a	p ɾ i m i t 'i v a
classifiquen	k l a s i f 'i k e n	k l a s i f 'i k e n
conduccions	k o n d u k s i 'o n s	k o n d u k s i 'o n s
àpat	'a p a t	'a p a t
faller	f a ʎ 'e ɾ	f a ʎ 'e ɾ
hesitades	e z i t 'a ð e s	e z i t 'a ð e s
inhabilitar	i n a β i l i t 'a ɾ	i n a β i l i t 'a ɾ
olis	'ɔ l i s	'ɔ l i s
necessitaríem	n e s e s i t a ɾ 'i e m	n e s e s i t a ɾ 'i e m
protònica	p ɾ o t 'ɔ n i k a	p ɾ o t 'ɔ n i k a
vesícula	v e z 'i k u l a	v e z 'i k u l a
sèu	s 'ɛ w	s 'ɛ w
volés	v o l 'e s	v o l 'e s
gelor	d ʒ e l 'o ɾ	d ʒ e l 'o ɾ
arc	'a ɾ k	'a ɾ k
consumicions	k o n s u m i s i 'o n s	k o n s u m i s i 'o n s
bloquis	b l 'ɔ k i s	b l 'ɔ k i s
dominicana	d o m i n i k 'a n a	d o m i n i k 'a n a
Alcoià	a l k o j 'a	a l k o j 'a
honorífic	o n o ɾ 'i f i k	o n o ɾ 'i f i k
boxar	b o k s 'a ɾ	b o k s 'a ɾ
coc	k 'ɔ k	k 'ɔ k
sinàptiques	s i n 'a p t i k e s	s i n 'a p t i k e s
plasmar	p l a z m 'a ɾ	p l a z m 'a ɾ
alegrar-los	a l e ɣ ɾ 'a ɾ l o s	a l e ɣ ɾ 'a ɾ l o s
estesa	a s t 'e z a	a s t 'e z a
bug	b 'u k	b 'u k
caràcter	k a ɾ 'a k t e ɾ	k a ɾ 'a k t e ɾ
arrasada	a r a z 'a ð a	a r a z 'a ð a
habilitada	a β i l i t 'a ð a	a β i l i t 'a ð a
abrogar	a β ɾ o ɣ 'a ɾ	a β ɾ o ɣ 'a ɾ
n'anés	n a n 'e s	n a n 'e s
evitar-los	e v i t 'a ɾ l o s	e v i t 'a ɾ l o s
lentilla	l e n t 'i ʎ a	l e n t 'i ʎ a
acreditades	a k ɾ e ð i t 'a ð e s	a k ɾ e ð i t 'a ð e s
resultada	r e z u l t 'a ð a	r e z u l t 'a ð a
apinyar	a p i ɲ 'a ɾ	a p i ɲ 'a ɾ
grandiós	g ɾ a n d i 'o s	g ɾ a n d i 'o s
mantí	m a n t 'i	m a n t 'i
xifrada	t ʃ i f ɾ 'a ð a	t ʃ i f ɾ 'a ð a
fres	f ɾ 'ɛ s	f ɾ 'ɛ s
antracosis	a n t ɾ a k 'ɔ z i s	a n t ɾ a k 'ɔ z i s
contravingut	k o n t ɾ a v i ŋ g 'u t	k o n t ɾ a v i ŋ g 'u t
consentides	k o n s e n t 'i ð e s	k o n s e n t 'i ð e s
tonguis	t 'ɔ ŋ g i s	t 'ɔ ŋ g i s
impulsa	i m p 'u l s a	i m p 'u l s a
merescut	m e ɾ e s k 'u t	m e ɾ e s k 'u t
anglòfoba	a ŋ g l 'ɔ f o β a	a ŋ g l 'ɔ f o β a
conill	k o n 'i ʎ	k o n 'i ʎ
emmalaltida	a m m a l a l t 'i ð a	a m m a l a l t 'i ð a
lucrats	l u k ɾ 'a t s	l u k ɾ 'a t s
dura	d 'u ɾ a	d 'u ɾ a
adeliciat	a ð e l i s i 'a t	a ð e l i s i 'a t
complicaria	k o m p l i k a ɾ 'i a	k o m p l i k a ɾ 'i a
descobrir	d e s k o β ɾ 'i ɾ	d e s k o β ɾ 'i ɾ
vexatori	v e k s a t 'ɔ ɾ i	v e k s a t 'ɔ ɾ i
Cornellà	k o ɾ n e ʎ 'a	k o ɾ n e ʎ 'a
cantants	k a n t 'a n s	k a n t 'a n s
rebel·lar	r e β e l 'a ɾ	r e β e l 'a ɾ
pintallavis	p i n t a ʎ 'a v i s	p i n t a ʎ 'a v i s
podrit	p o ð ɾ 'i t	p o ð ɾ 'i t
fèrrica	f 'ɛ r i k a	f 'ɛ r i k a
fruiterar	f ɾ w i t e ɾ 'a ɾ	f ɾ w i t e ɾ 'a ɾ
caldria	k a l d ɾ 'i a	k a l d ɾ 'i a
anés	a n 'e s	a n 'e s
ambaixada	a m b a j ʃ 'a ð a	a m b a j ʃ 'a ð a
obrer	o β ɾ 'e ɾ	o β ɾ 'e ɾ
complicades	k o m p l i k 'a ð e s	k o m p l i k 'a ð e s
salva	s 'a l v a	s 'a l v a
col·locades	k o l o k 'a ð e s	k o l o k 'a ð e s
levitar	l e v i t 'a ɾ	l e v i t 'a ɾ
Forestal	f o ɾ e s t 'a l	f o ɾ e s t 'a l
neoplàsies	n e o p l 'a z i e s	n e o p l 'a z i e s
sofraja	s o f ɾ 'a d ʒ a	s o f ɾ 'a d ʒ a
antediluvians	a n t e ð i l u v i 'a n s	a n t e ð i l u v i 'a n s
duquessa	d u k 'e s a	d u k 'e s a
distingida	d i s t i n d ʒ 'i ð a	d i s t i n d ʒ 'i ð a
valsar	v a l s 'a ɾ	v a l s 'a ɾ
escapes	a s k 'a p e s	a s k 'a p e s
quilos	k 'i l o s	k 'i l o s
cartutx	k a ɾ t 'u t ʃ	k a ɾ t 'u t ʃ
manteniment	m a n t e n i m 'e n t	m a n t e n i m 'e n t
prohibides	p ɾ o i β 'i ð e s	p ɾ o i β 'i ð e s
avança	a v 'a n s a	a v 'a n s a
perpetuar	p e ɾ p e t u 'a ɾ	p e ɾ p e t u 'a ɾ
metzinós	m e d z i n 'o s	m e d z i n 'o s
ratificades	r a t i f i k 'a ð e s	r a t i f i k 'a ð e s
argumental	a ɾ ɣ u m e n t 'a l	a ɾ ɣ u m e n t 'a l
l'anorac	l a n o ɾ 'a k	l a n o ɾ 'a k
buscats	b u s k 'a t s	b u s k 'a t s
flotis	f l 'ɔ t i s	f l 'ɔ t i s
sòlit	s 'ɔ l i t	s 'ɔ l i t
despotisme	d e s p o t 'i z m e	d e s p o t 'i z m e
afrontada	a f ɾ o n t 'a ð a	a f ɾ o n t 'a ð a
s'adreça	s a ð ɾ 'e s a	s a ð ɾ 'e s a
obrer	o β ɾ 'e ɾ	o β ɾ 'e ɾ
vehicular	v e i k u l 'a ɾ	v e i k u l 'a ɾ
iònics	i 'ɔ n i k s	i 'ɔ n i k s
prostitució	p ɾ o s t i t u s i 'o	p ɾ o s t i t u s i 'o
maçònic	m a s 'ɔ n i k	m a s 'ɔ n i k
d'algú	d a l ɣ 'u	d a l ɣ 'u
aviant	a v i 'a n t	a v i 'a n t
romana	r o m 'a n a	r o m 'a n a
encreuats	a ŋ k ɾ e w 'a t s	a ŋ k ɾ e w 'a t s
clericat	k l e ɾ i k 'a t	k l e ɾ i k 'a t
pugui	p 'u ɣ i	p 'u ɣ i
escalunya	a s k a l 'u ɲ a	a s k a l 'u ɲ a
escènica	a s 'ɛ n i k a	a s 'ɛ n i k a
cooperat	k o o p e ɾ 'a t	k o o p e ɾ 'a t
Tarragona	t a r a ɣ 'o n a	t a r a ɣ 'o n a
mil·lilitre	m i l i l 'i t ɾ e	m i l i l 'i t ɾ e
instrument	i n s t ɾ u m 'e n t	i n s t ɾ u m 'e n t
ambientats	a m b i e n t 'a t s	a m b i e n t 'a t s
alcalins	a l k a l 'i n s	a l k a l 'i n s
purgatori	p u ɾ ɣ a t 'ɔ ɾ i	p u ɾ ɣ a t 'ɔ ɾ i
bústies	b 'u s t i e s	b 'u s t i e s
llistes	ʎ 'i s t e s	ʎ 'i s t e s
carismàtics	k a ɾ i z m 'a t i k s	k a ɾ i z m 'a t i k s
ànims	'a n i m s	'a n i m s
toquis	t 'ɔ k i s	t 'ɔ k i s
estovar	a s t o v 'a ɾ	a s t o v 'a ɾ
imbricades	i m b ɾ i k 'a ð e s	i m b ɾ i k 'a ð e s
defenestrar	d e f e n e s t ɾ 'a ɾ	d e f e n e s t ɾ 'a ɾ
ecològiques	e k o l 'ɔ d ʒ i k e s	e k o l 'ɔ d ʒ i k e s
trenquen	t ɾ 'e ŋ k e n	t ɾ 'e ŋ k e n
exposada	e k s p o z 'a ð a	e k s p o z 'a ð a
abaixàreu	a β a j ʃ 'a ɾ e w	a β a j ʃ 'a ɾ e w
conductes	k o n d 'u k t e s	k o n d 'u k t e s
hipotètic	i p o t 'ɛ t i k	i p o t 'ɛ t i k
empallar	a m p a ʎ 'a ɾ	a m p a ʎ 'a ɾ
gramàtica	g ɾ a m 'a t i k a	g ɾ a m 'a t i k a
abastés	a β a s t 'e s	a β a s t 'e s
gorjut	g o ɾ d ʒ 'u t	g o ɾ d ʒ 'u t
atacar	a t a k 'a ɾ	a t a k 'a ɾ
Club	k l 'u p	k l 'u p
vessada	v e s 'a ð a	v e s 'a ð a
degotejar	d e ɣ o t e d ʒ 'a ɾ	d e ɣ o t e d ʒ 'a ɾ
corrompuda	k o r o m p 'u ð a	k o r o m p 'u ð a
batalló	b a t a ʎ 'o	b a t a ʎ 'o
malvenut	m a l v e n 'u t	m a l v e n 'u t
capada	k a p 'a ð a	k a p 'a ð a
medicina	m e ð i s 'i n a	m e ð i s 'i n a
publicitat	p u β l i s i t 'a t	p u β l i s i t 'a t
esponjaren	a s p o n d ʒ 'a ɾ e n	a s p o n d ʒ 'a ɾ e n
abatis	a β 'a t i s	a β 'a t i s
aportats	a p o ɾ t 'a t s	a p o ɾ t 'a t s
celtibèric	s e l t i β 'ɛ ɾ i k	s e l t i β 'ɛ ɾ i k
Jonc	d ʒ 'o ŋ k	d ʒ 'o ŋ k
personalitats	p e ɾ s o n a l i t 'a t s	p e ɾ s o n a l i t 'a t s
mústigues	m 'u s t i ɣ e s	m 'u s t i ɣ e s
Assís	a s 'i s	a s 'i s
coquetejant	k o k e t e d ʒ 'a n t	k o k e t e d ʒ 'a n t
additives	a d d i t 'i v e s	a d d i t 'i v e s
plurilingüisme	p l u ɾ i l i ŋ g w 'i z m e	p l u ɾ i l i ŋ g w 'i z m e
pronunciar	p ɾ o n u n s i 'a ɾ	p ɾ o n u n s i 'a ɾ
habitual	a β i t u 'a l	a β i t u 'a l
punia	p u n 'i a	p u n 'i a
periodicitat	p e ɾ i o ð i s i t 'a t	p e ɾ i o ð i s i t 'a t
d'extremar	d e k s t ɾ e m 'a ɾ	d e k s t ɾ e m 'a ɾ
borrall	b o r 'a ʎ	b o r 'a ʎ
regadora	r e ɣ a ð 'o ɾ a	r e ɣ a ð 'o ɾ a
l'Alta	l 'a l t a	l 'a l t a
aproximant	a p ɾ o k s i m 'a n t	a p ɾ o k s i m 'a n t
Can	k 'a n	k 'a n
xopat	t ʃ o p 'a t	t ʃ o p 'a t
linx	l 'i n t ʃ	l 'i n t ʃ
temperada	t e m p e ɾ 'a ð a	t e m p e ɾ 'a ð a
orina	o ɾ 'i n a	o ɾ 'i n a
xopar	t ʃ o p 'a ɾ	t ʃ o p 'a ɾ
intrusió	i n t ɾ u z i 'o	i n t ɾ u z i 'o
saure	s 'a w ɾ e	s 'a w ɾ e
limitaven	l i m i t 'a v e n	l i m i t 'a v e n
emmalaltits	a m m a l a l t 'i t s	a m m a l a l t 'i t s
estrella	a s t ɾ 'e ʎ a	a s t ɾ 'e ʎ a
graduar	g ɾ a ð u 'a ɾ	g ɾ a ð u 'a ɾ
cuscuta	k u s k 'u t a	k u s k 'u t a
útil	'u t i l	'u t i l
equivalent	e k i v a l 'e n t	e k i v a l 'e n t
furà	f u ɾ 'a	f u ɾ 'a
temor	t e m 'o ɾ	t e m 'o ɾ
vacil·lats	v a s i l 'a t s	v a s i l 'a t s
discrets	d i s k ɾ 'e t s	d i s k ɾ 'e t s
himnes	'i m n e s	'i m n e s
llardosos	ʎ a ɾ ð 'o z o s	ʎ a ɾ ð 'o z o s
llegien	ʎ e d ʒ 'i e n	ʎ e d ʒ 'i e n
desaconsellada	d e z a k o n s e ʎ 'a ð a	d e z a k o n s e ʎ 'a ð a
considerades	k o n s i ð e ɾ 'a ð e s	k o n s i ð e ɾ 'a ð e s
aixecat	a j ʃ e k 'a t	a j ʃ e k 'a t
eclipsat	e k l i p s 'a t	e k l i p s 'a t
dediquem	d e ð i k 'e m	d e ð i k 'e m
classe	k l 'a s e	k l 'a s e
estomacats	a s t o m a k 'a t s	a s t o m a k 'a t s
endauat	a n d a w 'a t	a n d a w 'a t
parlis	p 'a ɾ l i s	p 'a ɾ l i s
guanyar	g w a ɲ 'a ɾ	g w a ɲ 'a ɾ
justesa	d ʒ u s t 'e z a	d ʒ u s t 'e z a
S'instal·laran	s i n s t a l a ɾ 'a n	s i n s t a l a ɾ 'a n
despullades	d e s p u ʎ 'a ð e s	d e s p u ʎ 'a ð e s
m'amaga	m a m 'a ɣ a	m a m 'a ɣ a
entesos	a n t 'e z o s	a n t 'e z o s
pròrroga	p ɾ 'ɔ r o ɣ a	p ɾ 'ɔ r o ɣ a
decapitat	d e k a p i t 'a t	d e k a p i t 'a t
domin	d 'ɔ m i n	d 'ɔ m i n
pristins	p ɾ i s t 'i n s	p ɾ i s t 'i n s
macedònic	m a s e ð 'ɔ n i k	m a s e ð 'ɔ n i k
aeronàutiques	a e ɾ o n 'a w t i k e s	a e ɾ o n 'a w t i k e s
perversitat	p e ɾ v e ɾ s i t 'a t	p e ɾ v e ɾ s i t 'a t
lubricant	l u β ɾ i k 'a n t	l u β ɾ i k 'a n t
picarda	p i k 'a ɾ ð a	p i k 'a ɾ ð a
Quin	k 'i n	k 'i n
tirà	t i ɾ 'a	t i ɾ 'a
encalçats	a ŋ k a l s 'a t s	a ŋ k a l s 'a t s
birmanes	b i ɾ m 'a n e s	b i ɾ m 'a n e s
antílop	a n t 'i l o p	a n t 'i l o p
Levític	l e v 'i t i k	l e v 'i t i k
alçats	a l s 'a t s	a l s 'a t s
avinagrat	a v i n a ɣ ɾ 'a t	a v i n a ɣ ɾ 'a t
Selva	s 'ɛ l v a	s 'ɛ l v a
domtat	d o m t 'a t	d o m t 'a t
esmentades	a z m e n t 'a ð e s	a z m e n t 'a ð e s
litúrgiques	l i t 'u ɾ d ʒ i k e s	l i t 'u ɾ d ʒ i k e s
centèsim	s e n t 'ɛ z i m	s e n t 'ɛ z i m
vella	v 'e ʎ a	v 'e ʎ a
incendis	i n s 'ɛ n d i s	i n s 'ɛ n d i s
agençats	a d ʒ e n s 'a t s	a d ʒ e n s 'a t s
moblat	m o β l 'a t	m o β l 'a t
accedits	a k s e ð 'i t s	a k s e ð 'i t s
falange	f a l 'a n d ʒ e	f a l 'a n d ʒ e
exacte	e g z 'a k t e	e g z 'a k t e
contaminant	k o n t a m i n 'a n t	k o n t a m i n 'a n t
amenaçador	a m e n a s a ð 'o ɾ	a m e n a s a ð 'o ɾ
frenades	f ɾ e n 'a ð e s	f ɾ e n 'a ð e s
ocellets	o s e ʎ 'e t s	o s e ʎ 'e t s
vani	v 'a n i	v 'a n i
acceptarem	a k s e p t a ɾ 'e m	a k s e p t a ɾ 'e m
Macau	m a k 'a w	m a k 'a w
orfisme	o ɾ f 'i z m e	o ɾ f 'i z m e
depredat	d e p ɾ e ð 'a t	d e p ɾ e ð 'a t
cromàtics	k ɾ o m 'a t i k s	k ɾ o m 'a t i k s
alguns	a l ɣ 'u n s	a l ɣ 'u n s
Mont	m 'o n t	m 'o n t
cervell	s e ɾ v 'e ʎ	s e ɾ v 'e ʎ
reciprocitat	r e s i p ɾ o s i t 'a t	r e s i p ɾ o s i t 'a t
gràcies	g ɾ 'a s i e s	g ɾ 'a s i e s
embrear	a m b ɾ e 'a ɾ	a m b ɾ e 'a ɾ
garlanda	g a ɾ l 'a n d a	g a ɾ l 'a n d a
aliades	a l i 'a ð e s	a l i 'a ð e s
marrana	m a r 'a n a	m a r 'a n a
sondejats	s o n d e d ʒ 'a t s	s o n d e d ʒ 'a t s
baralla	b a ɾ 'a ʎ a	b a ɾ 'a ʎ a
traçabilitat	t ɾ a s a β i l i t 'a t	t ɾ a s a β i l i t 'a t
expenedor	e k s p e n e ð 'o ɾ	e k s p e n e ð 'o ɾ
goma	g 'o m a	g 'o m a
Valeri	v a l 'ɛ ɾ i	v a l 'ɛ ɾ i
superàvits	s u p e ɾ 'a v i t s	s u p e ɾ 'a v i t s
vagons	v a ɣ 'o n s	v a ɣ 'o n s
falsejat	f a l s e d ʒ 'a t	f a l s e d ʒ 'a t
afalagat	a f a l a ɣ 'a t	a f a l a ɣ 'a t
clàssica	k l 'a s i k a	k l 'a s i k a
assessor	a s e s 'o ɾ	a s e s 'o ɾ
alba	'a l β a	'a l β a
avèstic	a v 'ɛ s t i k	a v 'ɛ s t i k
colpejat	k o l p e d ʒ 'a t	k o l p e d ʒ 'a t
pedicura	p e ð i k 'u ɾ a	p e ð i k 'u ɾ a
sollis	s 'ɔ ʎ i s	s 'ɔ ʎ i s
urticària	u ɾ t i k 'a ɾ i a	u ɾ t i k 'a ɾ i a
arqueoastronòmica	a ɾ k e o a s t ɾ o n 'ɔ m i k a	a ɾ k e o a s t ɾ o n 'ɔ m i k a
cordat	k o ɾ ð 'a t	k o ɾ ð 'a t
neguitós	n e ɣ i t 'o s	n e ɣ i t 'o s
primala	p ɾ i m 'a l a	p ɾ i m 'a l a
escombrades	a s k o m b ɾ 'a ð e s	a s k o m b ɾ 'a ð e s
pregunta	p ɾ e ɣ 'u n t a	p ɾ e ɣ 'u n t a
subdirectoris	s u b d i ɾ e k t 'ɔ ɾ i s	s u b d i ɾ e k t 'ɔ ɾ i s
minúscules	m i n 'u s k u l e s	m i n 'u s k u l e s
estadístiques	a s t a ð 'i s t i k e s	a s t a ð 'i s t i k e s
herètiques	e ɾ 'ɛ t i k e s	e ɾ 'ɛ t i k e s
despert	d e s p 'ɛ ɾ t	d e s p 'ɛ ɾ t
graduada	g ɾ a ð u 'a ð a	g ɾ a ð u 'a ð a
llardó	ʎ a ɾ ð 'o	ʎ a ɾ ð 'o
pau	p 'a w	p 'a w
referents	r e f e ɾ 'e n s	r e f e ɾ 'e n s
vibrares	v i β ɾ 'a ɾ e s	v i β ɾ 'a ɾ e s
diaris	d i 'a ɾ i s	d i 'a ɾ i s
quart	k w 'a ɾ t	k w 'a ɾ t
congregació	k o ŋ g ɾ e ɣ a s i 'o	k o ŋ g ɾ e ɣ a s i 'o
debanar	d e β a n 'a ɾ	d e β a n 'a ɾ
reemplaçats	r e e m p l a s 'a t s	r e e m p l a s 'a t s
fugida	f u d ʒ 'i ð a	f u d ʒ 'i ð a
literatures	l i t e ɾ a t 'u ɾ e s	l i t e ɾ a t 'u ɾ e s
veganisme	v e ɣ a n 'i z m e	v e ɣ a n 'i z m e
dissuasiva	d i s u a z 'i v a	d i s u a z 'i v a
venjatiu	v e n d ʒ a t 'i w	v e n d ʒ a t 'i w
classismes	k l a s 'i z m e s	k l a s 'i z m e s
percussió	p e ɾ k u s i 'o	p e ɾ k u s i 'o
afermar	a f e ɾ m 'a ɾ	a f e ɾ m 'a ɾ
italià	i t a l i 'a	i t a l i 'a
cerç	s 'ɛ ɾ s	s 'ɛ ɾ s
escoltat	a s k o l t 'a t	a s k o l t 'a t
escapo	a s k 'a p o	a s k 'a p o
segellat	s e d ʒ e ʎ 'a t	s e d ʒ e ʎ 'a t
artèria	a ɾ t 'ɛ ɾ i a	a ɾ t 'ɛ ɾ i a
Abelard	a β e l 'a ɾ t	a β e l 'a ɾ t
Andorra	a n d 'o r a	a n d 'o r a
estadístics	a s t a ð 'i s t i k s	a s t a ð 'i s t i k s
dropa	d ɾ 'ɔ p a	d ɾ 'ɔ p a
L'àrea	l 'a ɾ e a	l 'a ɾ e a
temprança	t e m p ɾ 'a n s a	t e m p ɾ 'a n s a
cirrus	s 'i r u s	s 'i r u s
garfir	g a ɾ f 'i ɾ	g a ɾ f 'i ɾ
carretera	k a r e t 'e ɾ a	k a r e t 'e ɾ a
espirar	a s p i ɾ 'a ɾ	a s p i ɾ 'a ɾ
mamba	m 'a m b a	m 'a m b a
plorat	p l o ɾ 'a t	p l o ɾ 'a t
contrada	k o n t ɾ 'a ð a	k o n t ɾ 'a ð a
preparar	p ɾ e p a ɾ 'a ɾ	p ɾ e p a ɾ 'a ɾ
claudàtor	k l a w ð 'a t o ɾ	k l a w ð 'a t o ɾ
planta	p l 'a n t a	p l 'a n t a
reestructurat	r e e s t ɾ u k t u ɾ 'a t	r e e s t ɾ u k t u ɾ 'a t
denuncien	d e n u n s 'i e n	d e n u n s 'i e n
dictadura	d i k t a ð 'u ɾ a	d i k t a ð 'u ɾ a
dracs	d ɾ 'a k s	d ɾ 'a k s
bullida	b u ʎ 'i ð a	b u ʎ 'i ð a
vulnerat	v u l n e ɾ 'a t	v u l n e ɾ 'a t
vetades	v e t 'a ð e s	v e t 'a ð e s
llevar	ʎ e v 'a ɾ	ʎ e v 'a ɾ
Raval	r a v 'a l	r a v 'a l
asseguro	a s e ɣ 'u ɾ o	a s e ɣ 'u ɾ o
rodalies	r o ð a l 'i e s	r o ð a l 'i e s
terrejar	t e r e d ʒ 'a ɾ	t e r e d ʒ 'a ɾ
contractat	k o n t ɾ a k t 'a t	k o n t ɾ a k t 'a t
dedicació	d e ð i k a s i 'o	d e ð i k a s i 'o
resultats	r e z u l t 'a t s	r e z u l t 'a t s
d'accés	d a k s 'e s	d a k s 'e s
esclatat	a s k l a t 'a t	a s k l a t 'a t
pastitx	p a s t 'i t ʃ	p a s t 'i t ʃ
deformi	d e f 'ɔ ɾ m i	d e f 'ɔ ɾ m i
Vés	v 'e s	v 'e s
resen	r 'e z e n	r 'e z e n
llevades	ʎ e v 'a ð e s	ʎ e v 'a ð e s
rar	r 'a ɾ	r 'a ɾ
enemics	e n e m 'i k s	e n e m 'i k s
embolica	a m b o l 'i k a	a m b o l 'i k a
ressaltat	r e s a l t 'a t	r e s a l t 'a t
enemistat	e n e m i s t 'a t	e n e m i s t 'a t
frase	f ɾ 'a z e	f ɾ 'a z e
ressentiment	r e s e n t i m 'e n t	r e s e n t i m 'e n t
clissades	k l i s 'a ð e s	k l i s 'a ð e s
agafada	a ɣ a f 'a ð a	a ɣ a f 'a ð a
recobrat	r e k o β ɾ 'a t	r e k o β ɾ 'a t
potàssica	p o t 'a s i k a	p o t 'a s i k a
sentir	s e n t 'i ɾ	s e n t 'i ɾ
altiplans	a l t i p l 'a n s	a l t i p l 'a n s
escalfa	a s k 'a l f a	a s k 'a l f a
disseminar	d i s e m i n 'a ɾ	d i s e m i n 'a ɾ
cúbit	k 'u β i t	k 'u β i t
penell	p e n 'e ʎ	p e n 'e ʎ
falcó	f a l k 'o	f a l k 'o
esportiva	a s p o ɾ t 'i v a	a s p o ɾ t 'i v a
patriòtic	p a t ɾ i 'ɔ t i k	p a t ɾ i 'ɔ t i k
promocional	p ɾ o m o s i o n 'a l	p ɾ o m o s i o n 'a l
dinovena	d i n o v 'e n a	d i n o v 'e n a
llibres	ʎ 'i β ɾ e s	ʎ 'i β ɾ e s
ordinari	o ɾ ð i n 'a ɾ i	o ɾ ð i n 'a ɾ i
trenquen	t ɾ 'e ŋ k e n	t ɾ 'e ŋ k e n
conquilla	k o ŋ k 'i ʎ a	k o ŋ k 'i ʎ a
prevenir	p ɾ e v e n 'i ɾ	p ɾ e v e n 'i ɾ
concentrats	k o n s e n t ɾ 'a t s	k o n s e n t ɾ 'a t s
curats	k u ɾ 'a t s	k u ɾ 'a t s
definició	d e f i n i s i 'o	d e f i n i s i 'o
deteriorats	d e t e ɾ i o ɾ 'a t s	d e t e ɾ i o ɾ 'a t s
poca	p 'ɔ k a	p 'ɔ k a
despert	d e s p 'ɛ ɾ t	d e s p 'ɛ ɾ t
moment	m o m 'e n t	m o m 'e n t
ordi	'ɔ ɾ ð i	'ɔ ɾ ð i
dissemina	d i s e m 'i n a	d i s e m 'i n a
lúdiques	l 'u ð i k e s	l 'u ð i k e s
diví	d i v 'i	d i v 'i
estúpidament	a s t 'u p i ð a m 'e n t	a s t 'u p i ð a m 'e n t
perpetues	p e ɾ p e t 'u e s	p e ɾ p e t 'u e s
furat	f u ɾ 'a t	f u ɾ 'a t
apàtrides	a p 'a t ɾ i ð e s	a p 'a t ɾ i ð e s
situació	s i t u a s i 'o	s i t u a s i 'o
generat	d ʒ e n e ɾ 'a t	d ʒ e n e ɾ 'a t
incaic	i ŋ k 'a j k	i ŋ k 'a j k
aprofita	a p ɾ o f 'i t a	a p ɾ o f 'i t a
palmer	p a l m 'e ɾ	p a l m 'e ɾ
preguntar	p ɾ e ɣ u n t 'a ɾ	p ɾ e ɣ u n t 'a ɾ
in	'i n	'i n
àtom	'a t o m	'a t o m
necrosi	n e k ɾ 'ɔ z i	n e k ɾ 'ɔ z i
axil·la	a k s 'i l a	a k s 'i l a
franciscana	f ɾ a n s i s k 'a n a	f ɾ a n s i s k 'a n a
Més	m 'e s	m 'e s
elevada	e l e v 'a ð a	e l e v 'a ð a
commemorat	k o m m e m o ɾ 'a t	k o m m e m o ɾ 'a t
ontologia	o n t o l o d ʒ 'i a	o n t o l o d ʒ 'i a
obrir	o β ɾ 'i ɾ	o β ɾ 'i ɾ
basa	b 'a z a	b 'a z a
tallat	t a ʎ 'a t	t a ʎ 'a t
baríton	b a ɾ 'i t o n	b a ɾ 'i t o n
escup	a s k 'u p	a s k 'u p
harpia	a ɾ p 'i a	a ɾ p 'i a
travessava	t ɾ a v e s 'a v a	t ɾ a v e s 'a v a
exposar-ho	e k s p o z 'a ɾ o	e k s p o z 'a ɾ o
secreta	s e k ɾ 'e t a	s e k ɾ 'e t a
torrencial	t o r e n s i 'a l	t o r e n s i 'a l
carnavals	k a ɾ n a v 'a l s	k a ɾ n a v 'a l s
ajudada	a d ʒ u ð 'a ð a	a d ʒ u ð 'a ð a
asolellat	a z o l e ʎ 'a t	a z o l e ʎ 'a t
miraven	m i ɾ 'a v e n	m i ɾ 'a v e n
adquisició	a t k i z i s i 'o	a t k i z i s i 'o
palpitació	p a l p i t a s i 'o	p a l p i t a s i 'o
pixapins	p i ʃ a p 'i n s	p i ʃ a p 'i n s
diaca	d i 'a k a	d i 'a k a
sorrar	s o r 'a ɾ	s o r 'a ɾ
beduí	b e ð u 'i	b e ð u 'i
merder	m e ɾ ð 'e ɾ	m e ɾ ð 'e ɾ
fragmentats	f ɾ a g m e n t 'a t s	f ɾ a g m e n t 'a t s
cotxet	k o t ʃ 'e t	k o t ʃ 'e t
moguis	m 'ɔ ɣ i s	m 'ɔ ɣ i s
trencador	t ɾ e ŋ k a ð 'o ɾ	t ɾ e ŋ k a ð 'o ɾ
nosaltres	n o z 'a l t ɾ e s	n o z 'a l t ɾ e s
dibuixaven	d i β u j ʃ 'a v e n	d i β u j ʃ 'a v e n
feliços	f e l 'i s o s	f e l 'i s o s
datares	d a t 'a ɾ e s	d a t 'a ɾ e s
Gavà	g a v 'a	g a v 'a
cavalls	k a v 'a ʎ s	k a v 'a ʎ s
aglans	a ɣ l 'a n s	a ɣ l 'a n s
físics	f 'i z i k s	f 'i z i k s
poalanca	p o a l 'a ŋ k a	p o a l 'a ŋ k a
l'angle	l 'a ŋ g l e	l 'a ŋ g l e
apregonar	a p ɾ e ɣ o n 'a ɾ	a p ɾ e ɣ o n 'a ɾ
verola	v e ɾ 'ɔ l a	v e ɾ 'ɔ l a
pàl·lidament	p 'a l i ð a m 'e n t	p 'a l i ð a m 'e n t
negociós	n e ɣ o s i 'o s	n e ɣ o s i 'o s
esbotzada	a z β o d z 'a ð a	a z β o d z 'a ð a
educat	e ð u k 'a t	e ð u k 'a t
dotat	d o t 'a t	d o t 'a t
africà	a f ɾ i k 'a	a f ɾ i k 'a
drusa	d ɾ 'u z a	d ɾ 'u z a
tècniques	t 'ɛ g n i k e s	t 'ɛ g n i k e s
kurd	k 'u ɾ t	k 'u ɾ t
empinar	a m p i n 'a ɾ	a m p i n 'a ɾ
vinc	v 'i ŋ k	v 'i ŋ k
Interna	i n t 'ɛ ɾ n a	i n t 'ɛ ɾ n a
bany	b 'a ɲ	b 'a ɲ
columnista	k o l u m n 'i s t a	k o l u m n 'i s t a
delimitat	d e l i m i t 'a t	d e l i m i t 'a t
anomena	a n o m 'e n a	a n o m 'e n a
morta	m 'ɔ ɾ t a	m 'ɔ ɾ t a
depilar-me	d e p i l 'a ɾ m e	d e p i l 'a ɾ m e
mendastre	m e n d 'a s t ɾ e	m e n d 'a s t ɾ e
compatriota	k o m p a t ɾ i 'ɔ t a	k o m p a t ɾ i 'ɔ t a
súplica	s 'u p l i k a	s 'u p l i k a
pagar	p a ɣ 'a ɾ	p a ɣ 'a ɾ
ocultat	o k u l t 'a t	o k u l t 'a t
deceptives	d e s e p t 'i v e s	d e s e p t 'i v e s
firmar	f i ɾ m 'a ɾ	f i ɾ m 'a ɾ
arrossegades	a r o s e ɣ 'a ð e s	a r o s e ɣ 'a ð e s
crepitar	k ɾ e p i t 'a ɾ	k ɾ e p i t 'a ɾ
esforçades	a s f o ɾ s 'a ð e s	a s f o ɾ s 'a ð e s
Priorat	p ɾ i o ɾ 'a t	p ɾ i o ɾ 'a t
forjo	f 'ɔ ɾ d ʒ o	f 'ɔ ɾ d ʒ o
gorga	g 'ɔ ɾ ɣ a	g 'ɔ ɾ ɣ a
esperadíssims	a s p e ɾ a ð 'i s i m s	a s p e ɾ a ð 'i s i m s
angèlica	a n d ʒ 'ɛ l i k a	a n d ʒ 'ɛ l i k a
esperança	a s p e ɾ 'a n s a	a s p e ɾ 'a n s a
farcir	f a ɾ s 'i ɾ	f a ɾ s 'i ɾ
Base	b 'a z e	b 'a z e
coiot	k o j 'ɔ t	k o j 'ɔ t
afirmava	a f i ɾ m 'a v a	a f i ɾ m 'a v a
multiplataforma	m u l t i p l a t a f 'ɔ ɾ m a	m u l t i p l a t a f 'ɔ ɾ m a
aromar	a ɾ o m 'a ɾ	a ɾ o m 'a ɾ
acte	'a k t e	'a k t e
esperit	a s p e ɾ 'i t	a s p e ɾ 'i t
depauperar	d e p a w p e ɾ 'a ɾ	d e p a w p e ɾ 'a ɾ
criptograma	k ɾ i p t o ɣ ɾ 'a m a	k ɾ i p t o ɣ ɾ 'a m a
presagis	p ɾ e z 'a d ʒ i s	p ɾ e z 'a d ʒ i s
Imagino	i m a d ʒ 'i n o	i m a d ʒ 'i n o
escaldar	a s k a l d 'a ɾ	a s k a l d 'a ɾ
aïllades	a i ʎ 'a ð e s	a i ʎ 'a ð e s
pic	p 'i k	p 'i k
platejar	p l a t e d ʒ 'a ɾ	p l a t e d ʒ 'a ɾ
ambientada	a m b i e n t 'a ð a	a m b i e n t 'a ð a
Teníem	t e n 'i e m	t e n 'i e m
remaràs	r e m a ɾ 'a s	r e m a ɾ 'a s
destina	d e s t 'i n a	d e s t 'i n a
privada	p ɾ i v 'a ð a	p ɾ i v 'a ð a
dentuda	d e n t 'u ð a	d e n t 'u ð a
cireres	s i ɾ 'e ɾ e s	s i ɾ 'e ɾ e s
cuguços	k u ɣ 'u s o s	k u ɣ 'u s o s
modèlica	m o ð 'ɛ l i k a	m o ð 'ɛ l i k a
lamentar	l a m e n t 'a ɾ	l a m e n t 'a ɾ
armilla	a ɾ m 'i ʎ a	a ɾ m 'i ʎ a
accionari	a k s i o n 'a ɾ i	a k s i o n 'a ɾ i
pelut	p e l 'u t	p e l 'u t
agressivitat	a ɣ ɾ e s i v i t 'a t	a ɣ ɾ e s i v i t 'a t
abominat	a β o m i n 'a t	a β o m i n 'a t
televisiu	t e l e v i z 'i w	t e l e v i z 'i w
litografia	l i t o ɣ ɾ a f 'i a	l i t o ɣ ɾ a f 'i a
L'heroïna	l e ɾ o 'i n a	l e ɾ o 'i n a
disposa	d i s p 'o z a	d i s p 'o z a
Rodes	r 'ɔ ð e s	r 'ɔ ð e s
coreografiar	k o ɾ e o ɣ ɾ a f i 'a ɾ	k o ɾ e o ɣ ɾ a f i 'a ɾ
fugitives	f u d ʒ i t 'i v e s	f u d ʒ i t 'i v e s
Estimo	a s t 'i m o	a s t 'i m o
catàleg	k a t 'a l e k	k a t 'a l e k
vorejat	v o ɾ e d ʒ 'a t	v o ɾ e d ʒ 'a t
Talteüll	t a l t e 'u ʎ	t a l t e 'u ʎ
retòrcer	r e t 'ɔ ɾ s e ɾ	r e t 'ɔ ɾ s e ɾ
rabejar	r a β e d ʒ 'a ɾ	r a β e d ʒ 'a ɾ
Indoxina	i n d o k s 'i n a	i n d o k s 'i n a
tén	t 'e n	t 'e n
ningú	n i ŋ g 'u	n i ŋ g 'u
abraçada	a β ɾ a s 'a ð a	a β ɾ a s 'a ð a
bacarà	b a k a ɾ 'a	b a k a ɾ 'a
adobat	a ð o β 'a t	a ð o β 'a t
desperto	d e s p 'ɛ ɾ t o	d e s p 'ɛ ɾ t o
usades	u z 'a ð e s	u z 'a ð e s
procariòtica	p ɾ o k a ɾ i 'ɔ t i k a	p ɾ o k a ɾ i 'ɔ t i k a
basades	b a z 'a ð e s	b a z 'a ð e s
esbombat	a z β o m b 'a t	a z β o m b 'a t
censuro	s e n s 'u ɾ o	s e n s 'u ɾ o
grat	g ɾ 'a t	g ɾ 'a t
oxidada	o k s i ð 'a ð a	o k s i ð 'a ð a
vital	v i t 'a l	v i t 'a l
monoparental	m o n o p a ɾ e n t 'a l	m o n o p a ɾ e n t 'a l
aufrany	a w f ɾ 'a ɲ	a w f ɾ 'a ɲ
lilà	l i l 'a	l i l 'a
pongui	p 'ɔ ŋ g i	p 'ɔ ŋ g i
finançat	f i n a n s 'a t	f i n a n s 'a t
humiliar	u m i l i 'a ɾ	u m i l i 'a ɾ
imbècil	i m b 'ɛ s i l	i m b 'ɛ s i l
colga	k 'ɔ l ɣ a	k 'ɔ l ɣ a
saciada	s a s i 'a ð a	s a s i 'a ð a
recipient	r e s i p i 'e n t	r e s i p i 'e n t
elegides	e l e d ʒ 'i ð e s	e l e d ʒ 'i ð e s
semblada	s e m b l 'a ð a	s e m b l 'a ð a
escollits	a s k o ʎ 'i t s	a s k o ʎ 'i t s
paramilitar	p a ɾ a m i l i t 'a ɾ	p a ɾ a m i l i t 'a ɾ
cupaire	k u p 'a j ɾ e	k u p 'a j ɾ e
usat	u z 'a t	u z 'a t
carregada	k a r e ɣ 'a ð a	k a r e ɣ 'a ð a
fanàtic	f a n 'a t i k	f a n 'a t i k
papereta	p a p e ɾ 'e t a	p a p e ɾ 'e t a
consternat	k o n s t e ɾ n 'a t	k o n s t e ɾ n 'a t
bato	b 'a t o	b 'a t o
regulat	r e ɣ u l 'a t	r e ɣ u l 'a t
oficial	o f i s i 'a l	o f i s i 'a l
lateral	l a t e ɾ 'a l	l a t e ɾ 'a l
dolçamara	d o l s a m 'a ɾ a	d o l s a m 'a ɾ a
arruinats	a r w i n 'a t s	a r w i n 'a t s
aluminat	a l u m i n 'a t	a l u m i n 'a t
ronyós	r o ɲ 'o s	r o ɲ 'o s
denominada	d e n o m i n 'a ð a	d e n o m i n 'a ð a
bosnià	b o z n i 'a	b o z n i 'a
comercial	k o m e ɾ s i 'a l	k o m e ɾ s i 'a l
jugares	d ʒ u ɣ 'a ɾ e s	d ʒ u ɣ 'a ɾ e s
garota	g a ɾ 'ɔ t a	g a ɾ 'ɔ t a
ran	r 'a n	r 'a n
assajos	a s 'a d ʒ o s	a s 'a d ʒ o s
bagenc	b a d ʒ 'e ŋ k	b a d ʒ 'e ŋ k
creador	k ɾ e a ð 'o ɾ	k ɾ e a ð 'o ɾ
acústic	a k 'u s t i k	a k 'u s t i k
endògam	a n d 'ɔ ɣ a m	a n d 'ɔ ɣ a m
acceptar	a k s e p t 'a ɾ	a k s e p t 'a ɾ
amades	a m 'a ð e s	a m 'a ð e s
àlep	'a l e p	'a l e p
resina	r e z 'i n a	r e z 'i n a
Àvila	'a v i l a	'a v i l a
concentrar-me	k o n s e n t ɾ 'a ɾ m e	k o n s e n t ɾ 'a ɾ m e
esquí	a s k 'i	a s k 'i
quasi	k w 'a z i	k w 'a z i
consultant	k o n s u l t 'a n t	k o n s u l t 'a n t
estarien	a s t a ɾ 'i e n	a s t a ɾ 'i e n
occident	o k s i ð 'e n t	o k s i ð 'e n t
salvat	s a l v 'a t	s a l v 'a t
dionisíac	d i o n i z 'i a k	d i o n i z 'i a k
deuteronomista	d e w t e ɾ o n o m 'i s t a	d e w t e ɾ o n o m 'i s t a
capsular	k a p s u l 'a ɾ	k a p s u l 'a ɾ
mudats	m u ð 'a t s	m u ð 'a t s
abrupte	a β ɾ 'u p t e	a β ɾ 'u p t e
miliard	m i l i 'a ɾ t	m i l i 'a ɾ t
exhauria	e g z a w ɾ 'i a	e g z a w ɾ 'i a
copta	k 'ɔ p t a	k 'ɔ p t a
queixal	k e j ʃ 'a l	k e j ʃ 'a l
caucionar	k a w s i o n 'a ɾ	k a w s i o n 'a ɾ
coïssor	k o i s 'o ɾ	k o i s 'o ɾ
canals	k a n 'a l s	k a n 'a l s
pondré	p o n d ɾ 'e	p o n d ɾ 'e
gironí	d ʒ i ɾ o n 'i	d ʒ i ɾ o n 'i
màquines	m 'a k i n e s	m 'a k i n e s
austríaca	a w s t ɾ 'i a k a	a w s t ɾ 'i a k a
vehicles	v e 'i k l e s	v e 'i k l e s
morfològics	m o ɾ f o l 'ɔ d ʒ i k s	m o ɾ f o l 'ɔ d ʒ i k s
agroalimentàries	a ɣ ɾ o a l i m e n t 'a ɾ i e s	a ɣ ɾ o a l i m e n t 'a ɾ i e s
individualista	i n d i v i ð u a l 'i s t a	i n d i v i ð u a l 'i s t a
perits	p e ɾ 'i t s	p e ɾ 'i t s
comunions	k o m u n i 'o n s	k o m u n i 'o n s
capitulada	k a p i t u l 'a ð a	k a p i t u l 'a ð a
ombrós	o m b ɾ 'o s	o m b ɾ 'o s
bastança	b a s t 'a n s a	b a s t 'a n s a
l'asfalt	l a s f 'a l t	l a s f 'a l t
exculpada	e k s k u l p 'a ð a	e k s k u l p 'a ð a
contistes	k o n t 'i s t e s	k o n t 'i s t e s
calcificar	k a l s i f i k 'a ɾ	k a l s i f i k 'a ɾ
osqui	'ɔ s k i	'ɔ s k i
ferit	f e ɾ 'i t	f e ɾ 'i t
perillós	p e ɾ i ʎ 'o s	p e ɾ i ʎ 'o s
vingut	v i ŋ g 'u t	v i ŋ g 'u t
Navarra	n a v 'a r a	n a v 'a r a
abrasiva	a β ɾ a z 'i v a	a β ɾ a z 'i v a
compràreu	k o m p ɾ 'a ɾ e w	k o m p ɾ 'a ɾ e w
prorrogacions	p ɾ o r o ɣ a s i 'o n s	p ɾ o r o ɣ a s i 'o n s
inserits	i n s e ɾ 'i t s	i n s e ɾ 'i t s
patrullar	p a t ɾ u ʎ 'a ɾ	p a t ɾ u ʎ 'a ɾ
cerimònia	s e ɾ i m 'ɔ n i a	s e ɾ i m 'ɔ n i a
vincla	v 'i ŋ k l a	v 'i ŋ k l a
ubiqui	u β 'i k i	u β 'i k i
comoditat	k o m o ð i t 'a t	k o m o ð i t 'a t
Segur	s e ɣ 'u ɾ	s e ɣ 'u ɾ
cefàlica	s e f 'a l i k a	s e f 'a l i k a
consum	k o n s 'u m	k o n s 'u m
pinça	p 'i n s a	p 'i n s a
andola	a n d 'ɔ l a	a n d 'ɔ l a
decora	d e k 'o ɾ a	d e k 'o ɾ a
commemoratives	k o m m e m o ɾ a t 'i v e s	k o m m e m o ɾ a t 'i v e s
locutori	l o k u t 'ɔ ɾ i	l o k u t 'ɔ ɾ i
milionari	m i l i o n 'a ɾ i	m i l i o n 'a ɾ i
gaire	g 'a j ɾ e	g 'a j ɾ e
ratar	r a t 'a ɾ	r a t 'a ɾ
desnivell	d e z n i v 'e ʎ	d e z n i v 'e ʎ
llencen	ʎ 'e n s e n	ʎ 'e n s e n
netejats	n e t e d ʒ 'a t s	n e t e d ʒ 'a t s
frustres	f ɾ 'u s t ɾ e s	f ɾ 'u s t ɾ e s
fracció	f ɾ a k s i 'o	f ɾ a k s i 'o
provocats	p ɾ o v o k 'a t s	p ɾ o v o k 'a t s
astronòmic	a s t ɾ o n 'ɔ m i k	a s t ɾ o n 'ɔ m i k
androgèniques	a n d ɾ o d ʒ 'ɛ n i k e s	a n d ɾ o d ʒ 'ɛ n i k e s
creadora	k ɾ e a ð 'o ɾ a	k ɾ e a ð 'o ɾ a
protònics	p ɾ o t 'ɔ n i k s	p ɾ o t 'ɔ n i k s
carolí	k a ɾ o l 'i	k a ɾ o l 'i
clamor	k l a m 'o ɾ	k l a m 'o ɾ
caravanes	k a ɾ a v 'a n e s	k a ɾ a v 'a n e s
detonats	d e t o n 'a t s	d e t o n 'a t s
fèl·lera	f 'ɛ l e ɾ a	f 'ɛ l e ɾ a
diversos	d i v 'ɛ ɾ s o s	d i v 'ɛ ɾ s o s
fornal	f o ɾ n 'a l	f o ɾ n 'a l
citades	s i t 'a ð e s	s i t 'a ð e s
ridículs	r i ð 'i k u l s	r i ð 'i k u l s
companyes	k o m p 'a ɲ e s	k o m p 'a ɲ e s
emmarcat	a m m a ɾ k 'a t	a m m a ɾ k 'a t
halibut	a l i β 'u t	a l i β 'u t
delegades	d e l e ɣ 'a ð e s	d e l e ɣ 'a ð e s
morruda	m o r 'u ð a	m o r 'u ð a
incompatibilitat	i ŋ k o m p a t i β i l i t 'a t	i ŋ k o m p a t i β i l i t 'a t
pòlissa	p 'ɔ l i s a	p 'ɔ l i s a
consumir	k o n s u m 'i ɾ	k o n s u m 'i ɾ
remadors	r e m a ð 'o ɾ s	r e m a ð 'o ɾ s
felices	f e l 'i s e s	f e l 'i s e s
meditades	m e ð i t 'a ð e s	m e ð i t 'a ð e s
Amic	a m 'i k	a m 'i k
postular	p o s t u l 'a ɾ	p o s t u l 'a ɾ
Només	n o m 'e s	n o m 'e s
zumzejar	z u m z e d ʒ 'a ɾ	z u m z e d ʒ 'a ɾ
avinagrar	a v i n a ɣ ɾ 'a ɾ	a v i n a ɣ ɾ 'a ɾ
udolada	u ð o l 'a ð a	u ð o l 'a ð a
benefici	b e n e f 'i s i	b e n e f 'i s i
empalat	a m p a l 'a t	a m p a l 'a t
impartides	i m p a ɾ t 'i ð e s	i m p a ɾ t 'i ð e s
gravades	g ɾ a v 'a ð e s	g ɾ a v 'a ð e s
fesomia	f e z o m 'i a	f e z o m 'i a
sencer	s e n s 'e ɾ	s e n s 'e ɾ
planto	p l 'a n t o	p l 'a n t o
sopades	s o p 'a ð e s	s o p 'a ð e s
oncològic	o ŋ k o l 'ɔ d ʒ i k	o ŋ k o l 'ɔ d ʒ i k
impulsiva	i m p u l s 'i v a	i m p u l s 'i v a
desintegraria	d e z i n t e ɣ ɾ a ɾ 'i a	d e z i n t e ɣ ɾ a ɾ 'i a
llàntia	ʎ 'a n t i a	ʎ 'a n t i a
davantal	d a v a n t 'a l	d a v a n t 'a l
minuciositat	m i n u s i o z i t 'a t	m i n u s i o z i t 'a t
estatuts	a s t a t 'u t s	a s t a t 'u t s
tenor	t e n 'o ɾ	t e n 'o ɾ
Farallons	f a ɾ a ʎ 'o n s	f a ɾ a ʎ 'o n s
antics	a n t 'i k s	a n t 'i k s
alçar	a l s 'a ɾ	a l s 'a ɾ
droguen	d ɾ 'ɔ ɣ e n	d ɾ 'ɔ ɣ e n
coreans	k o ɾ e 'a n s	k o ɾ e 'a n s
col·loqui	k o l 'ɔ k i	k o l 'ɔ k i
absorcions	a p s o ɾ s i 'o n s	a p s o ɾ s i 'o n s
angèlic	a n d ʒ 'ɛ l i k	a n d ʒ 'ɛ l i k
natura	n a t 'u ɾ a	n a t 'u ɾ a
tarifa	t a ɾ 'i f a	t a ɾ 'i f a
moldau	m o l d 'a w	m o l d 'a w
preparar	p ɾ e p a ɾ 'a ɾ	p ɾ e p a ɾ 'a ɾ
cinematogràfic	s i n e m a t o ɣ ɾ 'a f i k	s i n e m a t o ɣ ɾ 'a f i k
Llibre	ʎ 'i β ɾ e	ʎ 'i β ɾ e
condicionà	k o n d i s i o n 'a	k o n d i s i o n 'a
d'amagat	d a m a ɣ 'a t	d a m a ɣ 'a t
corredissa	k o r e ð 'i s a	k o r e ð 'i s a
dolorada	d o l o ɾ 'a ð a	d o l o ɾ 'a ð a
multitudinaris	m u l t i t u ð i n 'a ɾ i s	m u l t i t u ð i n 'a ɾ i s
càmfora	k 'a m f o ɾ a	k 'a m f o ɾ a
batallades	b a t a ʎ 'a ð e s	b a t a ʎ 'a ð e s
terra	t 'ɛ r a	t 'ɛ r a
situava	s i t u 'a v a	s i t u 'a v a
d'Any	d 'a ɲ	d 'a ɲ
tenim	t e n 'i m	t e n 'i m
llimadura	ʎ i m a ð 'u ɾ a	ʎ i m a ð 'u ɾ a
malastre	m a l 'a s t ɾ e	m a l 'a s t ɾ e
dames	d 'a m e s	d 'a m e s
delicte	d e l 'i k t e	d e l 'i k t e
besalú	b e z a l 'u	b e z a l 'u
inicio	i n i s 'i o	i n i s 'i o
alegrar	a l e ɣ ɾ 'a ɾ	a l e ɣ ɾ 'a ɾ
nominades	n o m i n 'a ð e s	n o m i n 'a ð e s
d'Alacant	d a l a k 'a n t	d a l a k 'a n t
identitats	i ð e n t i t 'a t s	i ð e n t i t 'a t s
inoblidable	i n o β l i ð 'a β l e	i n o β l i ð 'a β l e
judaïtzar	d ʒ u ð a i d z 'a ɾ	d ʒ u ð a i d z 'a ɾ
ressaca	r e s 'a k a	r e s 'a k a
solitari	s o l i t 'a ɾ i	s o l i t 'a ɾ i
cabalístic	k a β a l 'i s t i k	k a β a l 'i s t i k
purificar	p u ɾ i f i k 'a ɾ	p u ɾ i f i k 'a ɾ
gamma	g 'a m m a	g 'a m m a
arrapats	a r a p 'a t s	a r a p 'a t s
cessió	s e s i 'o	s e s i 'o
requerir	r e k e ɾ 'i ɾ	r e k e ɾ 'i ɾ
gujarati	g u d ʒ a ɾ 'a t i	g u d ʒ a ɾ 'a t i
transgredits	t ɾ a n z ɣ ɾ e ð 'i t s	t ɾ a n z ɣ ɾ e ð 'i t s
humans	u m 'a n s	u m 'a n s
panarra	p a n 'a r a	p a n 'a r a
escull	a s k 'u ʎ	a s k 'u ʎ
respectiu	r e s p e k t 'i w	r e s p e k t 'i w
insurgents	i n s u ɾ d ʒ 'e n s	i n s u ɾ d ʒ 'e n s
dutxat	d u t ʃ 'a t	d u t ʃ 'a t
frau	f ɾ 'a w	f ɾ 'a w
vern	v 'ɛ ɾ n	v 'ɛ ɾ n
canins	k a n 'i n s	k a n 'i n s
arronsat	a r o n s 'a t	a r o n s 'a t
averar	a v e ɾ 'a ɾ	a v e ɾ 'a ɾ
engendrada	a n d ʒ e n d ɾ 'a ð a	a n d ʒ e n d ɾ 'a ð a
cooperat	k o o p e ɾ 'a t	k o o p e ɾ 'a t
actes	'a k t e s	'a k t e s
pala	p 'a l a	p 'a l a
constatació	k o n s t a t a s i 'o	k o n s t a t a s i 'o
apartat	a p a ɾ t 'a t	a p a ɾ t 'a t
munyida	m u ɲ 'i ð a	m u ɲ 'i ð a
adoptares	a ð o p t 'a ɾ e s	a ð o p t 'a ɾ e s
expletiva	e k s p l e t 'i v a	e k s p l e t 'i v a
evadit	e v a ð 'i t	e v a ð 'i t
explorant	e k s p l o ɾ 'a n t	e k s p l o ɾ 'a n t
sospitar	s o s p i t 'a ɾ	s o s p i t 'a ɾ
intrínseca	i n t ɾ 'i n s e k a	i n t ɾ 'i n s e k a
posats	p o z 'a t s	p o z 'a t s
anomenat	a n o m e n 'a t	a n o m e n 'a t
implicats	i m p l i k 'a t s	i m p l i k 'a t s
escarrassat	a s k a r a s 'a t	a s k a r a s 'a t
menopàusica	m e n o p 'a w z i k a	m e n o p 'a w z i k a
clític	k l 'i t i k	k l 'i t i k
primerenc	p ɾ i m e ɾ 'e ŋ k	p ɾ i m e ɾ 'e ŋ k
sonades	s o n 'a ð e s	s o n 'a ð e s
integració	i n t e ɣ ɾ a s i 'o	i n t e ɣ ɾ a s i 'o
teratogènica	t e ɾ a t o d ʒ 'ɛ n i k a	t e ɾ a t o d ʒ 'ɛ n i k a
fixar	f i k s 'a ɾ	f i k s 'a ɾ
acollida	a k o ʎ 'i ð a	a k o ʎ 'i ð a
tinta	t 'i n t a	t 'i n t a
jurídica	d ʒ u ɾ 'i ð i k a	d ʒ u ɾ 'i ð i k a
lladró	ʎ a ð ɾ 'o	ʎ a ð ɾ 'o
argiles	a ɾ d ʒ 'i l e s	a ɾ d ʒ 'i l e s
grups	g ɾ 'u p s	g ɾ 'u p s
excitats	e k s i t 'a t s	e k s i t 'a t s
peninsulars	p e n i n s u l 'a ɾ s	p e n i n s u l 'a ɾ s
compartits	k o m p a ɾ t 'i t s	k o m p a ɾ t 'i t s
ara	'a ɾ a	'a ɾ a
excoriar	e k s k o ɾ i 'a ɾ	e k s k o ɾ i 'a ɾ
doctorada	d o k t o ɾ 'a ð a	d o k t o ɾ 'a ð a
Govern	g o v 'ɛ ɾ n	g o v 'ɛ ɾ n
servents	s e ɾ v 'e n s	s e ɾ v 'e n s
Entren	'e n t ɾ e n	'e n t ɾ e n
epònim	e p 'ɔ n i m	e p 'ɔ n i m
enquestar	a ŋ k e s t 'a ɾ	a ŋ k e s t 'a ɾ
sopada	s o p 'a ð a	s o p 'a ð a
farem	f a ɾ 'e m	f a ɾ 'e m
novetat	n o v e t 'a t	n o v e t 'a t
lluna	ʎ 'u n a	ʎ 'u n a
D'on	d 'o n	d 'o n
Niça	n 'i s a	n 'i s a
escalat	a s k a l 'a t	a s k a l 'a t
puntilles	p u n t 'i ʎ e s	p u n t 'i ʎ e s
rabut	r a β 'u t	r a β 'u t
inclinada	i ŋ k l i n 'a ð a	i ŋ k l i n 'a ð a
panera	p a n 'e ɾ a	p a n 'e ɾ a
orgasme	o ɾ ɣ 'a z m e	o ɾ ɣ 'a z m e
llargues	ʎ 'a ɾ ɣ e s	ʎ 'a ɾ ɣ e s
deliberats	d e l i β e ɾ 'a t s	d e l i β e ɾ 'a t s
l'avanç	l a v 'a n s	l a v 'a n s
kannada	k a n n 'a ð a	k a n n 'a ð a
andí	a n d 'i	a n d 'i
gats	g 'a t s	g 'a t s
concurrència	k o ŋ k u r 'ɛ n s i a	k o ŋ k u r 'ɛ n s i a
nenes	n 'e n e s	n 'e n e s
robatori	r o β a t 'ɔ ɾ i	r o β a t 'ɔ ɾ i
esforçada	a s f o ɾ s 'a ð a	a s f o ɾ s 'a ð a
l'atònita	l a t 'ɔ n i t a	l a t 'ɔ n i t a
llit	ʎ 'i t	ʎ 'i t
ràpida	r 'a p i ð a	r 'a p i ð a
pair	p a 'i ɾ	p a 'i ɾ
laiques	l 'a j k e s	l 'a j k e s
menopàusiques	m e n o p 'a w z i k e s	m e n o p 'a w z i k e s
ritual	r i t u 'a l	r i t u 'a l
beguina	b e ɣ 'i n a	b e ɣ 'i n a
ajupit	a d ʒ u p 'i t	a d ʒ u p 'i t
doblats	d o β l 'a t s	d o β l 'a t s
nanisme	n a n 'i z m e	n a n 'i z m e
aquilí	a k i l 'i	a k i l 'i
emmalaltides	a m m a l a l t 'i ð e s	a m m a l a l t 'i ð e s
ginya	d ʒ 'i ɲ a	d ʒ 'i ɲ a
hagués	a ɣ 'e s	a ɣ 'e s
tirotejar	t i ɾ o t e d ʒ 'a ɾ	t i ɾ o t e d ʒ 'a ɾ
afilaria	a f i l a ɾ 'i a	a f i l a ɾ 'i a
Callas	k 'a ʎ a s	k 'a ʎ a s
exultat	e g z u l t 'a t	e g z u l t 'a t
digital	d i d ʒ i t 'a l	d i d ʒ i t 'a l
teatre	t e 'a t ɾ e	t e 'a t ɾ e
forrellat	f o r e ʎ 'a t	f o r e ʎ 'a t
místic	m 'i s t i k	m 'i s t i k
operadors	o p e ɾ a ð 'o ɾ s	o p e ɾ a ð 'o ɾ s
puniu	p u n 'i w	p u n 'i w
incitació	i n s i t a s i 'o	i n s i t a s i 'o
paleòlegs	p a l e 'ɔ l e k s	p a l e 'ɔ l e k s
màrtir	m 'a ɾ t i ɾ	m 'a ɾ t i ɾ
assedegat	a s e ð e ɣ 'a t	a s e ð e ɣ 'a t
l'Homo	l 'ɔ m o	l 'ɔ m o
corregit	k o r e d ʒ 'i t	k o r e d ʒ 'i t
adormida	a ð o ɾ m 'i ð a	a ð o ɾ m 'i ð a
planímetre	p l a n 'i m e t ɾ e	p l a n 'i m e t ɾ e
dita	d 'i t a	d 'i t a
fotocopiada	f o t o k o p i 'a ð a	f o t o k o p i 'a ð a
explicat	e k s p l i k 'a t	e k s p l i k 'a t
sicofanta	s i k o f 'a n t a	s i k o f 'a n t a
declarava	d e k l a ɾ 'a v a	d e k l a ɾ 'a v a
safranada	s a f ɾ a n 'a ð a	s a f ɾ a n 'a ð a
venerares	v e n e ɾ 'a ɾ e s	v e n e ɾ 'a ɾ e s
cilindrats	s i l i n d ɾ 'a t s	s i l i n d ɾ 'a t s
anunciades	a n u n s i 'a ð e s	a n u n s i 'a ð e s
bran	b ɾ 'a n	b ɾ 'a n
traslladen	t ɾ a z ʎ 'a ð e n	t ɾ a z ʎ 'a ð e n
fotògraf	f o t 'ɔ ɣ ɾ a f	f o t 'ɔ ɣ ɾ a f
papaia	p a p 'a j a	p a p 'a j a
projectat	p ɾ o d ʒ e k t 'a t	p ɾ o d ʒ e k t 'a t
tenacitat	t e n a s i t 'a t	t e n a s i t 'a t
especificada	a s p e s i f i k 'a ð a	a s p e s i f i k 'a ð a
incolor	i ŋ k o l 'o ɾ	i ŋ k o l 'o ɾ
tomar	t o m 'a ɾ	t o m 'a ɾ
retirar	r e t i ɾ 'a ɾ	r e t i ɾ 'a ɾ
sumeri	s u m 'ɛ ɾ i	s u m 'ɛ ɾ i
Perpinyà	p e ɾ p i ɲ 'a	p e ɾ p i ɲ 'a
perfil	p e ɾ f 'i l	p e ɾ f 'i l
ciàtica	s i 'a t i k a	s i 'a t i k a
esglaons	a z ɣ l a 'o n s	a z ɣ l a 'o n s
perquisicionar	p e ɾ k i z i s i o n 'a ɾ	p e ɾ k i z i s i o n 'a ɾ
pecadora	p e k a ð 'o ɾ a	p e k a ð 'o ɾ a
globina	g l o β 'i n a	g l o β 'i n a
belis	b 'ɛ l i s	b 'ɛ l i s
separades	s e p a ɾ 'a ð e s	s e p a ɾ 'a ð e s
coronari	k o ɾ o n 'a ɾ i	k o ɾ o n 'a ɾ i
sentència	s e n t 'ɛ n s i a	s e n t 'ɛ n s i a
berenada	b e ɾ e n 'a ð a	b e ɾ e n 'a ð a
desfer	d e s f 'e ɾ	d e s f 'e ɾ
testimoniar	t e s t i m o n i 'a ɾ	t e s t i m o n i 'a ɾ
apinyats	a p i ɲ 'a t s	a p i ɲ 'a t s
cagaria	k a ɣ a ɾ 'i a	k a ɣ a ɾ 'i a
activitat	a k t i v i t 'a t	a k t i v i t 'a t
vaccines	v a k s 'i n e s	v a k s 'i n e s
polèmic	p o l 'ɛ m i k	p o l 'ɛ m i k
sonor	s o n 'o ɾ	s o n 'o ɾ
rovellat	r o v e ʎ 'a t	r o v e ʎ 'a t
espanyar	a s p a ɲ 'a ɾ	a s p a ɲ 'a ɾ
oncològica	o ŋ k o l 'ɔ d ʒ i k a	o ŋ k o l 'ɔ d ʒ i k a
plugim	p l u d ʒ 'i m	p l u d ʒ 'i m
duríssims	d u ɾ 'i s i m s	d u ɾ 'i s i m s
resistir	r e z i s t 'i ɾ	r e z i s t 'i ɾ
serrades	s e r 'a ð e s	s e r 'a ð e s
quanties	k w a n t 'i e s	k w a n t 'i e s
malaisi	m a l 'a j z i	m a l 'a j z i
hepàtica	e p 'a t i k a	e p 'a t i k a
disposada	d i s p o z 'a ð a	d i s p o z 'a ð a
parlamentari	p a ɾ l a m e n t 'a ɾ i	p a ɾ l a m e n t 'a ɾ i
Àrtic	'a ɾ t i k	'a ɾ t i k
incòmoda	i ŋ k 'ɔ m o ð a	i ŋ k 'ɔ m o ð a
bloquejat	b l o k e d ʒ 'a t	b l o k e d ʒ 'a t
adormides	a ð o ɾ m 'i ð e s	a ð o ɾ m 'i ð e s
coneixíem	k o n e j ʃ 'i e m	k o n e j ʃ 'i e m
caracarà	k a ɾ a k a ɾ 'a	k a ɾ a k a ɾ 'a
reforçada	r e f o ɾ s 'a ð a	r e f o ɾ s 'a ð a
somio	s o m 'i o	s o m 'i o
cercares	s e ɾ k 'a ɾ e s	s e ɾ k 'a ɾ e s
imperfecte	i m p e ɾ f 'ɛ k t e	i m p e ɾ f 'ɛ k t e
alumínica	a l u m 'i n i k a	a l u m 'i n i k a
llau	ʎ 'a w	ʎ 'a w
panell	p a n 'e ʎ	p a n 'e ʎ
al·lòtrop	a l 'ɔ t ɾ o p	a l 'ɔ t ɾ o p
sexats	s e k s 'a t s	s e k s 'a t s
Tortura	t o ɾ t 'u ɾ a	t o ɾ t 'u ɾ a
fines	f 'i n e s	f 'i n e s
deguts	d e ɣ 'u t s	d e ɣ 'u t s
detindre	d e t 'i n d ɾ e	d e t 'i n d ɾ e
corpori	k o ɾ p 'ɔ ɾ i	k o ɾ p 'ɔ ɾ i
disculpada	d i s k u l p 'a ð a	d i s k u l p 'a ð a
Estem	a s t 'e m	a s t 'e m
transbordar	t ɾ a n z β o ɾ ð 'a ɾ	t ɾ a n z β o ɾ ð 'a ɾ
melodia	m e l o ð 'i a	m e l o ð 'i a
enganyem	a ŋ g a ɲ 'e m	a ŋ g a ɲ 'e m
macular	m a k u l 'a ɾ	m a k u l 'a ɾ
ballades	b a ʎ 'a ð e s	b a ʎ 'a ð e s
exhaustiva	e g z a w s t 'i v a	e g z a w s t 'i v a
composicions	k o m p o z i s i 'o n s	k o m p o z i s i 'o n s
Bisbal	b i z β 'a l	b i z β 'a l
dirigírem	d i ɾ i d ʒ 'i ɾ e m	d i ɾ i d ʒ 'i ɾ e m
óssa	'o s a	'o s a
àrees	'a ɾ e e s	'a ɾ e e s
metodologia	m e t o ð o l o d ʒ 'i a	m e t o ð o l o d ʒ 'i a
ceretà	s e ɾ e t 'a	s e ɾ e t 'a
quemaco	k e m 'a k o	k e m 'a k o
n'era	n 'e ɾ a	n 'e ɾ a
encorreguts	a ŋ k o r e ɣ 'u t s	a ŋ k o r e ɣ 'u t s
paranoia	p a ɾ a n 'ɔ j a	p a ɾ a n 'ɔ j a
demolides	d e m o l 'i ð e s	d e m o l 'i ð e s
intactes	i n t 'a k t e s	i n t 'a k t e s
aplaudits	a p l a w ð 'i t s	a p l a w ð 'i t s
autoritarisme	a w t o ɾ i t a ɾ 'i z m e	a w t o ɾ i t a ɾ 'i z m e
canalla	k a n 'a ʎ a	k a n 'a ʎ a
estiregassar	a s t i ɾ e ɣ a s 'a ɾ	a s t i ɾ e ɣ a s 'a ɾ
bombin	b 'ɔ m b i n	b 'ɔ m b i n
escènics	a s 'ɛ n i k s	a s 'ɛ n i k s
regularitats	r e ɣ u l a ɾ i t 'a t s	r e ɣ u l a ɾ i t 'a t s
declinada	d e k l i n 'a ð a	d e k l i n 'a ð a
poal	p o 'a l	p o 'a l
bassal	b a s 'a l	b a s 'a l
onclastre	o ŋ k l 'a s t ɾ e	o ŋ k l 'a s t ɾ e
obeí	o β e 'i	o β e 'i
precedits	p ɾ e s e ð 'i t s	p ɾ e s e ð 'i t s
Felicitats	f e l i s i t 'a t s	f e l i s i t 'a t s
ocular	o k u l 'a ɾ	o k u l 'a ɾ
preocupa	p ɾ e o k 'u p a	p ɾ e o k 'u p a
correcció	k o r e k s i 'o	k o r e k s i 'o
compromeses	k o m p ɾ o m 'e z e s	k o m p ɾ o m 'e z e s
Artesà	a ɾ t e z 'a	a ɾ t e z 'a
morrió	m o r i 'o	m o r i 'o
marraix	m a r 'a j ʃ	m a r 'a j ʃ
medieval	m e ð i e v 'a l	m e ð i e v 'a l
quadruplicats	k w a ð ɾ u p l i k 'a t s	k w a ð ɾ u p l i k 'a t s
perduts	p e ɾ ð 'u t s	p e ɾ ð 'u t s
erudita	e ɾ u ð 'i t a	e ɾ u ð 'i t a
admirada	a d m i ɾ 'a ð a	a d m i ɾ 'a ð a
àliga	'a l i ɣ a	'a l i ɣ a
deixant-lo	d e j ʃ 'a n l o	d e j ʃ 'a n l o
tractades	t ɾ a k t 'a ð e s	t ɾ a k t 'a ð e s
explicàrem	e k s p l i k 'a ɾ e m	e k s p l i k 'a ɾ e m
trames	t ɾ 'a m e s	t ɾ 'a m e s
endeutament	a n d e w t a m 'e n t	a n d e w t a m 'e n t
anarquismes	a n a ɾ k 'i z m e s	a n a ɾ k 'i z m e s
aixequem	a j ʃ e k 'e m	a j ʃ e k 'e m
Definir	d e f i n 'i ɾ	d e f i n 'i ɾ
Balears	b a l e 'a ɾ s	b a l e 'a ɾ s
grandíssim	g ɾ a n d 'i s i m	g ɾ a n d 'i s i m
disponible	d i s p o n 'i β l e	d i s p o n 'i β l e
tornejar	t o ɾ n e d ʒ 'a ɾ	t o ɾ n e d ʒ 'a ɾ
pescats	p e s k 'a t s	p e s k 'a t s
teloner	t e l o n 'e ɾ	t e l o n 'e ɾ
politicastra	p o l i t i k 'a s t ɾ a	p o l i t i k 'a s t ɾ a
desbloquejar-la	d e z β l o k e d ʒ 'a ɾ l a	d e z β l o k e d ʒ 'a ɾ l a
irrogava	i r o ɣ 'a v a	i r o ɣ 'a v a
assaborits	a s a β o ɾ 'i t s	a s a β o ɾ 'i t s
anxova	a n t ʃ 'ɔ v a	a n t ʃ 'ɔ v a
animació	a n i m a s i 'o	a n i m a s i 'o
afrontat	a f ɾ o n t 'a t	a f ɾ o n t 'a t
bronca	b ɾ 'ɔ ŋ k a	b ɾ 'ɔ ŋ k a
molguis	m 'ɔ l ɣ i s	m 'ɔ l ɣ i s
d'assistir	d a s i s t 'i ɾ	d a s i s t 'i ɾ
deliri	d e l 'i ɾ i	d e l 'i ɾ i
distanciament	d i s t a n s i a m 'e n t	d i s t a n s i a m 'e n t
clandestinitats	k l a n d e s t i n i t 'a t s	k l a n d e s t i n i t 'a t s
segadors	s e ɣ a ð 'o ɾ s	s e ɣ a ð 'o ɾ s
visitat	v i z i t 'a t	v i z i t 'a t
titulo	t i t 'u l o	t i t 'u l o
semblen	s 'e m b l e n	s 'e m b l e n
importar	i m p o ɾ t 'a ɾ	i m p o ɾ t 'a ɾ
descartar	d e s k a ɾ t 'a ɾ	d e s k a ɾ t 'a ɾ
recomanable	r e k o m a n 'a β l e	r e k o m a n 'a β l e
descartaria	d e s k a ɾ t a ɾ 'i a	d e s k a ɾ t a ɾ 'i a
calamitós	k a l a m i t 'o s	k a l a m i t 'o s
paio	p 'a j o	p 'a j o
d'Arquitectes	d a ɾ k i t 'ɛ k t e s	d a ɾ k i t 'ɛ k t e s
epitafi	e p i t 'a f i	e p i t 'a f i
agrícoles	a ɣ ɾ 'i k o l e s	a ɣ ɾ 'i k o l e s
cruspida	k ɾ u s p 'i ð a	k ɾ u s p 'i ð a
criticaria	k ɾ i t i k a ɾ 'i a	k ɾ i t i k a ɾ 'i a
fils	f 'i l s	f 'i l s
falsejada	f a l s e d ʒ 'a ð a	f a l s e d ʒ 'a ð a
constis	k 'ɔ n s t i s	k 'ɔ n s t i s
batejada	b a t e d ʒ 'a ð a	b a t e d ʒ 'a ð a
dates	d 'a t e s	d 'a t e s
astronauta	a s t ɾ o n 'a w t a	a s t ɾ o n 'a w t a
atrofia	a t ɾ o f 'i a	a t ɾ o f 'i a
madrina	m a ð ɾ 'i n a	m a ð ɾ 'i n a
campionat	k a m p i o n 'a t	k a m p i o n 'a t
tràcia	t ɾ 'a s i a	t ɾ 'a s i a
marxem	m a ɾ t ʃ 'e m	m a ɾ t ʃ 'e m
ulls	'u ʎ s	'u ʎ s
viver	v i v 'e ɾ	v i v 'e ɾ
tocar-la	t o k 'a ɾ l a	t o k 'a ɾ l a
albergats	a l β e ɾ ɣ 'a t s	a l β e ɾ ɣ 'a t s
aconseguí	a k o n s e ɣ 'i	a k o n s e ɣ 'i
Blocs	b l 'ɔ k s	b l 'ɔ k s
legítima	l e d ʒ 'i t i m a	l e d ʒ 'i t i m a
desacoblar	d e z a k o β l 'a ɾ	d e z a k o β l 'a ɾ
incontestables	i ŋ k o n t e s t 'a β l e s	i ŋ k o n t e s t 'a β l e s
reprimia	r e p ɾ i m 'i a	r e p ɾ i m 'i a
amansits	a m a n s 'i t s	a m a n s 'i t s
lingüista	l i ŋ g w 'i s t a	l i ŋ g w 'i s t a
trampós	t ɾ a m p 'o s	t ɾ a m p 'o s
seleccionats	s e l e k s i o n 'a t s	s e l e k s i o n 'a t s
sedimentària	s e ð i m e n t 'a ɾ i a	s e ð i m e n t 'a ɾ i a
ventiles	v e n t 'i l e s	v e n t 'i l e s
exigit	e g z i d ʒ 'i t	e g z i d ʒ 'i t
acostat	a k o s t 'a t	a k o s t 'a t
mamífer	m a m 'i f e ɾ	m a m 'i f e ɾ
concorregudes	k o ŋ k o r e ɣ 'u ð e s	k o ŋ k o r e ɣ 'u ð e s
continuat	k o n t i n u 'a t	k o n t i n u 'a t
compàs	k o m p 'a s	k o m p 'a s
compostats	k o m p o s t 'a t s	k o m p o s t 'a t s
ofrenes	o f ɾ 'e n e s	o f ɾ 'e n e s
procés	p ɾ o s 'e s	p ɾ o s 'e s
vocables	v o k 'a β l e s	v o k 'a β l e s
totals	t o t 'a l s	t o t 'a l s
temudes	t e m 'u ð e s	t e m 'u ð e s
xatejada	t ʃ a t e d ʒ 'a ð a	t ʃ a t e d ʒ 'a ð a
traves	t ɾ 'a v e s	t ɾ 'a v e s
meses	m 'e z e s	m 'e z e s
repercutits	r e p e ɾ k u t 'i t s	r e p e ɾ k u t 'i t s
departides	d e p a ɾ t 'i ð e s	d e p a ɾ t 'i ð e s
daina	d 'a j n a	d 'a j n a
Galetes	g a l 'e t e s	g a l 'e t e s
secretades	s e k ɾ e t 'a ð e s	s e k ɾ e t 'a ð e s
apagant	a p a ɣ 'a n t	a p a ɣ 'a n t
recaptant	r e k a p t 'a n t	r e k a p t 'a n t
xirimoia	t ʃ i ɾ i m 'ɔ j a	t ʃ i ɾ i m 'ɔ j a
complementar	k o m p l e m e n t 'a ɾ	k o m p l e m e n t 'a ɾ
peüc	p e 'u k	p e 'u k
repara	r e p 'a ɾ a	r e p 'a ɾ a
d'arròs	d a r 'ɔ s	d a r 'ɔ s
memorística	m e m o ɾ 'i s t i k a	m e m o ɾ 'i s t i k a
solidaritat	s o l i ð a ɾ i t 'a t	s o l i ð a ɾ i t 'a t
acomiadar	a k o m i a ð 'a ɾ	a k o m i a ð 'a ɾ
llençada	ʎ e n s 'a ð a	ʎ e n s 'a ð a
minúsculs	m i n 'u s k u l s	m i n 'u s k u l s
treballada	t ɾ e β a ʎ 'a ð a	t ɾ e β a ʎ 'a ð a
carabassejar	k a ɾ a β a s e d ʒ 'a ɾ	k a ɾ a β a s e d ʒ 'a ɾ
futura	f u t 'u ɾ a	f u t 'u ɾ a
volats	v o l 'a t s	v o l 'a t s
fenomenalisme	f e n o m e n a l 'i z m e	f e n o m e n a l 'i z m e
Elda	'ɛ l d a	'ɛ l d a
danyades	d a ɲ 'a ð e s	d a ɲ 'a ð e s
inicia	i n i s 'i a	i n i s 'i a
estàvem	a s t 'a v e m	a s t 'a v e m
teleria	t e l e ɾ 'i a	t e l e ɾ 'i a
antàrtica	a n t 'a ɾ t i k a	a n t 'a ɾ t i k a
curolla	k u ɾ 'ɔ ʎ a	k u ɾ 'ɔ ʎ a
aclamada	a k l a m 'a ð a	a k l a m 'a ð a
difamada	d i f a m 'a ð a	d i f a m 'a ð a
tribu	t ɾ 'i β u	t ɾ 'i β u
Nota	n 'ɔ t a	n 'ɔ t a
endolcir	a n d o l s 'i ɾ	a n d o l s 'i ɾ
prima	p ɾ 'i m a	p ɾ 'i m a
actini	a k t 'i n i	a k t 'i n i
frondós	f ɾ o n d 'o s	f ɾ o n d 'o s
tecnològics	t e g n o l 'ɔ d ʒ i k s	t e g n o l 'ɔ d ʒ i k s
brancar	b ɾ a ŋ k 'a ɾ	b ɾ a ŋ k 'a ɾ
recessiu	r e s e s 'i w	r e s e s 'i w
conegut	k o n e ɣ 'u t	k o n e ɣ 'u t
directes	d i ɾ 'ɛ k t e s	d i ɾ 'ɛ k t e s
xiclet	t ʃ i k l 'e t	t ʃ i k l 'e t
comandants	k o m a n d 'a n s	k o m a n d 'a n s
hepatitis	e p a t 'i t i s	e p a t 'i t i s
ensordit	a n s o ɾ ð 'i t	a n s o ɾ ð 'i t
cristal·lí	k ɾ i s t a l 'i	k ɾ i s t a l 'i
Talgo	t 'a l ɣ o	t 'a l ɣ o
secretisme	s e k ɾ e t 'i z m e	s e k ɾ e t 'i z m e
nivells	n i v 'e ʎ s	n i v 'e ʎ s
exacte	e g z 'a k t e	e g z 'a k t e
transmigrada	t ɾ a n z m i ɣ ɾ 'a ð a	t ɾ a n z m i ɣ ɾ 'a ð a
assenyada	a s e ɲ 'a ð a	a s e ɲ 'a ð a
compartits	k o m p a ɾ t 'i t s	k o m p a ɾ t 'i t s
visó	v i z 'o	v i z 'o
guardat	g w a ɾ ð 'a t	g w a ɾ ð 'a t
assaltant	a s a l t 'a n t	a s a l t 'a n t
administrares	a d m i n i s t ɾ 'a ɾ e s	a d m i n i s t ɾ 'a ɾ e s
obtingut	o p t i ŋ g 'u t	o p t i ŋ g 'u t
inactivitats	i n a k t i v i t 'a t s	i n a k t i v i t 'a t s
collades	k o ʎ 'a ð e s	k o ʎ 'a ð e s
premisses	p ɾ e m 'i s e s	p ɾ e m 'i s e s
agúen	a ɣ 'u e n	a ɣ 'u e n
mag	m 'a k	m 'a k
prefix	p ɾ e f 'i k s	p ɾ e f 'i k s
oradors	o ɾ a ð 'o ɾ s	o ɾ a ð 'o ɾ s
ceràmiques	s e ɾ 'a m i k e s	s e ɾ 'a m i k e s
babaues	b a β 'a w e s	b a β 'a w e s
regada	r e ɣ 'a ð a	r e ɣ 'a ð a
enxampades	a n t ʃ a m p 'a ð e s	a n t ʃ a m p 'a ð e s
decència	d e s 'ɛ n s i a	d e s 'ɛ n s i a
adaptable	a ð a p t 'a β l e	a ð a p t 'a β l e
diplomàtic	d i p l o m 'a t i k	d i p l o m 'a t i k
consti	k 'ɔ n s t i	k 'ɔ n s t i
participar	p a ɾ t i s i p 'a ɾ	p a ɾ t i s i p 'a ɾ
catapultar	k a t a p u l t 'a ɾ	k a t a p u l t 'a ɾ
festival	f e s t i v 'a l	f e s t i v 'a l
laminar	l a m i n 'a ɾ	l a m i n 'a ɾ
traqueïtis	t ɾ a k e 'i t i s	t ɾ a k e 'i t i s
destina	d e s t 'i n a	d e s t 'i n a
millorament	m i ʎ o ɾ a m 'e n t	m i ʎ o ɾ a m 'e n t
defoliats	d e f o l i 'a t s	d e f o l i 'a t s
demanar	d e m a n 'a ɾ	d e m a n 'a ɾ
esbotifarrar	a z β o t i f a r 'a ɾ	a z β o t i f a r 'a ɾ
torço	t 'ɔ ɾ s o	t 'ɔ ɾ s o
barallo	b a ɾ 'a ʎ o	b a ɾ 'a ʎ o
memòria	m e m 'ɔ ɾ i a	m e m 'ɔ ɾ i a
consentiment	k o n s e n t i m 'e n t	k o n s e n t i m 'e n t
enterra	a n t 'ɛ r a	a n t 'ɛ r a
estern	a s t 'ɛ ɾ n	a s t 'ɛ ɾ n
commemoració	k o m m e m o ɾ a s i 'o	k o m m e m o ɾ a s i 'o
àbacs	'a β a k s	'a β a k s
presentable	p ɾ e z e n t 'a β l e	p ɾ e z e n t 'a β l e
interaccionat	i n t e ɾ a k s i o n 'a t	i n t e ɾ a k s i o n 'a t
sonora	s o n 'o ɾ a	s o n 'o ɾ a
Considera	k o n s i ð 'e ɾ a	k o n s i ð 'e ɾ a
dir-ho	d 'i ɾ o	d 'i ɾ o
fonamentada	f o n a m e n t 'a ð a	f o n a m e n t 'a ð a
assagista	a s a d ʒ 'i s t a	a s a d ʒ 'i s t a
ribagorçà	r i β a ɣ o ɾ s 'a	r i β a ɣ o ɾ s 'a
duts	d 'u t s	d 'u t s
purista	p u ɾ 'i s t a	p u ɾ 'i s t a
Alguns	a l ɣ 'u n s	a l ɣ 'u n s
tosc	t 'o s k	t 'o s k
radiograma	r a ð i o ɣ ɾ 'a m a	r a ð i o ɣ ɾ 'a m a
sorneguera	s o ɾ n e ɣ 'e ɾ a	s o ɾ n e ɣ 'e ɾ a
àlgid	'a l d ʒ i t	'a l d ʒ i t
carxofes	k a ɾ t ʃ 'ɔ f e s	k a ɾ t ʃ 'ɔ f e s
denotaria	d e n o t a ɾ 'i a	d e n o t a ɾ 'i a
pagador	p a ɣ a ð 'o ɾ	p a ɣ a ð 'o ɾ
transferit	t ɾ a n s f e ɾ 'i t	t ɾ a n s f e ɾ 'i t
iniciaria	i n i s i a ɾ 'i a	i n i s i a ɾ 'i a
plantejar	p l a n t e d ʒ 'a ɾ	p l a n t e d ʒ 'a ɾ
disfressades	d i s f ɾ e s 'a ð e s	d i s f ɾ e s 'a ð e s
bramuls	b ɾ a m 'u l s	b ɾ a m 'u l s
pintats	p i n t 'a t s	p i n t 'a t s
salivo	s a l 'i v o	s a l 'i v o
obeïts	o β e 'i t s	o β e 'i t s
centaus	s e n t 'a w s	s e n t 'a w s
patins	p a t 'i n s	p a t 'i n s
agermanades	a d ʒ e ɾ m a n 'a ð e s	a d ʒ e ɾ m a n 'a ð e s
patrulles	p a t ɾ 'u ʎ e s	p a t ɾ 'u ʎ e s
rellevant	r e ʎ e v 'a n t	r e ʎ e v 'a n t
fornejades	f o ɾ n e d ʒ 'a ð e s	f o ɾ n e d ʒ 'a ð e s
hipòfisi	i p 'ɔ f i z i	i p 'ɔ f i z i
classificació	k l a s i f i k a s i 'o	k l a s i f i k a s i 'o
aplacar	a p l a k 'a ɾ	a p l a k 'a ɾ
esforçat	a s f o ɾ s 'a t	a s f o ɾ s 'a t
concís	k o n s 'i s	k o n s 'i s
afusellar	a f u z e ʎ 'a ɾ	a f u z e ʎ 'a ɾ
desplaçar	d e s p l a s 'a ɾ	d e s p l a s 'a ɾ
dietètics	d i e t 'ɛ t i k s	d i e t 'ɛ t i k s
pedregós	p e ð ɾ e ɣ 'o s	p e ð ɾ e ɣ 'o s
l'amistat	l a m i s t 'a t	l a m i s t 'a t
darrer	d a r 'e ɾ	d a r 'e ɾ
estúpides	a s t 'u p i ð e s	a s t 'u p i ð e s
arraulits	a r a w l 'i t s	a r a w l 'i t s
adonar	a ð o n 'a ɾ	a ð o n 'a ɾ
advocats	a d v o k 'a t s	a d v o k 'a t s
indici	i n d 'i s i	i n d 'i s i
auscultades	a w s k u l t 'a ð e s	a w s k u l t 'a ð e s
fregida	f ɾ e d ʒ 'i ð a	f ɾ e d ʒ 'i ð a
rostit	r o s t 'i t	r o s t 'i t
pagava	p a ɣ 'a v a	p a ɣ 'a v a
criteris	k ɾ i t 'ɛ ɾ i s	k ɾ i t 'ɛ ɾ i s
Berguedà	b e ɾ ɣ e ð 'a	b e ɾ ɣ e ð 'a
Bessones	b e s 'o n e s	b e s 'o n e s
evolucionar	e v o l u s i o n 'a ɾ	e v o l u s i o n 'a ɾ
trèvol	t ɾ 'ɛ v o l	t ɾ 'ɛ v o l
electròlit	e l e k t ɾ 'ɔ l i t	e l e k t ɾ 'ɔ l i t
minat	m i n 'a t	m i n 'a t
separàrem	s e p a ɾ 'a ɾ e m	s e p a ɾ 'a ɾ e m
Herodes	e ɾ 'ɔ ð e s	e ɾ 'ɔ ð e s
pactades	p a k t 'a ð e s	p a k t 'a ð e s
comprensible	k o m p ɾ e n s 'i β l e	k o m p ɾ e n s 'i β l e
adduïts	a d d u 'i t s	a d d u 'i t s
delictives	d e l i k t 'i v e s	d e l i k t 'i v e s
sil·làbiques	s i l 'a β i k e s	s i l 'a β i k e s
jornada	d ʒ o ɾ n 'a ð a	d ʒ o ɾ n 'a ð a
reduïts	r e ð u 'i t s	r e ð u 'i t s
Ribó	r i β 'o	r i β 'o
l'illa	l 'i ʎ a	l 'i ʎ a
imitat	i m i t 'a t	i m i t 'a t
arqueòleg	a ɾ k e 'ɔ l e k	a ɾ k e 'ɔ l e k
criança	k ɾ i 'a n s a	k ɾ i 'a n s a
funàmbuls	f u n 'a m b u l s	f u n 'a m b u l s
aprehendre	a p ɾ e 'ɛ n d ɾ e	a p ɾ e 'ɛ n d ɾ e
tsarista	t s a ɾ 'i s t a	t s a ɾ 'i s t a
figuretes	f i ɣ u ɾ 'e t e s	f i ɣ u ɾ 'e t e s
cultes	k 'u l t e s	k 'u l t e s
peresós	p e ɾ e z 'o s	p e ɾ e z 'o s
geomètrica	d ʒ e o m 'ɛ t ɾ i k a	d ʒ e o m 'ɛ t ɾ i k a
jubilar	d ʒ u β i l 'a ɾ	d ʒ u β i l 'a ɾ
foc	f 'ɔ k	f 'ɔ k
masses	m 'a s e s	m 'a s e s
lírica	l 'i ɾ i k a	l 'i ɾ i k a
assumides	a s u m 'i ð e s	a s u m 'i ð e s
agressors	a ɣ ɾ e s 'o ɾ s	a ɣ ɾ e s 'o ɾ s
inquietant	i ŋ k i e t 'a n t	i ŋ k i e t 'a n t
firmats	f i ɾ m 'a t s	f i ɾ m 'a t s
engrunadís	a ŋ g ɾ u n a ð 'i s	a ŋ g ɾ u n a ð 'i s
insinuat	i n s i n u 'a t	i n s i n u 'a t
sentiment	s e n t i m 'e n t	s e n t i m 'e n t
empedrats	a m p e ð ɾ 'a t s	a m p e ð ɾ 'a t s
combatudes	k o m b a t 'u ð e s	k o m b a t 'u ð e s
tornéssim	t o ɾ n 'e s i m	t o ɾ n 'e s i m
fórmula	f 'o ɾ m u l a	f 'o ɾ m u l a
entrebancar	a n t ɾ e β a ŋ k 'a ɾ	a n t ɾ e β a ŋ k 'a ɾ
analògic	a n a l 'ɔ d ʒ i k	a n a l 'ɔ d ʒ i k
comunicares	k o m u n i k 'a ɾ e s	k o m u n i k 'a ɾ e s
fendran	f e n d ɾ 'a n	f e n d ɾ 'a n
temptació	t e m t a s i 'o	t e m t a s i 'o
netejant	n e t e d ʒ 'a n t	n e t e d ʒ 'a n t
anticipats	a n t i s i p 'a t s	a n t i s i p 'a t s
potra	p 'ɔ t ɾ a	p 'ɔ t ɾ a
asiàtics	a z i 'a t i k s	a z i 'a t i k s
consagracions	k o n s a ɣ ɾ a s i 'o n s	k o n s a ɣ ɾ a s i 'o n s
incontrolat	i ŋ k o n t ɾ o l 'a t	i ŋ k o n t ɾ o l 'a t
transportada	t ɾ a n s p o ɾ t 'a ð a	t ɾ a n s p o ɾ t 'a ð a
elegies	e l e d ʒ 'i e s	e l e d ʒ 'i e s
carrutxes	k a r 'u t ʃ e s	k a r 'u t ʃ e s
abrandes	a β ɾ 'a n d e s	a β ɾ 'a n d e s
depurades	d e p u ɾ 'a ð e s	d e p u ɾ 'a ð e s
empinades	a m p i n 'a ð e s	a m p i n 'a ð e s
incitada	i n s i t 'a ð a	i n s i t 'a ð a
trencament	t ɾ e ŋ k a m 'e n t	t ɾ e ŋ k a m 'e n t
instruí	i n s t ɾ u 'i	i n s t ɾ u 'i
cal·ligràfic	k a l i ɣ ɾ 'a f i k	k a l i ɣ ɾ 'a f i k
notin	n 'ɔ t i n	n 'ɔ t i n
mascarada	m a s k a ɾ 'a ð a	m a s k a ɾ 'a ð a
prestades	p ɾ e s t 'a ð e s	p ɾ e s t 'a ð e s
dràstica	d ɾ 'a s t i k a	d ɾ 'a s t i k a
catàstrofe	k a t 'a s t ɾ o f e	k a t 'a s t ɾ o f e
assessor	a s e s 'o ɾ	a s e s 'o ɾ
hipotètica	i p o t 'ɛ t i k a	i p o t 'ɛ t i k a
qualificar	k w a l i f i k 'a ɾ	k w a l i f i k 'a ɾ
lleonat	ʎ e o n 'a t	ʎ e o n 'a t
truca	t ɾ 'u k a	t ɾ 'u k a
voladura	v o l a ð 'u ɾ a	v o l a ð 'u ɾ a
desastres	d e z 'a s t ɾ e s	d e z 'a s t ɾ e s
encadenada	a ŋ k a ð e n 'a ð a	a ŋ k a ð e n 'a ð a
rementerola	r e m e n t e ɾ 'ɔ l a	r e m e n t e ɾ 'ɔ l a
passo	p 'a s o	p 'a s o
círcols	s 'i ɾ k o l s	s 'i ɾ k o l s
barrada	b a r 'a ð a	b a r 'a ð a
empàtica	a m p 'a t i k a	a m p 'a t i k a
etiòpic	e t i 'ɔ p i k	e t i 'ɔ p i k
mesurats	m e z u ɾ 'a t s	m e z u ɾ 'a t s
Müller	m u ʎ 'e ɾ	m u ʎ 'e ɾ
inundables	i n u n d 'a β l e s	i n u n d 'a β l e s
titot	t i t 'ɔ t	t i t 'ɔ t
vogar	v o ɣ 'a ɾ	v o ɣ 'a ɾ
Saló	s a l 'o	s a l 'o
alfac	a l f 'a k	a l f 'a k
esteparis	a s t e p 'a ɾ i s	a s t e p 'a ɾ i s
Hipòlit	i p 'ɔ l i t	i p 'ɔ l i t
esclatades	a s k l a t 'a ð e s	a s k l a t 'a ð e s
Filadèlfia	f i l a ð 'ɛ l f i a	f i l a ð 'ɛ l f i a
suïssos	s u 'i s o s	s u 'i s o s
col·locada	k o l o k 'a ð a	k o l o k 'a ð a
reculades	r e k u l 'a ð e s	r e k u l 'a ð e s
nuvi	n 'u v i	n 'u v i
doblegar	d o β l e ɣ 'a ɾ	d o β l e ɣ 'a ɾ
carpat	k a ɾ p 'a t	k a ɾ p 'a t
despertador	d e s p e ɾ t a ð 'o ɾ	d e s p e ɾ t a ð 'o ɾ
d'animals	d a n i m 'a l s	d a n i m 'a l s
inert	i n 'ɛ ɾ t	i n 'ɛ ɾ t
donàvem	d o n 'a v e m	d o n 'a v e m
incomodada	i ŋ k o m o ð 'a ð a	i ŋ k o m o ð 'a ð a
marit	m a ɾ 'i t	m a ɾ 'i t
biogràfiques	b i o ɣ ɾ 'a f i k e s	b i o ɣ ɾ 'a f i k e s
menús	m e n 'u s	m e n 'u s
pigmentat	p i g m e n t 'a t	p i g m e n t 'a t
saludant	s a l u ð 'a n t	s a l u ð 'a n t
costejats	k o s t e d ʒ 'a t s	k o s t e d ʒ 'a t s
encreuament	a ŋ k ɾ e w a m 'e n t	a ŋ k ɾ e w a m 'e n t
equivalent	e k i v a l 'e n t	e k i v a l 'e n t
arxius	a ɾ t ʃ 'i w s	a ɾ t ʃ 'i w s
amperímetre	a m p e ɾ 'i m e t ɾ e	a m p e ɾ 'i m e t ɾ e
cedres	s 'ɛ ð ɾ e s	s 'ɛ ð ɾ e s
caiguda	k a j ɣ 'u ð a	k a j ɣ 'u ð a
visita	v i z 'i t a	v i z 'i t a
estampats	a s t a m p 'a t s	a s t a m p 'a t s
sortilla	s o ɾ t 'i ʎ a	s o ɾ t 'i ʎ a
dotis	d 'ɔ t i s	d 'ɔ t i s
escàs	a s k 'a s	a s k 'a s
esgotat	a z ɣ o t 'a t	a z ɣ o t 'a t
crusant	k ɾ u z 'a n t	k ɾ u z 'a n t
bísties	b 'i s t i e s	b 'i s t i e s
destructor	d e s t ɾ u k t 'o ɾ	d e s t ɾ u k t 'o ɾ
correlacions	k o r e l a s i 'o n s	k o r e l a s i 'o n s
proliferades	p ɾ o l i f e ɾ 'a ð e s	p ɾ o l i f e ɾ 'a ð e s
miraves	m i ɾ 'a v e s	m i ɾ 'a v e s
frontó	f ɾ o n t 'o	f ɾ o n t 'o
evidenciat	e v i ð e n s i 'a t	e v i ð e n s i 'a t
bastions	b a s t i 'o n s	b a s t i 'o n s
rentat	r e n t 'a t	r e n t 'a t
coneixent	k o n e j ʃ 'e n t	k o n e j ʃ 'e n t
concedides	k o n s e ð 'i ð e s	k o n s e ð 'i ð e s
captivats	k a p t i v 'a t s	k a p t i v 'a t s
ponderar	p o n d e ɾ 'a ɾ	p o n d e ɾ 'a ɾ
suc	s 'u k	s 'u k
alenat	a l e n 'a t	a l e n 'a t
ferides	f e ɾ 'i ð e s	f e ɾ 'i ð e s
agitades	a d ʒ i t 'a ð e s	a d ʒ i t 'a ð e s
biaix	b i 'a j ʃ	b i 'a j ʃ
ingressat	i ŋ g ɾ e s 'a t	i ŋ g ɾ e s 'a t
afanar	a f a n 'a ɾ	a f a n 'a ɾ
sofriment	s o f ɾ i m 'e n t	s o f ɾ i m 'e n t
Casa	k 'a z a	k 'a z a
coexistiu	k o e g z i s t 'i w	k o e g z i s t 'i w
perill	p e ɾ 'i ʎ	p e ɾ 'i ʎ
MIR	m 'i ɾ	m 'i ɾ
subjectivat	s u b d ʒ e k t i v 'a t	s u b d ʒ e k t i v 'a t
bisbe	b 'i z β e	b 'i z β e
jaca	d ʒ 'a k a	d ʒ 'a k a
baralla	b a ɾ 'a ʎ a	b a ɾ 'a ʎ a
ressaltar	r e s a l t 'a ɾ	r e s a l t 'a ɾ
Cases	k 'a z e s	k 'a z e s
colgar	k o l ɣ 'a ɾ	k o l ɣ 'a ɾ
milotxa	m i l 'ɔ t ʃ a	m i l 'ɔ t ʃ a
fornir	f o ɾ n 'i ɾ	f o ɾ n 'i ɾ
sostretes	s o s t ɾ 'e t e s	s o s t ɾ 'e t e s
esclavina	a s k l a v 'i n a	a s k l a v 'i n a
capironat	k a p i ɾ o n 'a t	k a p i ɾ o n 'a t
secrets	s e k ɾ 'e t s	s e k ɾ 'e t s
homòfobes	o m 'ɔ f o β e s	o m 'ɔ f o β e s
veler	v e l 'e ɾ	v e l 'e ɾ
detingut	d e t i ŋ g 'u t	d e t i ŋ g 'u t
celebrarà	s e l e β ɾ a ɾ 'a	s e l e β ɾ a ɾ 'a
xafogosa	t ʃ a f o ɣ 'o z a	t ʃ a f o ɣ 'o z a
Alcàntara	a l k 'a n t a ɾ a	a l k 'a n t a ɾ a
depenen	d e p 'e n e n	d e p 'e n e n
segades	s e ɣ 'a ð e s	s e ɣ 'a ð e s
intempestivitat	i n t e m p e s t i v i t 'a t	i n t e m p e s t i v i t 'a t
trombocitopènia	t ɾ o m b o s i t o p 'ɛ n i a	t ɾ o m b o s i t o p 'ɛ n i a
penat	p e n 'a t	p e n 'a t
pantera	p a n t 'e ɾ a	p a n t 'e ɾ a
principi	p ɾ i n s 'i p i	p ɾ i n s 'i p i
travessem	t ɾ a v e s 'e m	t ɾ a v e s 'e m
Garrigues	g a r 'i ɣ e s	g a r 'i ɣ e s
hesitats	e z i t 'a t s	e z i t 'a t s
allistar	a ʎ i s t 'a ɾ	a ʎ i s t 'a ɾ
Carles	k 'a ɾ l e s	k 'a ɾ l e s
entorn	a n t 'o ɾ n	a n t 'o ɾ n
nino	n 'i n o	n 'i n o
bars	b 'a ɾ s	b 'a ɾ s
cargolar	k a ɾ ɣ o l 'a ɾ	k a ɾ ɣ o l 'a ɾ
innocent	i n n o s 'e n t	i n n o s 'e n t
pronunciares	p ɾ o n u n s i 'a ɾ e s	p ɾ o n u n s i 'a ɾ e s
sofertes	s o f 'ɛ ɾ t e s	s o f 'ɛ ɾ t e s
disseminats	d i s e m i n 'a t s	d i s e m i n 'a t s
difuminar	d i f u m i n 'a ɾ	d i f u m i n 'a ɾ
relatat	r e l a t 'a t	r e l a t 'a t
elaborats	e l a β o ɾ 'a t s	e l a β o ɾ 'a t s
banquisa	b a ŋ k 'i z a	b a ŋ k 'i z a
dubte	d 'u p t e	d 'u p t e
espaiador	a s p a j a ð 'o ɾ	a s p a j a ð 'o ɾ
dodecagonal	d o ð e k a ɣ o n 'a l	d o ð e k a ɣ o n 'a l
balconades	b a l k o n 'a ð e s	b a l k o n 'a ð e s
regulats	r e ɣ u l 'a t s	r e ɣ u l 'a t s
abandonant	a β a n d o n 'a n t	a β a n d o n 'a n t
pisar	p i z 'a ɾ	p i z 'a ɾ
mirall	m i ɾ 'a ʎ	m i ɾ 'a ʎ
suarà	s u a ɾ 'a	s u a ɾ 'a
podien	p o ð 'i e n	p o ð 'i e n
esmentats	a z m e n t 'a t s	a z m e n t 'a t s
raurà	r a w ɾ 'a	r a w ɾ 'a
honorífiques	o n o ɾ 'i f i k e s	o n o ɾ 'i f i k e s
moció	m o s i 'o	m o s i 'o
creen	k ɾ 'e e n	k ɾ 'e e n
guerriller	g e r i ʎ 'e ɾ	g e r i ʎ 'e ɾ
dilatats	d i l a t 'a t s	d i l a t 'a t s
avisava	a v i z 'a v a	a v i z 'a v a
teòleg	t e 'ɔ l e k	t e 'ɔ l e k
pixades	p i ʃ 'a ð e s	p i ʃ 'a ð e s
increpar	i ŋ k ɾ e p 'a ɾ	i ŋ k ɾ e p 'a ɾ
quota	k w 'ɔ t a	k w 'ɔ t a
baixats	b a j ʃ 'a t s	b a j ʃ 'a t s
bolli	b 'ɔ ʎ i	b 'ɔ ʎ i
matemàtiques	m a t e m 'a t i k e s	m a t e m 'a t i k e s
vidalba	v i ð 'a l β a	v i ð 'a l β a
lliga	ʎ 'i ɣ a	ʎ 'i ɣ a
decolorades	d e k o l o ɾ 'a ð e s	d e k o l o ɾ 'a ð e s
jonquilla	d ʒ o ŋ k 'i ʎ a	d ʒ o ŋ k 'i ʎ a
insalubre	i n s a l 'u β ɾ e	i n s a l 'u β ɾ e
pressa	p ɾ 'e s a	p ɾ 'e s a
xenòfobes	t ʃ e n 'ɔ f o β e s	t ʃ e n 'ɔ f o β e s
efectives	e f e k t 'i v e s	e f e k t 'i v e s
Sol	s 'ɔ l	s 'ɔ l
cruïlla	k ɾ u 'i ʎ a	k ɾ u 'i ʎ a
asímptota	a z 'i m t o t a	a z 'i m t o t a
canari	k a n 'a ɾ i	k a n 'a ɾ i
caldria	k a l d ɾ 'i a	k a l d ɾ 'i a
posada	p o z 'a ð a	p o z 'a ð a
desamor	d e z a m 'o ɾ	d e z a m 'o ɾ
estrenaran	a s t ɾ e n a ɾ 'a n	a s t ɾ e n a ɾ 'a n
afecto	a f 'ɛ k t o	a f 'ɛ k t o
transsexual	t ɾ a n s e k s u 'a l	t ɾ a n s e k s u 'a l
preliminar	p ɾ e l i m i n 'a ɾ	p ɾ e l i m i n 'a ɾ
dialectal	d i a l e k t 'a l	d i a l e k t 'a l
traslladats	t ɾ a z ʎ a ð 'a t s	t ɾ a z ʎ a ð 'a t s
evaporats	e v a p o ɾ 'a t s	e v a p o ɾ 'a t s
soltin	s 'ɔ l t i n	s 'ɔ l t i n
ensopegats	a n s o p e ɣ 'a t s	a n s o p e ɣ 'a t s
salsifí	s a l s i f 'i	s a l s i f 'i
ací	a s 'i	a s 'i
clemàstecs	k l e m 'a s t e k s	k l e m 'a s t e k s
governar	g o v e ɾ n 'a ɾ	g o v e ɾ n 'a ɾ
hitita	i t 'i t a	i t 'i t a
rodi	r 'ɔ ð i	r 'ɔ ð i
setanta	s e t 'a n t a	s e t 'a n t a
déu	d 'e w	d 'e w
sòcia	s 'ɔ s i a	s 'ɔ s i a
Sorribes	s o r 'i β e s	s o r 'i β e s
lícies	l 'i s i e s	l 'i s i e s
complexitats	k o m p l e k s i t 'a t s	k o m p l e k s i t 'a t s
patir	p a t 'i ɾ	p a t 'i ɾ
desvinculada	d e z v i ŋ k u l 'a ð a	d e z v i ŋ k u l 'a ð a
monòxid	m o n 'ɔ k s i t	m o n 'ɔ k s i t
derrotades	d e r o t 'a ð e s	d e r o t 'a ð e s
tucans	t u k 'a n s	t u k 'a n s
accentuar	a k s e n t u 'a ɾ	a k s e n t u 'a ɾ
grises	g ɾ 'i z e s	g ɾ 'i z e s
sindical	s i n d i k 'a l	s i n d i k 'a l
consumir	k o n s u m 'i ɾ	k o n s u m 'i ɾ
escapada	a s k a p 'a ð a	a s k a p 'a ð a
valora	v a l 'o ɾ a	v a l 'o ɾ a
valguts	v a l ɣ 'u t s	v a l ɣ 'u t s
immune	i m m 'u n e	i m m 'u n e
bolet	b o l 'e t	b o l 'e t
Magí	m a d ʒ 'i	m a d ʒ 'i
S'imagina	s i m a d ʒ 'i n a	s i m a d ʒ 'i n a
ocorregut	o k o r e ɣ 'u t	o k o r e ɣ 'u t
lletimó	ʎ e t i m 'o	ʎ e t i m 'o
nuls	n 'u l s	n 'u l s
moixina	m o j ʃ 'i n a	m o j ʃ 'i n a
l'objecte	l o b d ʒ 'ɛ k t e	l o b d ʒ 'ɛ k t e
pressionada	p ɾ e s i o n 'a ð a	p ɾ e s i o n 'a ð a
encapçalada	a ŋ k a p s a l 'a ð a	a ŋ k a p s a l 'a ð a
altes	'a l t e s	'a l t e s
arrencats	a r e ŋ k 'a t s	a r e ŋ k 'a t s
segellats	s e d ʒ e ʎ 'a t s	s e d ʒ e ʎ 'a t s
davantal	d a v a n t 'a l	d a v a n t 'a l
sodomitzà	s o ð o m i d z 'a	s o ð o m i d z 'a
reverent	r e v e ɾ 'e n t	r e v e ɾ 'e n t
expansió	e k s p a n s i 'o	e k s p a n s i 'o
descosir	d e s k o z 'i ɾ	d e s k o z 'i ɾ
clicar	k l i k 'a ɾ	k l i k 'a ɾ
desdoblat	d e z ð o β l 'a t	d e z ð o β l 'a t
digitats	d i d ʒ i t 'a t s	d i d ʒ i t 'a t s
falsificats	f a l s i f i k 'a t s	f a l s i f i k 'a t s
palplantat	p a l p l a n t 'a t	p a l p l a n t 'a t
lleuger	ʎ e w d ʒ 'e ɾ	ʎ e w d ʒ 'e ɾ
traslladada	t ɾ a z ʎ a ð 'a ð a	t ɾ a z ʎ a ð 'a ð a
l'acusis	l a k 'u z i s	l a k 'u z i s
gairebé	g a j ɾ e β 'e	g a j ɾ e β 'e
reanomenar	r e a n o m e n 'a ɾ	r e a n o m e n 'a ɾ
desnatada	d e z n a t 'a ð a	d e z n a t 'a ð a
cònsol	k 'ɔ n s o l	k 'ɔ n s o l
arcà	a ɾ k 'a	a ɾ k 'a
esperes	a s p 'e ɾ e s	a s p 'e ɾ e s
programat	p ɾ o ɣ ɾ a m 'a t	p ɾ o ɣ ɾ a m 'a t
afavorits	a f a v o ɾ 'i t s	a f a v o ɾ 'i t s
rapinyar	r a p i ɲ 'a ɾ	r a p i ɲ 'a ɾ
captares	k a p t 'a ɾ e s	k a p t 'a ɾ e s
pilotejar	p i l o t e d ʒ 'a ɾ	p i l o t e d ʒ 'a ɾ
immutar	i m m u t 'a ɾ	i m m u t 'a ɾ
frisar	f ɾ i z 'a ɾ	f ɾ i z 'a ɾ
reial	r e j 'a l	r e j 'a l
Marràqueix	m a r 'a k e j ʃ	m a r 'a k e j ʃ
alternativa	a l t e ɾ n a t 'i v a	a l t e ɾ n a t 'i v a
cerqui	s 'ɛ ɾ k i	s 'ɛ ɾ k i
construí	k o n s t ɾ u 'i	k o n s t ɾ u 'i
masia	m a z 'i a	m a z 'i a
regalar	r e ɣ a l 'a ɾ	r e ɣ a l 'a ɾ
Sortirem	s o ɾ t i ɾ 'e m	s o ɾ t i ɾ 'e m
interceptar	i n t e ɾ s e p t 'a ɾ	i n t e ɾ s e p t 'a ɾ
Illes	'i ʎ e s	'i ʎ e s
alemanya	a l e m 'a ɲ a	a l e m 'a ɲ a
variada	v a ɾ i 'a ð a	v a ɾ i 'a ð a
proper	p ɾ o p 'e ɾ	p ɾ o p 'e ɾ
acabaria	a k a β a ɾ 'i a	a k a β a ɾ 'i a
urubú	u ɾ u β 'u	u ɾ u β 'u
Malgrat	m a l ɣ ɾ 'a t	m a l ɣ ɾ 'a t
patrullat	p a t ɾ u ʎ 'a t	p a t ɾ u ʎ 'a t
burxó	b u ɾ t ʃ 'o	b u ɾ t ʃ 'o
acotxador	a k o t ʃ a ð 'o ɾ	a k o t ʃ a ð 'o ɾ
previ	p ɾ 'ɛ v i	p ɾ 'ɛ v i
editaré	e ð i t a ɾ 'e	e ð i t a ɾ 'e
nets	n 'e t s	n 'e t s
indispensable	i n d i s p e n s 'a β l e	i n d i s p e n s 'a β l e
fòssil	f 'ɔ s i l	f 'ɔ s i l
panoràmic	p a n o ɾ 'a m i k	p a n o ɾ 'a m i k
pomada	p o m 'a ð a	p o m 'a ð a
Munic	m u n 'i k	m u n 'i k
empastat	a m p a s t 'a t	a m p a s t 'a t
nodrida	n o ð ɾ 'i ð a	n o ð ɾ 'i ð a
entretingut	a n t ɾ e t i ŋ g 'u t	a n t ɾ e t i ŋ g 'u t
ratapinyada	r a t a p i ɲ 'a ð a	r a t a p i ɲ 'a ð a
l'i	l 'i	l 'i
simulats	s i m u l 'a t s	s i m u l 'a t s
fili	f 'i l i	f 'i l i
poterna	p o t 'ɛ ɾ n a	p o t 'ɛ ɾ n a
braç	b ɾ 'a s	b ɾ 'a s
urc	'u ɾ k	'u ɾ k
barrejades	b a r e d ʒ 'a ð e s	b a r e d ʒ 'a ð e s
agregades	a ɣ ɾ e ɣ 'a ð e s	a ɣ ɾ e ɣ 'a ð e s
parlàreu	p a ɾ l 'a ɾ e w	p a ɾ l 'a ɾ e w
perruqueria	p e r u k e ɾ 'i a	p e r u k e ɾ 'i a
Oslo	'ɔ z l o	'ɔ z l o
bruixes	b ɾ 'u j ʃ e s	b ɾ 'u j ʃ e s
verge	v 'ɛ ɾ d ʒ e	v 'ɛ ɾ d ʒ e
paleocènics	p a l e o s 'ɛ n i k s	p a l e o s 'ɛ n i k s
inexpressables	i n e k s p ɾ e s 'a β l e s	i n e k s p ɾ e s 'a β l e s
sacrificat	s a k ɾ i f i k 'a t	s a k ɾ i f i k 'a t
satisfet	s a t i s f 'e t	s a t i s f 'e t
França	f ɾ 'a n s a	f ɾ 'a n s a
escassos	a s k 'a s o s	a s k 'a s o s
comunicativa	k o m u n i k a t 'i v a	k o m u n i k a t 'i v a
grànul	g ɾ 'a n u l	g ɾ 'a n u l
romàntic	r o m 'a n t i k	r o m 'a n t i k
sotana	s o t 'a n a	s o t 'a n a
escalfeir	a s k a l f e 'i ɾ	a s k a l f e 'i ɾ
nassos	n 'a s o s	n 'a s o s
basc	b 'a s k	b 'a s k
amblats	a m b l 'a t s	a m b l 'a t s
personalitat	p e ɾ s o n a l i t 'a t	p e ɾ s o n a l i t 'a t
ualabi	u a l 'a β i	u a l 'a β i
marrans	m a r 'a n s	m a r 'a n s
trigança	t ɾ i ɣ 'a n s a	t ɾ i ɣ 'a n s a
trencat	t ɾ e ŋ k 'a t	t ɾ e ŋ k 'a t
virginals	v i ɾ d ʒ i n 'a l s	v i ɾ d ʒ i n 'a l s
S'acosta	s a k 'ɔ s t a	s a k 'ɔ s t a
copiaria	k o p i a ɾ 'i a	k o p i a ɾ 'i a
aflicció	a f l i k s i 'o	a f l i k s i 'o
faixa	f 'a j ʃ a	f 'a j ʃ a
Generalitat	d ʒ e n e ɾ a l i t 'a t	d ʒ e n e ɾ a l i t 'a t
desa	d 'e z a	d 'e z a
parlo	p 'a ɾ l o	p 'a ɾ l o
bíter	b 'i t e ɾ	b 'i t e ɾ
garrafes	g a r 'a f e s	g a r 'a f e s
brosses	b ɾ 'ɔ s e s	b ɾ 'ɔ s e s
assabentades	a s a β e n t 'a ð e s	a s a β e n t 'a ð e s
tendència	t e n d 'ɛ n s i a	t e n d 'ɛ n s i a
muntaven	m u n t 'a v e n	m u n t 'a v e n
contenidor	k o n t e n i ð 'o ɾ	k o n t e n i ð 'o ɾ
valdre	v 'a l d ɾ e	v 'a l d ɾ e
consto	k 'ɔ n s t o	k 'ɔ n s t o
Ligúria	l i ɣ 'u ɾ i a	l i ɣ 'u ɾ i a
precursors	p ɾ e k u ɾ s 'o ɾ s	p ɾ e k u ɾ s 'o ɾ s
xicots	t ʃ i k 'ɔ t s	t ʃ i k 'ɔ t s
doblar	d o β l 'a ɾ	d o β l 'a ɾ
pèrita	p 'ɛ ɾ i t a	p 'ɛ ɾ i t a
trobés	t ɾ o β 'e s	t ɾ o β 'e s
carregades	k a r e ɣ 'a ð e s	k a r e ɣ 'a ð e s
textual	t e k s t u 'a l	t e k s t u 'a l
pessetes	p e s 'e t e s	p e s 'e t e s
Bretanya	b ɾ e t 'a ɲ a	b ɾ e t 'a ɲ a
generadors	d ʒ e n e ɾ a ð 'o ɾ s	d ʒ e n e ɾ a ð 'o ɾ s
s'inicia	s i n i s 'i a	s i n i s 'i a
creuen	k ɾ 'e w e n	k ɾ 'e w e n
acarnissat	a k a ɾ n i s 'a t	a k a ɾ n i s 'a t
indòmita	i n d 'ɔ m i t a	i n d 'ɔ m i t a
casaques	k a z 'a k e s	k a z 'a k e s
m'agafa	m a ɣ 'a f a	m a ɣ 'a f a
adduí	a d d u 'i	a d d u 'i
conclusius	k o ŋ k l u z 'i w s	k o ŋ k l u z 'i w s
porfíria	p o ɾ f 'i ɾ i a	p o ɾ f 'i ɾ i a
empassar	a m p a s 'a ɾ	a m p a s 'a ɾ
segures	s e ɣ 'u ɾ e s	s e ɣ 'u ɾ e s
pirateria	p i ɾ a t e ɾ 'i a	p i ɾ a t e ɾ 'i a
desafiament	d e z a f i a m 'e n t	d e z a f i a m 'e n t
primavera	p ɾ i m a v 'e ɾ a	p ɾ i m a v 'e ɾ a
llibrer	ʎ i β ɾ 'e ɾ	ʎ i β ɾ 'e ɾ
retorni	r e t 'ɔ ɾ n i	r e t 'ɔ ɾ n i
abusats	a β u z 'a t s	a β u z 'a t s
petrificats	p e t ɾ i f i k 'a t s	p e t ɾ i f i k 'a t s
Agustí	a ɣ u s t 'i	a ɣ u s t 'i
fitxa	f 'i t ʃ a	f 'i t ʃ a
licita	l i s 'i t a	l i s 'i t a
simplificar	s i m p l i f i k 'a ɾ	s i m p l i f i k 'a ɾ
amable	a m 'a β l e	a m 'a β l e
anòmia	a n 'ɔ m i a	a n 'ɔ m i a
solgui	s 'ɔ l ɣ i	s 'ɔ l ɣ i
monoaminooxidasa	m o n o a m i n o o k s i ð 'a z a	m o n o a m i n o o k s i ð 'a z a
exògam	e g z 'ɔ ɣ a m	e g z 'ɔ ɣ a m
adàmic	a ð 'a m i k	a ð 'a m i k
abròtan	a β ɾ 'ɔ t a n	a β ɾ 'ɔ t a n
plànol	p l 'a n o l	p l 'a n o l
melanòcit	m e l a n 'ɔ s i t	m e l a n 'ɔ s i t
algun	a l ɣ 'u n	a l ɣ 'u n
sentiment	s e n t i m 'e n t	s e n t i m 'e n t
fellonia	f e ʎ o n 'i a	f e ʎ o n 'i a
previnguda	p ɾ e v i ŋ g 'u ð a	p ɾ e v i ŋ g 'u ð a
buidada	b w i ð 'a ð a	b w i ð 'a ð a
vàlids	v 'a l i t s	v 'a l i t s
cavades	k a v 'a ð e s	k a v 'a ð e s
pols	p 'ɔ l s	p 'ɔ l s
polleguera	p o ʎ e ɣ 'e ɾ a	p o ʎ e ɣ 'e ɾ a
auxiliada	a w k s i l i 'a ð a	a w k s i l i 'a ð a
preocupada	p ɾ e o k u p 'a ð a	p ɾ e o k u p 'a ð a
impulso	i m p 'u l s o	i m p 'u l s o
consistència	k o n s i s t 'ɛ n s i a	k o n s i s t 'ɛ n s i a
implantada	i m p l a n t 'a ð a	i m p l a n t 'a ð a
baixamar	b a j ʃ a m 'a ɾ	b a j ʃ a m 'a ɾ
assistires	a s i s t 'i ɾ e s	a s i s t 'i ɾ e s
utilitat	u t i l i t 'a t	u t i l i t 'a t
subscriure	s u p s k ɾ 'i w ɾ e	s u p s k ɾ 'i w ɾ e
afusellada	a f u z e ʎ 'a ð a	a f u z e ʎ 'a ð a
desgana	d e z ɣ 'a n a	d e z ɣ 'a n a
merescuts	m e ɾ e s k 'u t s	m e ɾ e s k 'u t s
pal·ladi	p a l 'a ð i	p a l 'a ð i
brillar	b ɾ i ʎ 'a ɾ	b ɾ i ʎ 'a ɾ
